,player_id,firstname,lastname,team,game_id,points,position,minutes,fgm,fga,fgp,ftm,fta,ftp,tpm,tpa,tpp,offReb,defReb,totReb,assists,pFouls,steals,turnovers,blocks,plusMinus,First Last Name,Points_Rebounds_Assist,Points_Rebounds,Points_Assist,Rebounds_Assist,id,date
0,1901,Grant,Williams,Charlotte Hornets,13466,9,PF,38,4,6,66.7,0,0,0,1,1,100.0,0,5,5,2,3,3,3,0,+1,Grant Williams,16,14,11,7,13466,03/10/2024 12:00:00 AM
1,3950,Brandon,Miller,Charlotte Hornets,13466,23,F,36,10,21,47.6,1,2,50.0,2,10,20.0,0,7,7,3,2,0,2,1,-3,Brandon Miller,33,30,26,10,13466,03/10/2024 12:00:00 AM
2,941,Miles,Bridges,Charlotte Hornets,13466,24,SF,39,10,15,66.7,2,5,40.0,2,5,40.0,1,9,10,4,1,1,3,0,+11,Miles Bridges,38,34,28,14,13466,03/10/2024 12:00:00 AM
3,2639,Nick,Richards,Charlotte Hornets,13466,15,C,31,6,10,60.0,3,3,100.0,0,0,0,5,6,11,0,3,1,1,1,-3,Nick Richards,26,26,15,11,13466,03/10/2024 12:00:00 AM
4,2739,Vasilije,Micic,Charlotte Hornets,13466,12,G,31,5,13,38.5,1,1,100.0,1,5,20.0,1,4,5,10,1,0,5,0,+2,Vasilije Micic,27,17,22,15,13466,03/10/2024 12:00:00 AM
5,2633,Aleksej,Pokusevski,Charlotte Hornets,13466,7,F,8,2,2,100.0,2,2,100.0,1,1,100.0,0,2,2,0,0,1,1,1,+7,Aleksej Pokusevski,9,9,7,2,13466,03/10/2024 12:00:00 AM
6,2856,JT,Thor,Charlotte Hornets,13466,5,F,13,2,2,100.0,0,0,0,1,1,100.0,0,1,1,0,1,0,0,0,+6,JT Thor,6,6,5,1,13466,03/10/2024 12:00:00 AM
7,52,Davis,Bertans,Charlotte Hornets,13466,11,SF,28,3,8,37.5,2,2,100.0,3,6,50.0,1,2,3,4,4,2,1,0,+25,Davis Bertans,18,14,15,7,13466,03/10/2024 12:00:00 AM
8,4042,Nick Jr.,Smith,Charlotte Hornets,13466,4,G,17,2,4,50.0,0,0,0,0,1,0,1,0,1,3,3,1,0,0,+9,Nick Jr. Smith,8,5,7,4,13466,03/10/2024 12:00:00 AM
9,175,Dorian,Finney-Smith,Brooklyn Nets,13466,8,PF,38,2,8,25.0,3,4,75.0,1,6,16.7,2,3,5,2,1,1,2,0,+11,Dorian Finney-Smith,15,13,10,7,13466,03/10/2024 12:00:00 AM
10,940,Mikal,Bridges,Brooklyn Nets,13466,19,SF,41,6,18,33.3,3,3,100.0,4,11,36.4,0,2,2,4,1,1,1,0,-10,Mikal Bridges,25,21,23,6,13466,03/10/2024 12:00:00 AM
11,1854,Nic,Claxton,Brooklyn Nets,13466,14,C,34,6,10,60.0,2,3,66.7,0,0,0,4,6,10,4,3,0,3,2,-7,Nic Claxton,28,24,18,14,13466,03/10/2024 12:00:00 AM
12,472,Dennis,Schroder,Brooklyn Nets,13466,12,PG,39,5,12,41.7,0,0,0,2,7,28.6,1,5,6,7,0,1,2,0,-13,Dennis Schroder,25,18,19,13,13466,03/10/2024 12:00:00 AM
13,2855,Cam,Thomas,Brooklyn Nets,13466,31,SG,30,12,24,50.0,2,3,66.7,5,10,50.0,0,1,1,2,2,0,2,0,+4,Cam Thomas,34,32,33,3,13466,03/10/2024 12:00:00 AM
14,2861,Trendon,Watford,Brooklyn Nets,13466,6,PF,13,2,6,33.3,1,2,50.0,1,2,50.0,3,2,5,0,3,0,1,0,-4,Trendon Watford,11,11,6,5,13466,03/10/2024 12:00:00 AM
15,3946,Jalen,Wilson,Brooklyn Nets,13466,0,F,20,0,5,0,0,0,0,0,3,0,2,2,4,1,2,1,2,0,-18,Jalen Wilson,5,4,1,5,13466,03/10/2024 12:00:00 AM
16,2848,Day'Ron,Sharpe,Brooklyn Nets,13466,2,C,10,1,3,33.3,0,0,0,0,0,0,4,1,5,2,1,0,1,0,-5,Day'Ron Sharpe,9,7,4,7,13466,03/10/2024 12:00:00 AM
17,876,Dennis,Smith Jr.,Brooklyn Nets,13466,7,PG,14,2,4,50.0,2,2,100.0,1,3,33.3,0,3,3,0,1,0,1,0,-13,Dennis Smith Jr.,10,10,7,3,13466,03/10/2024 12:00:00 AM
18,3971,Ausar,Thompson,Detroit Pistons,13467,4,F,11,1,7,14.3,2,4,50.0,0,2,0,4,1,5,0,1,1,0,0,0,Ausar Thompson,9,9,4,5,13467,03/10/2024 12:00:00 AM
19,2648,Isaiah,Stewart,Detroit Pistons,13467,5,C,34,2,6,33.3,0,0,0,1,4,25.0,0,4,4,0,0,3,1,0,+2,Isaiah Stewart,9,9,5,4,13467,03/10/2024 12:00:00 AM
20,3433,Jalen,Duren,Detroit Pistons,13467,6,C,16,1,4,25.0,4,4,100.0,0,0,0,2,6,8,3,4,0,2,0,-21,Jalen Duren,17,14,9,11,13467,03/10/2024 12:00:00 AM
21,2801,Cade,Cunningham,Detroit Pistons,13467,33,PG,32,11,21,52.4,8,8,100.0,3,7,42.9,3,6,9,10,2,0,5,0,-7,Cade Cunningham,52,42,43,19,13467,03/10/2024 12:00:00 AM
22,3451,Jaden,Ivey,Detroit Pistons,13467,17,PG,36,7,21,33.3,1,2,50.0,2,9,22.2,4,2,6,4,3,2,6,1,-16,Jaden Ivey,27,23,21,10,13467,03/10/2024 12:00:00 AM
23,3438,Simone,Fontecchio,Detroit Pistons,13467,27,F,32,9,13,69.2,5,5,100.0,4,5,80.0,1,3,4,2,4,1,0,1,+2,Simone Fontecchio,33,31,29,6,13467,03/10/2024 12:00:00 AM
24,945,Troy,Brown Jr.,Detroit Pistons,13467,0,SF,2,0,0,0,0,0,0,0,0,0,0,0,0,1,0,0,0,0,-2,Troy Brown Jr.,1,0,1,1,13467,03/10/2024 12:00:00 AM
25,2666,James,Wiseman,Detroit Pistons,13467,17,C,30,8,10,80.0,1,2,50.0,0,0,0,4,8,12,4,5,0,1,1,+1,James Wiseman,33,29,21,16,13467,03/10/2024 12:00:00 AM
26,2587,Malachi,Flynn,Detroit Pistons,13467,2,PG,2,1,1,100.0,0,0,0,0,0,0,0,0,0,1,1,0,1,0,-2,Malachi Flynn,3,2,3,1,13467,03/10/2024 12:00:00 AM
27,177,Evan,Fournier,Detroit Pistons,13467,0,SG,11,0,3,0,0,0,0,0,2,0,0,2,2,1,0,0,0,0,-12,Evan Fournier,3,2,1,3,13467,03/10/2024 12:00:00 AM
28,3790,Stanley,Umude,Detroit Pistons,13467,3,G,14,1,5,20.0,0,0,0,1,3,33.3,2,0,2,0,3,0,0,1,-20,Stanley Umude,5,5,3,2,13467,03/10/2024 12:00:00 AM
29,3970,Marcus,Sasser,Detroit Pistons,13467,10,G,19,4,8,50.0,0,0,0,2,5,40.0,0,4,4,1,3,1,3,0,-15,Marcus Sasser,15,14,11,5,13467,03/10/2024 12:00:00 AM
30,1897,P.J.,Washington,Dallas Mavericks,13467,7,PF,29,2,4,50.0,2,2,100.0,1,3,33.3,0,2,2,1,0,2,0,0,+4,P.J. Washington,10,9,8,3,13467,03/10/2024 12:00:00 AM
31,283,Derrick,Jones Jr.,Dallas Mavericks,13467,12,SF,18,5,7,71.4,2,2,100.0,0,2,0,0,1,1,1,2,4,0,1,+16,Derrick Jones Jr.,14,13,13,2,13467,03/10/2024 12:00:00 AM
32,1859,Daniel,Gafford,Dallas Mavericks,13467,17,C,24,7,7,100.0,3,4,75.0,0,0,0,0,7,7,1,3,0,1,4,+22,Daniel Gafford,25,24,18,8,13467,03/10/2024 12:00:00 AM
33,261,Kyrie,Irving,Dallas Mavericks,13467,21,PG,30,9,18,50.0,0,0,0,3,6,50.0,1,2,3,5,1,1,4,0,+15,Kyrie Irving,29,24,26,8,13467,03/10/2024 12:00:00 AM
34,963,Luka,Doncic,Dallas Mavericks,13467,39,PG,37,13,24,54.2,9,10,90.0,4,13,30.8,0,10,10,10,1,3,6,2,+13,Luka Doncic,59,49,49,20,13467,03/10/2024 12:00:00 AM
35,374,Markieff,Morris,Dallas Mavericks,13467,6,PF,3,2,2,100.0,0,0,0,2,2,100.0,0,0,0,0,0,0,1,0,-2,Markieff Morris,6,6,6,0,13467,03/10/2024 12:00:00 AM
36,817,Maxi,Kleber,Dallas Mavericks,13467,0,PF,17,0,2,0,0,0,0,0,2,0,1,5,6,0,2,1,0,1,+6,Maxi Kleber,6,6,0,6,13467,03/10/2024 12:00:00 AM
37,215,Tim,Hardaway Jr.,Dallas Mavericks,13467,17,SF,18,6,13,46.2,1,4,25.0,4,8,50.0,0,1,1,2,0,0,0,0,+13,Tim Hardaway Jr.,20,18,19,3,13467,03/10/2024 12:00:00 AM
38,433,Dwight,Powell,Dallas Mavericks,13467,3,C,12,1,2,50.0,1,1,100.0,0,0,0,1,1,2,1,4,0,1,0,-7,Dwight Powell,6,5,4,3,13467,03/10/2024 12:00:00 AM
39,2593,Josh,Green,Dallas Mavericks,13467,8,SG,27,2,5,40.0,4,5,80.0,0,1,0,0,1,1,2,3,2,0,0,+9,Josh Green,11,9,10,3,13467,03/10/2024 12:00:00 AM
40,164,Dante,Exum,Dallas Mavericks,13467,2,G,18,1,3,33.3,0,0,0,0,1,0,1,1,2,5,2,0,0,0,+7,Dante Exum,9,4,7,7,13467,03/10/2024 12:00:00 AM
41,2890,A.J.,Lawson,Dallas Mavericks,13467,2,G,3,1,1,100.0,0,0,0,0,0,0,0,0,0,0,0,0,0,0,-2,A.J. Lawson,2,2,2,0,13467,03/10/2024 12:00:00 AM
42,3407,Jaden,Hardy,Dallas Mavericks,13467,8,G,4,2,4,50.0,4,4,100.0,0,0,0,0,1,1,1,0,0,1,0,-4,Jaden Hardy,10,9,9,2,13467,03/10/2024 12:00:00 AM
43,153,Kevin,Durant,Phoenix Suns,13468,45,PF,37,18,26,69.2,5,7,71.4,4,7,57.1,1,9,10,6,2,1,6,0,-1,Kevin Durant,61,55,51,16,13468,03/10/2024 01:30:00 AM
44,851,Royce,O'Neale,Phoenix Suns,13468,3,PF,37,1,9,11.1,0,0,0,1,6,16.7,1,4,5,2,1,1,0,0,+10,Royce O'Neale,10,8,5,7,13468,03/10/2024 01:30:00 AM
45,398,Jusuf,Nurkic,Phoenix Suns,13468,11,C,28,5,6,83.3,1,3,33.3,0,0,0,5,6,11,4,2,1,3,1,+5,Jusuf Nurkic,26,22,15,15,13468,03/10/2024 01:30:00 AM
46,45,Bradley,Beal,Phoenix Suns,13468,25,SG,38,10,20,50.0,2,2,100.0,3,5,60.0,0,1,1,4,4,3,1,0,+1,Bradley Beal,30,26,29,5,13468,03/10/2024 01:30:00 AM
47,926,Grayson,Allen,Phoenix Suns,13468,7,SG,39,3,8,37.5,1,2,50.0,0,4,0,0,5,5,2,2,0,3,0,-16,Grayson Allen,14,12,9,7,13468,03/10/2024 01:30:00 AM
48,966,Drew,Eubanks,Phoenix Suns,13468,0,PF,11,0,0,0,0,0,0,0,0,0,0,1,1,0,1,0,0,0,-20,Drew Eubanks,1,1,0,1,13468,03/10/2024 01:30:00 AM
49,3483,David,Roddy,Phoenix Suns,13468,2,F,6,1,5,20.0,0,0,0,0,3,0,1,0,1,0,1,0,0,0,-6,David Roddy,3,3,2,1,13468,03/10/2024 01:30:00 AM
50,1849,Bol,Bol,Phoenix Suns,13468,13,C,10,6,7,85.7,0,0,0,1,2,50.0,1,3,4,0,0,0,0,0,-10,Bol Bol,17,17,13,4,13468,03/10/2024 01:30:00 AM
51,196,Eric,Gordon,Phoenix Suns,13468,0,SG,29,0,3,0,0,0,0,0,2,0,0,2,2,2,0,0,0,0,-9,Eric Gordon,4,2,2,4,13468,03/10/2024 01:30:00 AM
52,2610,Saben,Lee,Phoenix Suns,13468,1,G,4,0,3,0,1,2,50.0,0,2,0,1,0,1,1,1,0,1,0,-4,Saben Lee,3,2,2,2,13468,03/10/2024 01:30:00 AM
53,882,Jayson,Tatum,Boston Celtics,13468,29,SF,42,11,28,39.3,2,2,100.0,5,9,55.6,3,7,10,7,0,1,4,0,+4,Jayson Tatum,46,39,36,17,13468,03/10/2024 01:30:00 AM
54,248,Al,Horford,Boston Celtics,13468,9,C,32,4,12,33.3,0,0,0,1,7,14.3,3,9,12,3,4,1,1,0,0,Al Horford,24,21,12,15,13468,03/10/2024 01:30:00 AM
55,242,Jrue,Holiday,Boston Celtics,13468,15,PG,36,5,7,71.4,2,2,100.0,3,5,60.0,0,3,3,6,1,2,3,1,+6,Jrue Holiday,24,18,21,9,13468,03/10/2024 01:30:00 AM
56,897,Derrick,White,Boston Celtics,13468,10,PG,35,5,8,62.5,0,0,0,0,3,0,2,3,5,9,3,0,2,1,+1,Derrick White,24,15,19,14,13468,03/10/2024 01:30:00 AM
57,75,Jaylen,Brown,Boston Celtics,13468,27,SG,34,10,21,47.6,4,7,57.1,3,7,42.9,1,2,3,3,1,2,2,0,+6,Jaylen Brown,33,30,30,6,13468,03/10/2024 01:30:00 AM
58,2812,Sam,Hauser,Boston Celtics,13468,3,SF,18,1,5,20.0,0,0,0,1,4,25.0,0,2,2,0,0,0,0,1,+10,Sam Hauser,5,5,3,2,13468,03/10/2024 01:30:00 AM
59,819,Luke,Kornet,Boston Celtics,13468,14,C,20,6,7,85.7,2,2,100.0,0,0,0,3,3,6,0,2,0,0,1,+12,Luke Kornet,20,20,14,6,13468,03/10/2024 01:30:00 AM
60,2635,Payton,Pritchard,Boston Celtics,13468,10,PG,23,4,6,66.7,0,0,0,2,4,50.0,1,1,2,1,0,1,0,0,+13,Payton Pritchard,13,12,11,3,13468,03/10/2024 01:30:00 AM
61,3429,JD,Davison,Boston Celtics,13468,0,SG,0,0,0,0,0,0,0,0,0,0,0,0,0,0,0,0,0,0,-1,JD Davison,0,0,0,0,13468,03/10/2024 01:30:00 AM
62,2851,Jaden,Springer,Boston Celtics,13468,0,G,0,0,0,0,0,0,0,0,0,0,0,0,0,0,1,0,0,0,-1,Jaden Springer,0,0,0,0,13468,03/10/2024 01:30:00 AM
63,204,Draymond,Green,Golden State Warriors,13469,7,PF,28,3,6,50.0,0,0,0,1,3,33.3,2,3,5,4,2,2,3,1,-8,Draymond Green,16,12,11,9,13469,03/10/2024 01:30:00 AM
64,2827,Jonathan,Kuminga,Golden State Warriors,13469,26,PF,30,10,17,58.8,6,8,75.0,0,1,0,0,3,3,2,4,1,2,0,-8,Jonathan Kuminga,31,29,28,5,13469,03/10/2024 01:30:00 AM
65,3973,Trayce,JacksonDavis,Golden State Warriors,13469,11,F,24,5,5,100.0,1,5,20.0,0,0,0,1,5,6,0,4,1,1,3,-5,Trayce JacksonDavis,17,17,11,6,13469,03/10/2024 01:30:00 AM
66,415,Chris,Paul,Golden State Warriors,13469,10,PG,29,4,9,44.4,0,0,0,2,3,66.7,0,4,4,9,1,3,0,0,-3,Chris Paul,23,14,19,13,13469,03/10/2024 01:30:00 AM
67,3975,Brandin,Podziemski,Golden State Warriors,13469,8,G,31,2,7,28.6,3,4,75.0,1,1,100.0,4,2,6,7,0,1,2,1,-8,Brandin Podziemski,21,14,15,13,13469,03/10/2024 01:30:00 AM
68,468,Dario,Saric,Golden State Warriors,13469,2,PF,3,1,2,50.0,0,0,0,0,1,0,0,0,0,0,2,0,0,0,-6,Dario Saric,2,2,2,0,13469,03/10/2024 01:30:00 AM
69,3485,Gui,Santos,Golden State Warriors,13469,0,F,6,0,0,0,0,0,0,0,0,0,0,1,1,1,1,0,0,0,+1,Gui Santos,2,1,1,2,13469,03/10/2024 01:30:00 AM
70,548,Andrew,Wiggins,Golden State Warriors,13469,11,SF,26,5,12,41.7,0,0,0,1,3,33.3,1,5,6,1,3,1,0,0,-6,Andrew Wiggins,18,17,12,7,13469,03/10/2024 01:30:00 AM
71,514,Klay,Thompson,Golden State Warriors,13469,27,SG,25,8,16,50.0,6,6,100.0,5,10,50.0,0,2,2,1,4,0,3,1,+2,Klay Thompson,30,29,28,3,13469,03/10/2024 01:30:00 AM
72,1019,Jerome,Robinson,Golden State Warriors,13469,0,SG,2,0,0,0,0,0,0,0,0,0,0,0,0,0,0,0,0,0,-2,Jerome Robinson,0,0,0,0,13469,03/10/2024 01:30:00 AM
73,2836,Moses,Moody,Golden State Warriors,13469,9,SG,26,2,11,18.2,5,6,83.3,0,6,0,1,4,5,0,2,0,1,1,-9,Moses Moody,14,14,9,5,13469,03/10/2024 01:30:00 AM
74,3480,Lester,Quinones,Golden State Warriors,13469,2,G,9,1,3,33.3,0,0,0,0,2,0,0,1,1,0,1,0,0,0,-11,Lester Quinones,3,3,2,1,13469,03/10/2024 01:30:00 AM
75,3492,Pat,Spencer,Golden State Warriors,13469,0,G,2,0,0,0,0,0,0,0,0,0,0,0,0,1,0,0,0,0,-2,Pat Spencer,1,0,1,1,13469,03/10/2024 01:30:00 AM
76,762,Zach,Collins,San Antonio Spurs,13469,9,PF,22,4,8,50.0,0,2,0,1,1,100.0,0,2,2,0,5,1,0,1,+8,Zach Collins,11,11,9,2,13469,03/10/2024 01:30:00 AM
77,3425,Julian,Champagnie,San Antonio Spurs,13469,17,F,34,5,8,62.5,2,2,100.0,5,8,62.5,1,6,7,5,0,0,3,1,+5,Julian Champagnie,29,24,22,12,13469,03/10/2024 01:30:00 AM
78,3490,Jeremy,Sochan,San Antonio Spurs,13469,20,F,24,7,14,50.0,4,6,66.7,2,4,50.0,0,5,5,1,5,0,3,1,+7,Jeremy Sochan,26,25,21,6,13469,03/10/2024 01:30:00 AM
79,2606,Tre,Jones,San Antonio Spurs,13469,7,PG,31,1,5,20.0,5,6,83.3,0,2,0,1,4,5,11,1,2,1,0,+3,Tre Jones,23,12,18,16,13469,03/10/2024 01:30:00 AM
80,3419,Malaki,Branham,San Antonio Spurs,13469,20,G,29,7,15,46.7,3,4,75.0,3,6,50.0,1,2,3,2,1,0,3,0,+8,Malaki Branham,25,23,22,5,13469,03/10/2024 01:30:00 AM
81,2830,Sandro,Mamukelashvili,San Antonio Spurs,13469,0,PF,6,0,1,0,0,0,0,0,0,0,1,0,1,1,0,0,0,0,+8,Sandro Mamukelashvili,2,1,1,2,13469,03/10/2024 01:30:00 AM
82,3415,Dominick,Barlow,San Antonio Spurs,13469,19,F,30,7,10,70.0,5,6,83.3,0,1,0,5,3,8,4,4,1,0,1,+4,Dominick Barlow,31,27,23,12,13469,03/10/2024 01:30:00 AM
83,1872,Keldon,Johnson,San Antonio Spurs,13469,22,SF,32,9,18,50.0,0,0,0,4,9,44.4,3,8,11,1,1,0,1,0,+4,Keldon Johnson,34,33,23,12,13469,03/10/2024 01:30:00 AM
84,973,Devonte',Graham,San Antonio Spurs,13469,8,PG,11,3,4,75.0,0,0,0,2,2,100.0,0,2,2,0,2,1,0,0,+10,Devonte' Graham,10,10,8,2,13469,03/10/2024 01:30:00 AM
85,3499,Blake,Wesley,San Antonio Spurs,13469,4,G,20,1,3,33.3,2,2,100.0,0,0,0,0,5,5,9,3,1,1,2,+8,Blake Wesley,18,9,13,14,13469,03/10/2024 01:30:00 AM
86,195,Aaron,Gordon,Denver Nuggets,13470,7,PF,20,3,3,100.0,1,1,100.0,0,0,0,0,2,2,7,4,2,3,0,+19,Aaron Gordon,16,9,14,9,13470,03/10/2024 02:00:00 AM
87,1014,Michael,Porter Jr.,Denver Nuggets,13470,19,SF,22,8,13,61.5,0,0,0,3,5,60.0,1,3,4,2,1,1,2,1,+12,Michael Porter Jr.,25,23,21,6,13470,03/10/2024 02:00:00 AM
88,279,Nikola,Jokic,Denver Nuggets,13470,26,C,32,12,14,85.7,2,2,100.0,0,0,0,2,4,6,8,1,1,3,2,+6,Nikola Jokic,40,32,34,14,13470,03/10/2024 02:00:00 AM
89,383,Jamal,Murray,Denver Nuggets,13470,37,PG,37,13,21,61.9,5,7,71.4,6,9,66.7,1,2,3,7,2,2,1,0,+11,Jamal Murray,47,40,44,10,13470,03/10/2024 02:00:00 AM
90,89,Kentavious,Caldwell-Pope,Denver Nuggets,13470,13,SG,30,5,8,62.5,0,0,0,3,6,50.0,0,1,1,2,2,1,1,2,+1,Kentavious Caldwell-Pope,16,14,15,3,13470,03/10/2024 02:00:00 AM
91,2627,Zeke,Nnaji,Denver Nuggets,13470,1,PF,15,0,1,0,1,2,50.0,0,0,0,1,1,2,2,2,0,0,2,+13,Zeke Nnaji,5,3,3,4,13470,03/10/2024 02:00:00 AM
92,3967,Hunter,Tyson,Denver Nuggets,13470,3,F,1,1,1,100.0,0,0,0,1,1,100.0,0,1,1,0,1,0,0,0,+2,Hunter Tyson,4,4,3,1,13470,03/10/2024 02:00:00 AM
93,3498,Peyton,Watson,Denver Nuggets,13470,12,F,26,4,8,50.0,4,4,100.0,0,2,0,0,5,5,0,1,1,1,1,0,Peyton Watson,17,17,12,5,13470,03/10/2024 02:00:00 AM
94,243,Justin,Holiday,Denver Nuggets,13470,3,SF,25,1,1,100.0,0,0,0,1,1,100.0,0,2,2,7,1,0,0,1,+15,Justin Holiday,12,5,10,9,13470,03/10/2024 02:00:00 AM
95,2814,Jay,Huff,Denver Nuggets,13470,2,C,1,1,1,100.0,0,0,0,0,0,0,0,1,1,0,0,0,0,0,+2,Jay Huff,3,3,2,1,13470,03/10/2024 02:00:00 AM
96,264,Reggie,Jackson,Denver Nuggets,13470,6,PG,9,2,7,28.6,0,0,0,2,5,40.0,0,1,1,2,0,0,1,0,+8,Reggie Jackson,9,7,8,3,13470,03/10/2024 02:00:00 AM
97,3965,Jalen,Pickett,Denver Nuggets,13470,0,G,2,0,0,0,0,0,0,0,0,0,0,0,0,1,0,0,1,0,+2,Jalen Pickett,1,0,1,1,13470,03/10/2024 02:00:00 AM
98,3420,Christian,Braun,Denver Nuggets,13470,13,G,17,5,5,100.0,0,0,0,3,3,100.0,0,4,4,1,6,0,0,1,+12,Christian Braun,18,17,14,5,13470,03/10/2024 02:00:00 AM
99,3966,Julian,Strawther,Denver Nuggets,13470,0,G,2,0,0,0,0,0,0,0,0,0,0,0,0,1,1,0,0,0,+2,Julian Strawther,1,0,1,1,13470,03/10/2024 02:00:00 AM
100,761,John,Collins,Utah Jazz,13470,19,PF,33,7,10,70.0,5,8,62.5,0,0,0,3,4,7,1,1,0,2,0,+6,John Collins,27,26,20,8,13470,03/10/2024 02:00:00 AM
101,4034,Brice,Sensabaugh,Utah Jazz,13470,16,F,32,7,11,63.6,2,3,66.7,0,3,0,1,1,2,3,0,3,5,0,+4,Brice Sensabaugh,21,18,19,5,13470,03/10/2024 02:00:00 AM
102,3457,Walker,Kessler,Utah Jazz,13470,6,C,24,3,9,33.3,0,0,0,0,0,0,7,4,11,2,1,0,0,1,-19,Walker Kessler,19,17,8,13,13470,03/10/2024 02:00:00 AM
103,1021,Collin,Sexton,Utah Jazz,13470,17,PG,36,6,17,35.3,4,5,80.0,1,3,33.3,1,0,1,4,2,1,0,0,-1,Collin Sexton,22,18,21,5,13470,03/10/2024 02:00:00 AM
104,4029,Keyonte,George,Utah Jazz,13470,29,G,38,10,17,58.8,4,5,80.0,5,8,62.5,0,5,5,6,2,0,4,0,-2,Keyonte George,40,34,35,11,13470,03/10/2024 02:00:00 AM
105,1891,Luka,Samanic,Utah Jazz,13470,7,F,15,2,6,33.3,3,3,100.0,0,3,0,1,4,5,1,3,0,1,1,-4,Luka Samanic,13,12,8,6,13470,03/10/2024 02:00:00 AM
106,2785,Omer,Yurtseven,Utah Jazz,13470,0,C,4,0,0,0,0,0,0,0,0,0,0,0,0,0,0,0,0,0,-10,Omer Yurtseven,0,0,0,0,13470,03/10/2024 02:00:00 AM
107,109,Jordan,Clarkson,Utah Jazz,13470,22,PG,28,10,18,55.6,1,1,100.0,1,4,25.0,1,3,4,3,1,3,3,0,-29,Jordan Clarkson,29,26,25,7,13470,03/10/2024 02:00:00 AM
108,1867,Talen,Horton-Tucker,Utah Jazz,13470,3,SG,9,1,3,33.3,0,0,0,1,3,33.3,0,0,0,0,1,0,0,0,-16,Talen Horton-Tucker,3,3,3,0,13470,03/10/2024 02:00:00 AM
109,152,Kris,Dunn,Utah Jazz,13470,0,G,15,0,0,0,0,0,0,0,0,0,0,1,1,1,4,0,0,0,-22,Kris Dunn,2,1,1,2,13470,03/10/2024 02:00:00 AM
110,3454,Johnny,Juzang,Utah Jazz,13470,2,G,6,1,3,33.3,0,0,0,0,2,0,0,0,0,1,0,0,0,0,-12,Johnny Juzang,3,2,3,1,13470,03/10/2024 02:00:00 AM
111,4015,Toumani,Camara,Portland Trail Blazers,13471,15,F,32,5,10,50.0,3,3,100.0,2,4,50.0,5,4,9,4,3,1,1,0,+8,Toumani Camara,28,24,19,13,13471,03/10/2024 03:00:00 AM
112,4017,Kris,Murray,Portland Trail Blazers,13471,5,F,25,2,7,28.6,0,0,0,1,5,20.0,0,4,4,3,1,0,1,0,+8,Kris Murray,12,9,8,7,13471,03/10/2024 03:00:00 AM
113,930,Deandre,Ayton,Portland Trail Blazers,13471,30,C,40,14,25,56.0,2,2,100.0,0,1,0,5,14,19,1,1,2,3,1,+10,Deandre Ayton,50,49,31,20,13471,03/10/2024 03:00:00 AM
114,1023,Anfernee,Simons,Portland Trail Blazers,13471,23,SG,42,8,18,44.4,3,3,100.0,4,9,44.4,2,2,4,7,1,1,5,0,+1,Anfernee Simons,34,27,30,11,13471,03/10/2024 03:00:00 AM
115,2788,Dalano,Banton,Portland Trail Blazers,13471,25,G,42,9,16,56.3,2,3,66.7,5,8,62.5,2,5,7,4,2,0,2,1,+18,Dalano Banton,36,32,29,11,13471,03/10/2024 03:00:00 AM
116,4018,Duop,Reath,Portland Trail Blazers,13471,4,C,13,1,3,33.3,2,2,100.0,0,1,0,0,1,1,0,1,0,0,0,0,Duop Reath,5,5,4,1,13471,03/10/2024 03:00:00 AM
117,1896,Matisse,Thybulle,Portland Trail Blazers,13471,13,SG,32,5,9,55.6,0,0,0,3,5,60.0,2,2,4,4,3,4,1,1,-7,Matisse Thybulle,21,17,17,8,13471,03/10/2024 03:00:00 AM
118,3408,Scoot,Henderson,Portland Trail Blazers,13471,13,G,26,5,12,41.7,2,2,100.0,1,4,25.0,0,1,1,5,4,1,1,0,+5,Scoot Henderson,19,14,18,6,13471,03/10/2024 03:00:00 AM
119,4069,R.,Rupert,Portland Trail Blazers,13471,0,G,13,0,3,0,0,0,0,0,3,0,2,1,3,3,2,1,0,0,+7,R. Rupert,6,3,3,6,13471,03/10/2024 03:00:00 AM
120,404,Kelly,Olynyk,Toronto Raptors,13471,15,PF,32,6,10,60.0,0,0,0,3,4,75.0,2,4,6,8,4,2,5,2,-13,Kelly Olynyk,29,21,23,14,13471,03/10/2024 03:00:00 AM
121,1058,Gary,Trent Jr.,Toronto Raptors,13471,23,SG,42,10,26,38.5,0,1,0,3,12,25.0,2,3,5,3,2,2,2,0,-12,Gary Trent Jr.,31,28,26,8,13471,03/10/2024 03:00:00 AM
122,2636,Immanuel,Quickley,Toronto Raptors,13471,29,SG,44,10,21,47.6,5,7,71.4,4,10,40.0,0,3,3,7,1,1,6,0,-13,Immanuel Quickley,39,32,36,10,13471,03/10/2024 03:00:00 AM
123,3411,Ochai,Agbaji,Toronto Raptors,13471,7,G,22,2,7,28.6,2,2,100.0,1,4,25.0,0,1,1,1,0,1,0,0,-9,Ochai Agbaji,9,8,8,2,13471,03/10/2024 03:00:00 AM
124,4027,Gradey,Dick,Toronto Raptors,13471,8,G,39,3,10,30.0,0,0,0,2,7,28.6,2,3,5,2,3,0,0,0,+1,Gradey Dick,15,13,10,7,13471,03/10/2024 03:00:00 AM
125,745,Chris,Boucher,Toronto Raptors,13471,16,PF,31,4,5,80.0,6,6,100.0,2,3,66.7,1,7,8,2,2,0,3,3,+3,Chris Boucher,26,24,18,10,13471,03/10/2024 03:00:00 AM
126,1880,Jalen,McDaniels,Toronto Raptors,13471,4,PF,25,2,3,66.7,0,0,0,0,0,0,1,9,10,3,3,2,1,1,-7,Jalen McDaniels,17,14,7,13,13471,03/10/2024 03:00:00 AM
127,2628,Jordan,Nwora,Toronto Raptors,13471,10,SF,12,4,6,66.7,1,1,100.0,1,2,50.0,0,1,1,1,0,1,0,0,+2,Jordan Nwora,12,11,11,2,13471,03/10/2024 03:00:00 AM
128,2557,Jontay,Porter,Toronto Raptors,13471,0,C,0,0,0,0,0,0,0,0,0,0,0,0,0,0,0,0,0,0,0,Jontay Porter,0,0,0,0,13471,03/10/2024 03:00:00 AM
129,3440,Javon,Freeman-Liberty,Toronto Raptors,13471,6,G,18,2,3,66.7,2,2,100.0,0,1,0,1,3,4,2,3,0,3,0,-2,Javon Freeman-Liberty,12,10,8,6,13471,03/10/2024 03:00:00 AM
130,222,Tobias,Harris,Philadelphia 76ers,13457,21,PF,39,9,19,47.4,3,3,100.0,0,5,0,3,7,10,3,1,3,0,1,+10,Tobias Harris,34,31,24,13,13457,03/09/2024 12:00:00 AM
131,932,Mo,Bamba,Philadelphia 76ers,13457,2,C,18,1,2,50.0,0,0,0,0,1,0,1,5,6,0,2,0,1,2,-4,Mo Bamba,8,8,2,6,13457,03/09/2024 12:00:00 AM
132,327,Kyle,Lowry,Philadelphia 76ers,13457,6,PG,31,1,5,20.0,3,4,75.0,1,4,25.0,1,2,3,7,1,1,1,0,-11,Kyle Lowry,16,9,13,10,13457,03/09/2024 12:00:00 AM
133,236,Buddy,Hield,Philadelphia 76ers,13457,8,SG,25,2,10,20.0,2,2,100.0,2,9,22.2,0,2,2,2,3,2,2,1,-15,Buddy Hield,12,10,10,4,13457,03/09/2024 12:00:00 AM
134,407,Kelly,Oubre Jr.,Philadelphia 76ers,13457,20,SG,34,7,18,38.9,4,7,57.1,2,6,33.3,1,6,7,2,4,0,1,0,-12,Kelly Oubre Jr.,29,27,22,9,13457,03/09/2024 12:00:00 AM
135,2617,Kenyon,Martin Jr.,Philadelphia 76ers,13457,0,F,17,0,3,0,0,0,0,0,1,0,1,1,2,0,3,0,1,0,-17,Kenyon Martin Jr.,2,2,0,2,13457,03/09/2024 12:00:00 AM
136,2638,Paul,Reed,Philadelphia 76ers,13457,17,SF,27,7,16,43.8,1,1,100.0,2,4,50.0,6,5,11,2,2,1,0,3,+1,Paul Reed,30,28,19,13,13457,03/09/2024 12:00:00 AM
137,417,Cameron,Payne,Philadelphia 76ers,13457,13,PG,23,5,9,55.6,3,3,100.0,0,3,0,0,1,1,4,1,1,2,0,+4,Cameron Payne,18,14,17,5,13457,03/09/2024 12:00:00 AM
138,2878,Jeff,Dowtin,Philadelphia 76ers,13457,6,G,19,2,3,66.7,0,0,0,2,3,66.7,0,0,0,1,0,0,2,0,+3,Jeff Dowtin,7,6,7,1,13457,03/09/2024 12:00:00 AM
139,4049,Ricky IV,Council,Philadelphia 76ers,13457,2,G,6,1,3,33.3,0,0,0,0,1,0,0,0,0,0,2,0,0,0,+1,Ricky IV Council,2,2,2,0,13457,03/09/2024 12:00:00 AM
140,1902,Zion,Williamson,New Orleans Pelicans,13457,23,PF,35,7,14,50.0,9,9,100.0,0,1,0,2,10,12,4,2,2,1,3,+13,Zion Williamson,39,35,27,16,13457,03/09/2024 12:00:00 AM
141,260,Brandon,Ingram,New Orleans Pelicans,13457,17,SF,35,6,10,60.0,3,4,75.0,2,2,100.0,0,7,7,5,3,0,4,2,-13,Brandon Ingram,29,24,22,12,13457,03/09/2024 12:00:00 AM
142,2822,Herbert,Jones,New Orleans Pelicans,13457,4,SF,31,1,4,25.0,1,1,100.0,1,3,33.3,0,3,3,3,2,0,1,1,-15,Herbert Jones,10,7,7,6,13457,03/09/2024 12:00:00 AM
143,525,Jonas,Valanciunas,New Orleans Pelicans,13457,6,C,19,2,7,28.6,2,2,100.0,0,3,0,3,7,10,2,3,1,1,1,0,Jonas Valanciunas,18,16,8,12,13457,03/09/2024 12:00:00 AM
144,347,CJ,McCollum,New Orleans Pelicans,13457,10,SG,27,5,14,35.7,0,0,0,0,7,0,0,4,4,1,2,0,3,0,-4,CJ McCollum,15,14,11,5,13457,03/09/2024 12:00:00 AM
145,385,Larry,Nance Jr.,New Orleans Pelicans,13457,7,PF,27,2,7,28.6,2,2,100.0,1,1,100.0,2,2,4,1,2,1,0,1,+15,Larry Nance Jr.,12,11,8,5,13457,03/09/2024 12:00:00 AM
146,2668,Naji,Marshall,New Orleans Pelicans,13457,19,SF,18,7,8,87.5,1,1,100.0,4,4,100.0,1,3,4,1,1,1,2,1,+23,Naji Marshall,24,23,20,5,13457,03/09/2024 12:00:00 AM
147,2941,Jose,Alvarado,New Orleans Pelicans,13457,7,PG,21,2,7,28.6,2,2,100.0,1,3,33.3,0,1,1,2,2,1,0,0,+12,Jose Alvarado,10,8,9,3,13457,03/09/2024 12:00:00 AM
148,2837,Trey,Murphy III,New Orleans Pelicans,13457,10,SG,28,3,8,37.5,2,2,100.0,2,7,28.6,1,2,3,3,1,1,0,1,+9,Trey Murphy III,16,13,13,6,13457,03/09/2024 12:00:00 AM
149,246,Richaun,Holmes,Washington Wizards,13458,14,F,36,5,5,100.0,4,4,100.0,0,0,0,3,8,11,1,5,1,0,1,+23,Richaun Holmes,26,25,15,12,13458,03/09/2024 12:00:00 AM
150,820,Kyle,Kuzma,Washington Wizards,13458,28,SF,40,11,23,47.8,6,6,100.0,0,7,0,0,8,8,9,3,1,2,2,+21,Kyle Kuzma,45,36,37,17,13458,03/09/2024 12:00:00 AM
151,2564,Deni,Avdija,Washington Wizards,13458,18,SF,35,8,14,57.1,1,3,33.3,1,2,50.0,3,11,14,2,2,0,1,2,+9,Deni Avdija,34,32,20,16,13458,03/09/2024 12:00:00 AM
152,285,Tyus,Jones,Washington Wizards,13458,7,PG,22,3,7,42.9,0,0,0,1,4,25.0,0,4,4,4,1,0,1,1,-4,Tyus Jones,15,11,11,8,13458,03/09/2024 12:00:00 AM
153,4036,Bilal,Coulibaly,Washington Wizards,13458,11,SG,27,4,7,57.1,2,2,100.0,1,4,25.0,1,3,4,0,3,1,2,1,0,Bilal Coulibaly,15,15,11,4,13458,03/09/2024 12:00:00 AM
154,2590,Anthony,Gill,Washington Wizards,13458,2,PF,2,1,1,100.0,0,0,0,0,0,0,0,0,0,0,0,0,0,0,-3,Anthony Gill,2,2,2,0,13458,03/09/2024 12:00:00 AM
155,2838,Eugene,Omoruyi,Washington Wizards,13458,4,F,6,2,5,40.0,0,0,0,0,1,0,1,1,2,0,2,0,0,0,-6,Eugene Omoruyi,6,6,4,2,13458,03/09/2024 12:00:00 AM
156,2825,Corey,Kispert,Washington Wizards,13458,13,SF,30,3,7,42.9,6,6,100.0,1,5,20.0,0,4,4,2,0,0,0,0,+19,Corey Kispert,19,17,15,6,13458,03/09/2024 12:00:00 AM
157,1887,Jordan,Poole,Washington Wizards,13458,15,SG,34,6,17,35.3,1,2,50.0,2,10,20.0,1,4,5,7,2,2,4,3,+8,Jordan Poole,27,20,22,12,13458,03/09/2024 12:00:00 AM
158,3428,Johnny,Davis,Washington Wizards,13458,0,G,8,0,1,0,0,0,0,0,0,0,1,1,2,0,2,0,1,1,-7,Johnny Davis,2,2,0,2,13458,03/09/2024 12:00:00 AM
159,1901,Grant,Williams,Charlotte Hornets,13458,5,PF,38,2,10,20.0,0,3,0,1,5,20.0,3,1,4,5,3,1,0,1,-2,Grant Williams,14,9,10,9,13458,03/09/2024 12:00:00 AM
160,3950,Brandon,Miller,Charlotte Hornets,13458,21,F,30,8,19,42.1,3,3,100.0,2,7,28.6,1,5,6,0,4,0,1,1,-16,Brandon Miller,27,27,21,6,13458,03/09/2024 12:00:00 AM
161,941,Miles,Bridges,Charlotte Hornets,13458,32,SF,41,13,27,48.1,5,5,100.0,1,10,10.0,1,11,12,4,2,0,0,1,-10,Miles Bridges,48,44,36,16,13458,03/09/2024 12:00:00 AM
162,2639,Nick,Richards,Charlotte Hornets,13458,10,C,30,5,6,83.3,0,0,0,0,0,0,5,8,13,0,3,2,2,1,-15,Nick Richards,23,23,10,13,13458,03/09/2024 12:00:00 AM
163,2739,Vasilije,Micic,Charlotte Hornets,13458,14,G,32,6,14,42.9,2,2,100.0,0,5,0,0,3,3,3,1,0,3,0,-13,Vasilije Micic,20,17,17,6,13458,03/09/2024 12:00:00 AM
164,2856,JT,Thor,Charlotte Hornets,13458,6,F,11,2,2,100.0,0,0,0,2,2,100.0,0,2,2,1,1,0,1,1,+6,JT Thor,9,8,7,3,13458,03/09/2024 12:00:00 AM
165,52,Davis,Bertans,Charlotte Hornets,13458,11,SF,32,4,14,28.6,0,0,0,3,10,30.0,3,3,6,3,2,2,0,0,-7,Davis Bertans,20,17,14,9,13458,03/09/2024 12:00:00 AM
166,3469,Bryce,McGowens,Charlotte Hornets,13458,1,G,10,0,2,0,1,2,50.0,0,1,0,0,1,1,0,1,1,0,0,-4,Bryce McGowens,2,2,1,1,13458,03/09/2024 12:00:00 AM
167,4042,Nick Jr.,Smith,Charlotte Hornets,13458,0,G,16,0,6,0,0,0,0,0,2,0,0,1,1,2,2,0,0,0,+1,Nick Jr. Smith,3,1,2,3,13458,03/09/2024 12:00:00 AM
168,2392,Dean,Wade,Cleveland Cavaliers,13459,0,PF,33,0,2,0,0,0,0,0,2,0,1,3,4,2,2,0,0,1,-25,Dean Wade,6,4,2,6,13459,03/09/2024 12:30:00 AM
169,391,Georges,Niang,Cleveland Cavaliers,13459,16,SF,36,6,10,60.0,0,0,0,4,7,57.1,0,6,6,4,2,1,1,2,+26,Georges Niang,26,22,20,10,13459,03/09/2024 12:30:00 AM
170,2630,Isaac,Okoro,Cleveland Cavaliers,13459,9,SF,43,3,5,60.0,2,3,66.7,1,1,100.0,1,5,6,2,4,1,0,2,+13,Isaac Okoro,17,15,11,8,13459,03/09/2024 12:30:00 AM
171,727,Jarrett,Allen,Cleveland Cavaliers,13459,33,C,46,9,19,47.4,15,21,71.4,0,0,0,5,13,18,3,1,2,1,2,+21,Jarrett Allen,54,51,36,21,13459,03/09/2024 12:30:00 AM
172,1860,Darius,Garland,Cleveland Cavaliers,13459,34,PG,44,13,26,50.0,6,7,85.7,2,10,20.0,2,2,4,8,5,0,6,0,+19,Darius Garland,46,38,42,12,13459,03/09/2024 12:30:00 AM
173,281,Damian,Jones,Cleveland Cavaliers,13459,0,C,7,0,2,0,0,0,0,0,0,0,0,2,2,0,1,0,1,0,-12,Damian Jones,2,2,0,2,13459,03/09/2024 12:30:00 AM
174,317,Caris,LeVert,Cleveland Cavaliers,13459,15,SG,34,5,15,33.3,3,5,60.0,2,6,33.3,0,5,5,8,1,3,2,1,+18,Caris LeVert,28,20,23,13,13459,03/09/2024 12:30:00 AM
175,2623,Sam,Merrill,Cleveland Cavaliers,13459,6,SG,19,2,9,22.2,0,0,0,2,8,25.0,1,0,1,0,3,0,0,0,-6,Sam Merrill,7,7,6,1,13459,03/09/2024 12:30:00 AM
176,4043,Craig Jr.,Porter,Cleveland Cavaliers,13459,0,G,3,0,0,0,0,0,0,0,0,0,0,0,0,0,1,0,1,0,-9,Craig Jr. Porter,0,0,0,0,13459,03/09/2024 12:30:00 AM
177,2621,Jaden,McDaniels,Minnesota Timberwolves,13459,13,PF,40,5,11,45.5,2,3,66.7,1,4,25.0,0,5,5,2,5,0,1,0,-15,Jaden McDaniels,20,18,15,7,13459,03/09/2024 12:30:00 AM
178,18,Kyle,Anderson,Minnesota Timberwolves,13459,10,SF,35,5,9,55.6,0,1,0,0,0,0,0,3,3,5,1,1,1,0,-15,Kyle Anderson,18,13,15,8,13459,03/09/2024 12:30:00 AM
179,192,Rudy,Gobert,Minnesota Timberwolves,13459,7,C,37,3,7,42.9,1,2,50.0,0,0,0,4,13,17,2,6,1,2,2,+7,Rudy Gobert,26,24,9,19,13459,03/09/2024 12:30:00 AM
180,114,Mike,Conley,Minnesota Timberwolves,13459,9,PG,32,4,11,36.4,1,1,100.0,0,5,0,1,2,3,5,1,0,1,0,-10,Mike Conley,17,12,14,8,13459,03/09/2024 12:30:00 AM
181,2584,Anthony,Edwards,Minnesota Timberwolves,13459,19,SG,42,7,27,25.9,5,5,100.0,0,7,0,1,4,5,3,3,1,5,1,-20,Anthony Edwards,27,24,22,8,13459,03/09/2024 12:30:00 AM
182,540,T.J.,Warren,Minnesota Timberwolves,13459,6,SF,11,3,3,100.0,0,0,0,0,0,0,1,3,4,0,3,0,1,0,+15,T.J. Warren,10,10,6,4,13459,03/09/2024 12:30:00 AM
183,2146,Naz,Reid,Minnesota Timberwolves,13459,34,C,32,10,18,55.6,7,8,87.5,7,11,63.6,0,5,5,2,4,1,1,2,-9,Naz Reid,41,39,36,7,13459,03/09/2024 12:30:00 AM
184,997,Jordan,McLaughlin,Minnesota Timberwolves,13459,2,PG,11,0,0,0,2,2,100.0,0,0,0,0,1,1,4,1,1,0,0,+4,Jordan McLaughlin,7,3,6,5,13459,03/09/2024 12:30:00 AM
185,1845,Nickeil,Alexander-Walker,Minnesota Timberwolves,13459,4,SG,25,2,8,25.0,0,0,0,0,3,0,0,2,2,2,1,0,0,0,-2,Nickeil Alexander-Walker,8,6,6,4,13459,03/09/2024 12:30:00 AM
186,2561,Precious,Achiuwa,New York Knicks,13460,15,PF,39,6,16,37.5,1,2,50.0,2,4,50.0,3,11,14,4,2,2,3,5,+25,Precious Achiuwa,33,29,19,18,13460,03/09/2024 12:30:00 AM
187,978,Isaiah,Hartenstein,New York Knicks,13460,5,C,20,2,3,66.7,1,1,100.0,0,0,0,2,4,6,2,3,1,2,3,+14,Isaiah Hartenstein,13,11,7,8,13460,03/09/2024 12:30:00 AM
188,946,Jalen,Brunson,New York Knicks,13460,26,PG,29,11,19,57.9,0,0,0,4,7,57.1,0,3,3,2,2,0,1,0,+23,Jalen Brunson,31,29,28,5,13460,03/09/2024 12:30:00 AM
189,791,Josh,Hart,New York Knicks,13460,19,SG,42,8,12,66.7,0,0,0,3,5,60.0,2,5,7,4,2,0,2,0,+23,Josh Hart,30,26,23,11,13460,03/09/2024 12:30:00 AM
190,962,Donte,DiVincenzo,New York Knicks,13460,11,SG,42,3,13,23.1,2,2,100.0,3,10,30.0,0,4,4,6,1,2,5,1,+24,Donte DiVincenzo,21,15,17,10,13460,03/09/2024 12:30:00 AM
191,4007,Jacob,Toppin,New York Knicks,13460,0,F,1,0,0,0,0,0,0,0,0,0,0,0,0,0,0,0,0,0,+2,Jacob Toppin,0,0,0,0,13460,03/09/2024 12:30:00 AM
192,60,Bojan,Bogdanovic,New York Knicks,13460,6,SF,12,2,6,33.3,1,2,50.0,1,3,33.3,0,0,0,0,0,0,1,0,-4,Bojan Bogdanovic,6,6,6,0,13460,03/09/2024 12:30:00 AM
193,2849,Jericho,Sims,New York Knicks,13460,2,C,28,1,1,100.0,0,0,0,0,0,0,3,3,6,1,2,0,0,1,+10,Jericho Sims,9,8,3,7,13460,03/09/2024 12:30:00 AM
194,2832,Miles,McBride,New York Knicks,13460,14,PG,19,5,7,71.4,1,1,100.0,3,3,100.0,1,2,3,1,2,2,1,0,+1,Miles McBride,18,17,15,4,13460,03/09/2024 12:30:00 AM
195,84,Alec,Burks,New York Knicks,13460,0,SG,5,0,2,0,0,0,0,0,1,0,0,0,0,0,0,0,0,0,-2,Alec Burks,0,0,0,0,13460,03/09/2024 12:30:00 AM
196,1001,Shake,Milton,New York Knicks,13460,0,SG,1,0,0,0,0,0,0,0,0,0,0,0,0,0,0,0,0,0,+2,Shake Milton,0,0,0,0,13460,03/09/2024 12:30:00 AM
197,2111,Charlie,Brown Jr.,New York Knicks,13460,0,G,1,0,0,0,0,0,0,0,0,0,0,0,0,0,0,0,0,0,+2,Charlie Brown Jr.,0,0,0,0,13460,03/09/2024 12:30:00 AM
198,3414,Paolo,Banchero,Orlando Magic,13460,23,PF,36,9,20,45.0,3,5,60.0,2,3,66.7,2,7,9,2,3,2,4,4,-23,Paolo Banchero,34,32,25,11,13460,03/09/2024 12:30:00 AM
199,2858,Franz,Wagner,Orlando Magic,13460,13,SF,34,6,20,30.0,1,1,100.0,0,5,0,0,4,4,0,0,1,0,0,-25,Franz Wagner,17,17,13,4,13460,03/09/2024 12:30:00 AM
200,950,Wendell,Carter Jr.,Orlando Magic,13460,7,C,25,2,8,25.0,1,2,50.0,2,4,50.0,7,2,9,2,2,0,3,2,-22,Wendell Carter Jr.,18,16,9,11,13460,03/09/2024 12:30:00 AM
201,220,Gary,Harris,Orlando Magic,13460,5,SG,24,2,5,40.0,0,0,0,1,3,33.3,0,1,1,1,0,0,1,0,-20,Gary Harris,7,6,6,2,13460,03/09/2024 12:30:00 AM
202,4010,Anthony,Black,Orlando Magic,13460,0,G,23,0,5,0,0,0,0,0,2,0,0,2,2,0,2,0,1,0,-18,Anthony Black,2,2,0,2,13460,03/09/2024 12:30:00 AM
203,801,Jonathan,Isaac,Orlando Magic,13460,11,PF,16,4,6,66.7,2,2,100.0,1,2,50.0,2,4,6,0,0,1,0,2,+2,Jonathan Isaac,17,17,11,6,13460,03/09/2024 12:30:00 AM
204,1883,Chuma,Okeke,Orlando Magic,13460,2,PF,3,1,3,33.3,0,0,0,0,2,0,0,1,1,0,0,0,0,0,-1,Chuma Okeke,3,3,2,1,13460,03/09/2024 12:30:00 AM
205,1892,Admiral,Schofield,Orlando Magic,13460,0,SF,3,0,1,0,0,0,0,0,1,0,0,1,1,0,0,0,0,0,-1,Admiral Schofield,1,1,0,1,13460,03/09/2024 12:30:00 AM
206,1037,Moritz,Wagner,Orlando Magic,13460,4,C,12,1,2,50.0,2,2,100.0,0,0,0,0,1,1,1,1,0,1,0,+4,Moritz Wagner,6,5,5,2,13460,03/09/2024 12:30:00 AM
207,1848,Goga,Bitadze,Orlando Magic,13460,0,C,7,0,0,0,0,0,0,0,0,0,0,0,0,0,1,0,1,0,-8,Goga Bitadze,0,0,0,0,13460,03/09/2024 12:30:00 AM
208,779,Markelle,Fultz,Orlando Magic,13460,2,PG,9,1,4,25.0,0,0,0,0,1,0,0,1,1,0,1,0,1,0,0,Markelle Fultz,3,3,2,1,13460,03/09/2024 12:30:00 AM
209,2563,Cole,Anthony,Orlando Magic,13460,4,PG,25,1,4,25.0,2,4,50.0,0,2,0,1,0,1,5,2,1,1,2,-6,Cole Anthony,10,5,9,6,13460,03/09/2024 12:30:00 AM
210,258,Joe,Ingles,Orlando Magic,13460,1,SG,17,0,0,0,1,2,50.0,0,0,0,0,1,1,1,0,2,0,0,+2,Joe Ingles,3,2,2,2,13460,03/09/2024 12:30:00 AM
211,3449,Caleb,Houstan,Orlando Magic,13460,2,G,5,0,1,0,2,2,100.0,0,1,0,0,0,0,0,0,0,0,0,-4,Caleb Houstan,2,2,2,0,13460,03/09/2024 12:30:00 AM
212,982,Jaren,Jackson Jr.,Memphis Grizzlies,13461,21,PF,35,8,19,42.1,5,8,62.5,0,2,0,2,7,9,3,4,3,2,2,-13,Jaren Jackson Jr.,33,30,24,12,13461,03/09/2024 12:30:00 AM
213,2786,Santi,Aldama,Memphis Grizzlies,13461,13,PF,32,5,7,71.4,1,2,50.0,2,3,66.7,1,4,5,0,0,1,1,3,-14,Santi Aldama,18,18,13,5,13461,03/09/2024 12:30:00 AM
214,2177,John,Konchar,Memphis Grizzlies,13461,5,SG,29,2,4,50.0,0,0,0,1,2,50.0,2,3,5,3,1,0,2,1,-9,John Konchar,13,10,8,8,13461,03/09/2024 12:30:00 AM
215,3341,Jordan,Goodwin,Memphis Grizzlies,13461,5,G,24,2,8,25.0,0,0,0,1,3,33.3,0,0,0,4,2,0,0,1,-10,Jordan Goodwin,9,5,9,4,13461,03/09/2024 12:30:00 AM
216,3508,Vince,Williams Jr.,Memphis Grizzlies,13461,14,G,37,4,8,50.0,3,4,75.0,3,5,60.0,0,5,5,6,4,0,6,1,-7,Vince Williams Jr.,25,19,20,11,13461,03/09/2024 12:30:00 AM
217,2647,Lamar,Stevens,Memphis Grizzlies,13461,13,PF,29,3,12,25.0,6,6,100.0,1,4,25.0,1,4,5,0,2,1,0,2,+3,Lamar Stevens,18,18,13,5,13461,03/09/2024 12:30:00 AM
218,970,Wenyen,Gabriel,Memphis Grizzlies,13461,2,F,13,1,3,33.3,0,2,0,0,0,0,2,2,4,2,2,1,1,0,+6,Wenyen Gabriel,8,6,4,6,13461,03/09/2024 12:30:00 AM
219,3993,Matthew,Hurt,Memphis Grizzlies,13461,0,F,0,0,0,0,0,0,0,0,0,0,0,0,0,0,0,0,0,0,0,Matthew Hurt,0,0,0,0,13461,03/09/2024 12:30:00 AM
220,3460,Jake,LaRavia,Memphis Grizzlies,13461,14,F,26,3,10,30.0,6,6,100.0,2,7,28.6,2,1,3,3,2,3,0,1,+2,Jake LaRavia,20,17,17,6,13461,03/09/2024 12:30:00 AM
221,4003,Trey,Jemison,Memphis Grizzlies,13461,5,C,16,2,3,66.7,1,2,50.0,0,0,0,0,2,2,0,2,1,1,0,+7,Trey Jemison,7,7,5,2,13461,03/09/2024 12:30:00 AM
222,2569,Saddiq,Bey,Atlanta Hawks,13461,3,SF,37,1,12,8.3,1,2,50.0,0,6,0,4,5,9,2,1,1,3,1,+7,Saddiq Bey,14,12,5,11,13461,03/09/2024 12:30:00 AM
223,92,Clint,Capela,Atlanta Hawks,13461,15,C,27,5,13,38.5,5,5,100.0,0,0,0,5,6,11,3,2,0,1,1,+13,Clint Capela,29,26,18,14,13461,03/09/2024 12:30:00 AM
224,743,Bogdan,Bogdanovic,Atlanta Hawks,13461,16,SG,35,6,14,42.9,1,2,50.0,3,6,50.0,2,4,6,3,4,1,4,2,+15,Bogdan Bogdanovic,25,22,19,9,13461,03/09/2024 12:30:00 AM
225,382,Dejounte,Murray,Atlanta Hawks,13461,41,SG,40,17,25,68.0,1,1,100.0,6,10,60.0,0,7,7,6,1,2,2,0,+15,Dejounte Murray,54,48,47,13,13461,03/09/2024 12:30:00 AM
226,2608,Vit,Krejci,Atlanta Hawks,13461,3,G,22,1,5,20.0,0,0,0,1,4,25.0,1,0,1,5,1,2,0,1,+7,Vit Krejci,9,4,8,6,13461,03/09/2024 12:30:00 AM
227,1858,Bruno,Fernando,Atlanta Hawks,13461,1,PF,21,0,1,0,1,2,50.0,0,0,0,1,6,7,0,3,2,1,0,-6,Bruno Fernando,8,8,1,7,13461,03/09/2024 12:30:00 AM
228,1868,De'Andre,Hunter,Atlanta Hawks,13461,12,SF,29,4,11,36.4,1,3,33.3,3,6,50.0,0,2,2,2,5,1,3,0,+6,De'Andre Hunter,16,14,14,4,13461,03/09/2024 12:30:00 AM
229,341,Wesley,Matthews,Atlanta Hawks,13461,0,SG,5,0,0,0,0,0,0,0,0,0,0,0,0,0,0,0,0,0,-7,Wesley Matthews,0,0,0,0,13461,03/09/2024 12:30:00 AM
230,2327,Garrison,Mathews,Atlanta Hawks,13461,6,SG,16,2,4,50.0,0,0,0,2,3,66.7,2,1,3,0,3,0,0,0,-7,Garrison Mathews,9,9,6,3,13461,03/09/2024 12:30:00 AM
231,2589,Trent,Forrest,Atlanta Hawks,13461,2,G,8,1,2,50.0,0,0,0,0,0,0,0,1,1,0,0,0,0,0,-8,Trent Forrest,3,3,2,1,13461,03/09/2024 12:30:00 AM
232,3448,Chet,Holmgren,Oklahoma City Thunder,13462,7,PF,29,3,9,33.3,0,0,0,1,4,25.0,0,3,3,3,1,0,0,0,-1,Chet Holmgren,13,10,10,6,13462,03/09/2024 01:00:00 AM
233,3504,Jalen,Williams,Oklahoma City Thunder,13462,15,F,30,6,12,50.0,2,2,100.0,1,3,33.3,1,4,5,4,4,1,3,1,-2,Jalen Williams,24,20,19,9,13462,03/09/2024 01:00:00 AM
234,972,Shai,Gilgeous-Alexander,Oklahoma City Thunder,13462,37,PG,36,13,25,52.0,9,11,81.8,2,7,28.6,0,5,5,6,2,1,1,2,+17,Shai Gilgeous-Alexander,48,42,43,11,13462,03/09/2024 01:00:00 AM
235,2808,Josh,Giddey,Oklahoma City Thunder,13462,11,SG,23,5,9,55.6,0,0,0,1,3,33.3,1,8,9,6,0,0,1,0,-7,Josh Giddey,26,20,17,15,13462,03/09/2024 01:00:00 AM
236,2040,Luguentz,Dort,Oklahoma City Thunder,13462,9,G,33,4,9,44.4,0,0,0,1,6,16.7,1,6,7,2,2,1,1,1,+19,Luguentz Dort,18,16,11,9,13462,03/09/2024 01:00:00 AM
237,3505,Jaylin,Williams,Oklahoma City Thunder,13462,5,F,17,2,3,66.7,0,0,0,1,1,100.0,2,5,7,0,3,1,0,1,+3,Jaylin Williams,12,12,5,7,13462,03/09/2024 01:00:00 AM
238,227,Gordon,Hayward,Oklahoma City Thunder,13462,3,SF,18,1,3,33.3,0,0,0,1,2,50.0,0,2,2,4,2,1,0,0,+11,Gordon Hayward,9,5,7,6,13462,03/09/2024 01:00:00 AM
239,2604,Isaiah,Joe,Oklahoma City Thunder,13462,10,SG,19,4,10,40.0,0,0,0,2,6,33.3,2,2,4,1,0,0,1,0,+14,Isaiah Joe,15,14,11,5,13462,03/09/2024 01:00:00 AM
240,2863,Aaron,Wiggins,Oklahoma City Thunder,13462,7,SG,19,3,5,60.0,0,0,0,1,3,33.3,2,1,3,1,1,0,0,2,-5,Aaron Wiggins,11,10,8,4,13462,03/09/2024 01:00:00 AM
241,4009,Cason,Wallace,Oklahoma City Thunder,13462,3,G,14,1,4,25.0,0,0,0,1,3,33.3,0,0,0,1,1,0,2,1,-14,Cason Wallace,4,3,4,1,13462,03/09/2024 01:00:00 AM
242,1018,Duncan,Robinson,Miami Heat,13462,9,F,28,3,8,37.5,0,0,0,3,8,37.5,0,2,2,1,1,1,1,0,-8,Duncan Robinson,12,11,10,3,13462,03/09/2024 01:00:00 AM
243,3453,Nikola,Jovic,Miami Heat,13462,7,F,30,2,5,40.0,2,2,100.0,1,3,33.3,0,8,8,3,1,0,1,2,+4,Nikola Jovic,18,15,10,11,13462,03/09/2024 01:00:00 AM
244,86,Jimmy,Butler,Miami Heat,13462,20,SF,37,8,16,50.0,4,6,66.7,0,3,0,2,8,10,8,1,0,1,0,+3,Jimmy Butler,38,30,28,18,13462,03/09/2024 01:00:00 AM
245,724,Bam,Adebayo,Miami Heat,13462,5,C,31,1,9,11.1,3,4,75.0,0,0,0,4,6,10,4,1,1,4,2,-18,Bam Adebayo,19,15,9,14,13462,03/09/2024 01:00:00 AM
246,458,Terry,Rozier,Miami Heat,13462,14,SG,32,6,14,42.9,0,0,0,2,4,50.0,1,4,5,4,4,1,1,0,-20,Terry Rozier,23,19,18,9,13462,03/09/2024 01:00:00 AM
247,1815,Haywood,Highsmith,Miami Heat,13462,0,F,5,0,0,0,0,0,0,0,0,0,0,0,0,1,1,0,0,0,-4,Haywood Highsmith,1,0,1,1,13462,03/09/2024 01:00:00 AM
248,2242,Caleb,Martin,Miami Heat,13462,7,SF,30,3,10,30.0,0,0,0,1,4,25.0,0,3,3,0,4,0,1,1,+4,Caleb Martin,10,10,7,3,13462,03/09/2024 01:00:00 AM
249,365,Patty,Mills,Miami Heat,13462,13,PG,16,5,7,71.4,0,0,0,3,4,75.0,0,2,2,0,1,0,1,0,+13,Patty Mills,15,15,13,2,13462,03/09/2024 01:00:00 AM
250,4046,Jaime Jr.,Jaquez,Miami Heat,13462,25,G,31,10,13,76.9,4,6,66.7,1,3,33.3,0,3,3,3,2,3,0,0,-9,Jaime Jr. Jaquez,31,28,28,6,13462,03/09/2024 01:00:00 AM
251,126,Anthony,Davis,Los Angeles Lakers,13463,22,PF,41,10,21,47.6,2,2,100.0,0,1,0,1,12,13,5,3,0,0,3,-3,Anthony Davis,40,35,27,18,13463,03/09/2024 03:00:00 AM
252,1862,Rui,Hachimura,Los Angeles Lakers,13463,12,PF,38,5,16,31.3,1,2,50.0,1,6,16.7,0,5,5,2,1,0,0,0,-2,Rui Hachimura,19,17,14,7,13463,03/09/2024 03:00:00 AM
253,142,Spencer,Dinwiddie,Los Angeles Lakers,13463,5,PG,34,1,3,33.3,2,2,100.0,1,2,50.0,0,2,2,3,3,1,0,2,-5,Spencer Dinwiddie,10,7,8,5,13463,03/09/2024 03:00:00 AM
254,462,D'Angelo,Russell,Los Angeles Lakers,13463,44,PG,38,17,25,68.0,1,1,100.0,9,12,75.0,2,4,6,9,5,0,2,1,+1,D'Angelo Russell,59,50,53,15,13463,03/09/2024 03:00:00 AM
255,2845,Austin,Reaves,Los Angeles Lakers,13463,18,SG,37,7,12,58.3,2,4,50.0,2,5,40.0,0,5,5,7,1,1,2,0,-1,Austin Reaves,30,23,25,12,13463,03/09/2024 03:00:00 AM
256,437,Taurean,Prince,Los Angeles Lakers,13463,8,PF,16,3,7,42.9,0,0,0,2,5,40.0,1,5,6,1,0,0,0,0,+2,Taurean Prince,15,14,9,7,13463,03/09/2024 03:00:00 AM
257,1889,Cam,Reddish,Los Angeles Lakers,13463,6,SF,15,2,4,50.0,1,2,50.0,1,3,33.3,0,0,0,0,0,0,0,1,0,Cam Reddish,6,6,6,0,13463,03/09/2024 03:00:00 AM
258,1864,Jaxson,Hayes,Los Angeles Lakers,13463,8,C,17,2,2,100.0,4,6,66.7,0,0,0,0,1,1,0,3,0,1,0,+7,Jaxson Hayes,9,9,8,1,13463,03/09/2024 03:00:00 AM
259,3427,Max,Christie,Los Angeles Lakers,13463,0,G,3,0,0,0,0,0,0,0,0,0,0,0,0,0,0,0,0,0,+6,Max Christie,0,0,0,0,13463,03/09/2024 03:00:00 AM
260,121,Jae,Crowder,Milwaukee Bucks,13463,4,PF,21,1,5,20.0,2,2,100.0,0,2,0,1,2,3,0,2,1,0,0,-3,Jae Crowder,7,7,4,3,13463,03/09/2024 03:00:00 AM
261,20,Giannis,Antetokounmpo,Milwaukee Bucks,13463,34,PF,39,14,23,60.9,5,7,71.4,1,3,33.3,2,12,14,12,2,1,4,1,-4,Giannis Antetokounmpo,60,48,46,26,13463,03/09/2024 03:00:00 AM
262,323,Brook,Lopez,Milwaukee Bucks,13463,11,C,32,4,6,66.7,0,0,0,3,3,100.0,0,3,3,1,2,0,0,1,+13,Brook Lopez,15,14,12,4,13463,03/09/2024 03:00:00 AM
263,319,Damian,Lillard,Milwaukee Bucks,13463,28,PG,38,10,23,43.5,4,4,100.0,4,12,33.3,0,5,5,12,2,0,1,0,+13,Damian Lillard,45,33,40,17,13463,03/09/2024 03:00:00 AM
264,46,Malik,Beasley,Milwaukee Bucks,13463,14,SG,34,5,12,41.7,0,0,0,4,9,44.4,1,3,4,2,3,1,1,0,+11,Malik Beasley,20,18,16,6,13463,03/09/2024 03:00:00 AM
265,181,Danilo,Gallinari,Milwaukee Bucks,13463,0,PF,3,0,1,0,0,0,0,0,1,0,0,0,0,0,1,0,0,0,-6,Danilo Gallinari,0,0,0,0,13463,03/09/2024 03:00:00 AM
266,431,Bobby,Portis,Milwaukee Bucks,13463,14,F,26,6,13,46.2,2,2,100.0,0,4,0,1,7,8,0,2,0,0,0,-11,Bobby Portis,22,22,14,8,13463,03/09/2024 03:00:00 AM
267,53,Patrick,Beverley,Milwaukee Bucks,13463,0,PG,16,0,3,0,0,0,0,0,2,0,0,0,0,0,2,0,0,0,-16,Patrick Beverley,0,0,0,0,13463,03/09/2024 03:00:00 AM
268,115,Pat,Connaughton,Milwaukee Bucks,13463,17,SG,31,6,7,85.7,1,2,50.0,4,5,80.0,1,5,6,1,1,0,0,0,-2,Pat Connaughton,24,23,18,7,13463,03/09/2024 03:00:00 AM
269,4015,Toumani,Camara,Portland Trail Blazers,13464,9,F,30,2,4,50.0,4,4,100.0,1,2,50.0,3,4,7,0,1,1,1,0,-3,Toumani Camara,16,16,9,7,13464,03/09/2024 03:00:00 AM
270,4017,Kris,Murray,Portland Trail Blazers,13464,12,F,33,5,12,41.7,1,2,50.0,1,6,16.7,4,7,11,7,0,0,2,1,-3,Kris Murray,30,23,19,18,13464,03/09/2024 03:00:00 AM
271,4018,Duop,Reath,Portland Trail Blazers,13464,16,C,32,6,13,46.2,0,0,0,4,6,66.7,3,3,6,3,5,0,1,1,-3,Duop Reath,25,22,19,9,13464,03/09/2024 03:00:00 AM
272,1023,Anfernee,Simons,Portland Trail Blazers,13464,23,SG,34,7,14,50.0,5,7,71.4,4,7,57.1,0,3,3,3,2,3,6,0,-14,Anfernee Simons,29,26,26,6,13464,03/09/2024 03:00:00 AM
273,2788,Dalano,Banton,Portland Trail Blazers,13464,30,G,38,10,27,37.0,6,8,75.0,4,10,40.0,1,7,8,5,2,1,2,1,-9,Dalano Banton,43,38,35,13,13464,03/09/2024 03:00:00 AM
274,3714,Justin,Minaya,Portland Trail Blazers,13464,0,F,1,0,1,0,0,0,0,0,0,0,0,0,0,0,0,0,0,0,0,Justin Minaya,0,0,0,0,13464,03/09/2024 03:00:00 AM
275,2160,Moses,Brown,Portland Trail Blazers,13464,4,C,10,2,6,33.3,0,0,0,0,0,0,3,2,5,0,0,0,0,0,-7,Moses Brown,9,9,4,5,13464,03/09/2024 03:00:00 AM
276,1896,Matisse,Thybulle,Portland Trail Blazers,13464,5,SG,19,2,5,40.0,0,2,0,1,2,50.0,3,0,3,0,2,0,1,1,-22,Matisse Thybulle,8,8,5,3,13464,03/09/2024 03:00:00 AM
277,2594,Ashton,Hagans,Portland Trail Blazers,13464,6,G,18,2,6,33.3,1,2,50.0,1,2,50.0,1,3,4,2,2,0,1,1,-11,Ashton Hagans,12,10,8,6,13464,03/09/2024 03:00:00 AM
278,4069,R.,Rupert,Portland Trail Blazers,13464,2,G,22,1,1,100.0,0,0,0,0,0,0,1,1,2,2,2,0,3,0,-8,R. Rupert,6,4,4,4,13464,03/09/2024 03:00:00 AM
279,3489,Jabari,Smith Jr.,Houston Rockets,13464,15,PF,39,5,11,45.5,2,2,100.0,3,7,42.9,1,8,9,4,2,2,2,2,+11,Jabari Smith Jr.,28,24,19,13,13464,03/09/2024 03:00:00 AM
280,749,Dillon,Brooks,Houston Rockets,13464,4,SF,21,1,5,20.0,1,2,50.0,1,3,33.3,0,3,3,1,1,1,0,0,-6,Dillon Brooks,8,7,5,4,13464,03/09/2024 03:00:00 AM
281,2847,Alperen,Sengun,Houston Rockets,13464,19,C,32,7,15,46.7,5,8,62.5,0,0,0,5,4,9,6,2,1,1,1,+2,Alperen Sengun,34,28,25,15,13464,03/09/2024 03:00:00 AM
282,527,Fred,VanVleet,Houston Rockets,13464,18,PG,34,5,13,38.5,4,4,100.0,4,8,50.0,0,1,1,10,1,1,0,0,+12,Fred VanVleet,29,19,28,11,13464,03/09/2024 03:00:00 AM
283,2810,Jalen,Green,Houston Rockets,13464,27,SG,34,11,19,57.9,1,2,50.0,4,9,44.4,0,3,3,5,1,2,2,0,+2,Jalen Green,35,30,32,8,13464,03/09/2024 03:00:00 AM
284,3977,Amen,Thompson,Houston Rockets,13464,16,F,26,7,10,70.0,2,2,100.0,0,1,0,1,7,8,3,3,2,1,5,+24,Amen Thompson,27,24,19,11,13464,03/09/2024 03:00:00 AM
285,3978,Cam,Whitmore,Houston Rockets,13464,13,F,24,4,10,40.0,4,6,66.7,1,5,20.0,4,4,8,0,2,1,1,1,+19,Cam Whitmore,21,21,13,8,13464,03/09/2024 03:00:00 AM
286,1485,Jock,Landale,Houston Rockets,13464,5,C,13,2,4,50.0,0,0,0,1,1,100.0,2,1,3,3,1,0,0,1,+10,Jock Landale,11,8,8,6,13464,03/09/2024 03:00:00 AM
287,979,Aaron,Holiday,Houston Rockets,13464,6,G,15,3,7,42.9,0,0,0,0,3,0,0,1,1,1,2,2,0,0,+6,Aaron Holiday,8,7,7,2,13464,03/09/2024 03:00:00 AM
288,3931,Jeenathan,Williams,Houston Rockets,13464,0,G,1,0,0,0,0,0,0,0,0,0,1,1,2,0,0,0,0,0,0,Jeenathan Williams,2,2,0,2,13464,03/09/2024 03:00:00 AM
289,189,Paul,George,LA Clippers,13465,22,F,40,8,16,50.0,4,5,80.0,2,6,33.3,0,5,5,9,5,2,3,3,+13,Paul George,36,27,31,14,13465,03/09/2024 09:00:00 PM
290,314,Kawhi,Leonard,LA Clippers,13465,19,SF,38,8,15,53.3,3,3,100.0,0,1,0,2,7,9,4,1,0,2,1,+4,Kawhi Leonard,32,28,23,13,13465,03/09/2024 09:00:00 PM
291,575,Ivica,Zubac,LA Clippers,13465,16,C,25,7,9,77.8,2,2,100.0,0,0,0,2,7,9,2,3,0,1,1,+18,Ivica Zubac,27,25,18,11,13465,03/09/2024 09:00:00 PM
292,216,James,Harden,LA Clippers,13465,14,SG,34,4,10,40.0,2,2,100.0,4,10,40.0,0,11,11,10,2,1,1,0,+4,James Harden,35,25,24,21,13465,03/09/2024 09:00:00 PM
293,1877,Terance,Mann,LA Clippers,13465,7,SG,25,3,7,42.9,0,0,0,1,3,33.3,0,1,1,1,2,0,1,0,0,Terance Mann,9,8,8,2,13465,03/09/2024 09:00:00 PM
294,886,Daniel,Theis,LA Clippers,13465,6,C,21,3,8,37.5,0,0,0,0,1,0,3,0,3,2,4,0,2,1,-7,Daniel Theis,11,9,8,5,13465,03/09/2024 09:00:00 PM
295,2816,Bones,Hyland,LA Clippers,13465,10,PG,13,3,3,100.0,1,2,50.0,3,3,100.0,0,2,2,1,1,3,1,0,+6,Bones Hyland,13,12,11,3,13465,03/09/2024 09:00:00 PM
296,2115,Amir,Coffey,LA Clippers,13465,0,SG,15,0,2,0,0,0,0,0,2,0,0,1,1,0,0,0,0,0,+7,Amir Coffey,1,1,0,1,13465,03/09/2024 09:00:00 PM
297,434,Norman,Powell,LA Clippers,13465,18,G,27,6,14,42.9,4,4,100.0,2,9,22.2,2,2,4,0,2,1,2,0,+5,Norman Powell,22,22,18,4,13465,03/09/2024 09:00:00 PM
298,3984,Jordan,Miller,LA Clippers,13465,0,G,1,0,0,0,0,0,0,0,0,0,0,0,0,0,0,0,0,0,0,Jordan Miller,0,0,0,0,13465,03/09/2024 09:00:00 PM
299,3983,Kobe,Brown,LA Clippers,13465,0,G,0,0,0,0,0,0,0,0,0,0,0,0,0,0,0,0,0,0,0,Kobe Brown,0,0,0,0,13465,03/09/2024 09:00:00 PM
300,136,DeMar,DeRozan,Chicago Bulls,13465,24,SF,42,8,19,42.1,8,9,88.9,0,3,0,1,7,8,10,2,0,2,0,-10,DeMar DeRozan,42,32,34,18,13465,03/09/2024 09:00:00 PM
301,534,Nikola,Vucevic,Chicago Bulls,13465,22,C,35,9,22,40.9,2,2,100.0,2,4,50.0,4,7,11,2,1,0,1,0,-11,Nikola Vucevic,35,33,24,13,13465,03/09/2024 09:00:00 PM
302,1900,Coby,White,Chicago Bulls,13465,19,PG,41,7,16,43.8,2,2,100.0,3,9,33.3,1,4,5,4,4,0,5,0,-2,Coby White,28,24,23,9,13465,03/09/2024 09:00:00 PM
303,631,Alex,Caruso,Chicago Bulls,13465,9,SG,36,4,7,57.1,0,0,0,1,3,33.3,0,1,1,6,3,4,0,2,-11,Alex Caruso,16,10,15,7,13465,03/09/2024 09:00:00 PM
304,2802,Ayo,Dosunmu,Chicago Bulls,13465,13,SG,36,5,11,45.5,0,0,0,3,7,42.9,0,2,2,4,4,2,1,1,-7,Ayo Dosunmu,19,15,17,6,13465,03/09/2024 09:00:00 PM
305,2853,Terry,Taylor,Chicago Bulls,13465,0,F,1,0,0,0,0,0,0,0,0,0,0,0,0,0,0,0,0,0,0,Terry Taylor,0,0,0,0,13465,03/09/2024 09:00:00 PM
306,3494,Dalen,Terry,Chicago Bulls,13465,0,F,1,0,0,0,0,2,0,0,0,0,0,0,0,0,0,0,0,0,0,Dalen Terry,0,0,0,0,13465,03/09/2024 09:00:00 PM
307,3954,Julian,Phillips,Chicago Bulls,13465,0,F,5,0,1,0,0,0,0,0,1,0,0,0,0,0,2,0,0,0,-2,Julian Phillips,0,0,0,0,13465,03/09/2024 09:00:00 PM
308,765,Torrey,Craig,Chicago Bulls,13465,6,SF,13,2,6,33.3,0,0,0,2,5,40.0,2,1,3,0,2,1,2,0,-6,Torrey Craig,9,9,6,3,13465,03/09/2024 09:00:00 PM
309,3951,Onuralp,Bitim,Chicago Bulls,13465,6,SF,10,2,3,66.7,0,0,0,2,3,66.7,1,0,1,0,0,0,0,0,-5,Onuralp Bitim,7,7,6,1,13465,03/09/2024 09:00:00 PM
310,147,Andre,Drummond,Chicago Bulls,13465,3,C,12,0,1,0,3,4,75.0,0,0,0,3,4,7,0,1,0,1,0,+1,Andre Drummond,10,10,3,7,13465,03/09/2024 09:00:00 PM
311,949,Jevon,Carter,Chicago Bulls,13465,0,PG,7,0,0,0,0,0,0,0,0,0,0,0,0,1,0,0,0,0,+3,Jevon Carter,1,0,1,1,13465,03/09/2024 09:00:00 PM
