,player_id,firstname,lastname,team,game_id,points,position,minutes,fgm,fga,fgp,ftm,fta,ftp,tpm,tpa,tpp,offReb,defReb,totReb,assists,pFouls,steals,turnovers,blocks,plusMinus,First Last Name,Points_Rebounds_Assist,Points_Rebounds,Points_Assist,Rebounds_Assist,id,date,home_team,away_team
0,1891,Luka,Samanic,Utah Jazz,13716,22,F,34,7,17,41.2,7,9,77.8,1,7,14.3,3,3,6,2,2,1,2,0,+7,Luka Samanic,30,28,24,8,13716,2024-04-12 01:00:00,Utah Jazz,Houston Rockets
1,4031,Taylor,Hendricks,Utah Jazz,13716,5,F,19,2,3,66.7,0,0,0,1,2,50.0,1,3,4,4,1,3,0,1,+3,Taylor Hendricks,13,9,9,8,13716,2024-04-12 01:00:00,Utah Jazz,Houston Rockets
2,2785,Omer,Yurtseven,Utah Jazz,13716,10,C,19,5,9,55.6,0,0,0,0,1,0,2,3,5,0,0,0,0,0,-3,Omer Yurtseven,15,15,10,5,13716,2024-04-12 01:00:00,Utah Jazz,Houston Rockets
3,3454,Johnny,Juzang,Utah Jazz,13716,10,G,24,3,5,60.0,2,2,100.0,2,3,66.7,0,2,2,1,3,0,3,1,+1,Johnny Juzang,13,12,11,3,13716,2024-04-12 01:00:00,Utah Jazz,Houston Rockets
4,4029,Keyonte,George,Utah Jazz,13716,20,G,33,7,14,50.0,4,5,80.0,2,6,33.3,0,4,4,5,3,2,5,0,-2,Keyonte George,29,24,25,9,13716,2024-04-12 01:00:00,Utah Jazz,Houston Rockets
5,1847,Darius,Bazley,Utah Jazz,13716,8,F,23,4,5,80.0,0,0,0,0,1,0,2,5,7,2,0,0,1,2,-1,Darius Bazley,17,15,10,9,13716,2024-04-12 01:00:00,Utah Jazz,Houston Rockets
6,3463,Kenneth,Lofton Jr.,Utah Jazz,13716,14,F,27,5,7,71.4,2,4,50.0,2,3,66.7,5,4,9,5,3,2,2,1,+5,Kenneth Lofton Jr.,28,23,19,14,13716,2024-04-12 01:00:00,Utah Jazz,Houston Rockets
7,4034,Brice,Sensabaugh,Utah Jazz,13716,17,F,24,5,12,41.7,3,3,100.0,4,9,44.4,1,5,6,3,2,0,0,0,+4,Brice Sensabaugh,26,23,20,9,13716,2024-04-12 01:00:00,Utah Jazz,Houston Rockets
8,3358,Micah,Potter,Utah Jazz,13716,2,C,8,1,2,50.0,0,0,0,0,1,0,0,1,1,0,1,0,0,0,-5,Micah Potter,3,3,2,1,13716,2024-04-12 01:00:00,Utah Jazz,Houston Rockets
9,1867,Talen,Horton-Tucker,Utah Jazz,13716,16,SG,29,5,13,38.5,4,4,100.0,2,6,33.3,1,4,5,5,5,0,1,2,+6,Talen Horton-Tucker,26,21,21,10,13716,2024-04-12 01:00:00,Utah Jazz,Houston Rockets
10,3489,Jabari,Smith Jr.,Houston Rockets,13716,7,PF,26,3,6,50.0,0,0,0,1,4,25.0,0,3,3,2,1,0,0,2,-2,Jabari Smith Jr.,12,10,9,5,13716,2024-04-12 01:00:00,Utah Jazz,Houston Rockets
11,3977,Amen,Thompson,Houston Rockets,13716,15,F,35,6,12,50.0,3,4,75.0,0,1,0,6,4,10,4,0,2,1,0,-1,Amen Thompson,29,25,19,14,13716,2024-04-12 01:00:00,Utah Jazz,Houston Rockets
12,749,Dillon,Brooks,Houston Rockets,13716,8,SF,27,4,14,28.6,0,0,0,0,5,0,3,1,4,1,5,2,1,0,-6,Dillon Brooks,13,12,9,5,13716,2024-04-12 01:00:00,Utah Jazz,Houston Rockets
13,527,Fred,VanVleet,Houston Rockets,13716,42,PG,40,12,30,40.0,9,10,90.0,9,13,69.2,3,4,7,7,3,2,2,1,+12,Fred VanVleet,56,49,49,14,13716,2024-04-12 01:00:00,Utah Jazz,Houston Rockets
14,2810,Jalen,Green,Houston Rockets,13716,3,SG,19,1,7,14.3,0,0,0,1,5,20.0,0,1,1,1,2,0,3,0,-23,Jalen Green,5,4,4,2,13716,2024-04-12 01:00:00,Utah Jazz,Houston Rockets
15,207,Jeff,Green,Houston Rockets,13716,13,PF,22,4,7,57.1,2,2,100.0,3,5,60.0,1,5,6,0,1,0,0,0,-1,Jeff Green,19,19,13,6,13716,2024-04-12 01:00:00,Utah Jazz,Houston Rockets
16,3978,Cam,Whitmore,Houston Rockets,13716,18,F,27,5,11,45.5,4,4,100.0,4,8,50.0,0,4,4,4,2,0,2,2,+6,Cam Whitmore,26,22,22,8,13716,2024-04-12 01:00:00,Utah Jazz,Houston Rockets
17,82,Reggie,Bullock,Houston Rockets,13716,0,SF,5,0,0,0,0,0,0,0,0,0,0,1,1,0,0,1,0,0,-12,Reggie Bullock,1,1,0,1,13716,2024-04-12 01:00:00,Utah Jazz,Houston Rockets
18,1485,Jock,Landale,Houston Rockets,13716,9,C,27,3,3,100.0,2,2,100.0,1,1,100.0,1,0,1,2,4,1,1,1,+10,Jock Landale,12,10,11,3,13716,2024-04-12 01:00:00,Utah Jazz,Houston Rockets
19,979,Aaron,Holiday,Houston Rockets,13716,6,G,11,2,5,40.0,0,0,0,2,5,40.0,2,0,2,1,0,0,0,0,+2,Aaron Holiday,9,8,7,3,13716,2024-04-12 01:00:00,Utah Jazz,Houston Rockets
20,3496,Jabari,Walker,Portland Trail Blazers,13717,17,F,36,6,14,42.9,3,4,75.0,2,3,66.7,7,9,16,1,3,1,0,0,-14,Jabari Walker,34,33,18,17,13717,2024-04-12 02:00:00,Portland Trail Blazers,Golden State Warriors
21,4017,Kris,Murray,Portland Trail Blazers,13717,14,F,45,4,12,33.3,5,6,83.3,1,7,14.3,2,2,4,2,5,1,0,1,-3,Kris Murray,20,18,16,6,13717,2024-04-12 02:00:00,Portland Trail Blazers,Golden State Warriors
22,930,Deandre,Ayton,Portland Trail Blazers,13717,25,C,34,12,24,50.0,1,1,100.0,0,1,0,1,10,11,1,0,3,1,1,-8,Deandre Ayton,37,36,26,12,13717,2024-04-12 02:00:00,Portland Trail Blazers,Golden State Warriors
23,3408,Scoot,Henderson,Portland Trail Blazers,13717,18,G,40,7,20,35.0,2,3,66.7,2,8,25.0,1,2,3,12,2,2,9,0,-11,Scoot Henderson,33,21,30,15,13717,2024-04-12 02:00:00,Portland Trail Blazers,Golden State Warriors
24,4069,R.,Rupert,Portland Trail Blazers,13717,2,G,29,1,6,16.7,0,0,0,0,3,0,1,3,4,0,3,0,1,0,+12,R. Rupert,6,6,2,4,13717,2024-04-12 02:00:00,Portland Trail Blazers,Golden State Warriors
25,3714,Justin,Minaya,Portland Trail Blazers,13717,3,F,29,1,7,14.3,0,0,0,1,5,20.0,4,0,4,2,4,1,0,0,-20,Justin Minaya,9,7,5,6,13717,2024-04-12 02:00:00,Portland Trail Blazers,Golden State Warriors
26,4018,Duop,Reath,Portland Trail Blazers,13717,8,C,14,2,10,20.0,3,3,100.0,1,4,25.0,3,2,5,0,0,0,0,1,0,Duop Reath,13,13,8,5,13717,2024-04-12 02:00:00,Portland Trail Blazers,Golden State Warriors
27,2594,Ashton,Hagans,Portland Trail Blazers,13717,5,G,14,2,4,50.0,0,0,0,1,3,33.3,1,1,2,4,1,1,1,0,+4,Ashton Hagans,11,7,9,6,13717,2024-04-12 02:00:00,Portland Trail Blazers,Golden State Warriors
28,2827,Jonathan,Kuminga,Golden State Warriors,13717,19,PF,34,7,11,63.6,4,4,100.0,1,2,50.0,2,4,6,1,4,1,4,0,+8,Jonathan Kuminga,26,25,20,7,13717,2024-04-12 02:00:00,Portland Trail Blazers,Golden State Warriors
29,3973,Trayce,JacksonDavis,Golden State Warriors,13717,10,F,27,3,4,75.0,4,4,100.0,0,0,0,3,5,8,4,1,1,1,4,-11,Trayce JacksonDavis,22,18,14,12,13717,2024-04-12 02:00:00,Portland Trail Blazers,Golden State Warriors
30,548,Andrew,Wiggins,Golden State Warriors,13717,15,SF,30,5,12,41.7,2,2,100.0,3,8,37.5,0,5,5,1,3,1,3,2,-11,Andrew Wiggins,21,20,16,6,13717,2024-04-12 02:00:00,Portland Trail Blazers,Golden State Warriors
31,415,Chris,Paul,Golden State Warriors,13717,8,PG,32,3,9,33.3,0,0,0,2,6,33.3,0,3,3,4,3,1,1,1,+3,Chris Paul,15,11,12,7,13717,2024-04-12 02:00:00,Portland Trail Blazers,Golden State Warriors
32,124,Stephen,Curry,Golden State Warriors,13717,22,PG,36,8,22,36.4,1,1,100.0,5,16,31.3,0,7,7,8,0,1,2,2,+7,Stephen Curry,37,29,30,15,13717,2024-04-12 02:00:00,Portland Trail Blazers,Golden State Warriors
33,468,Dario,Saric,Golden State Warriors,13717,0,PF,6,0,1,0,0,0,0,0,1,0,0,1,1,1,1,1,1,0,+4,Dario Saric,2,1,1,2,13717,2024-04-12 02:00:00,Portland Trail Blazers,Golden State Warriors
34,322,Kevon,Looney,Golden State Warriors,13717,9,F,21,4,6,66.7,1,2,50.0,0,0,0,4,7,11,0,2,2,2,4,+19,Kevon Looney,20,20,9,11,13717,2024-04-12 02:00:00,Portland Trail Blazers,Golden State Warriors
35,2836,Moses,Moody,Golden State Warriors,13717,8,SG,21,2,3,66.7,3,6,50.0,1,1,100.0,0,2,2,1,3,0,2,0,+8,Moses Moody,11,10,9,3,13717,2024-04-12 02:00:00,Portland Trail Blazers,Golden State Warriors
36,3975,Brandin,Podziemski,Golden State Warriors,13717,9,G,33,4,9,44.4,1,1,100.0,0,1,0,1,2,3,4,1,0,0,0,+13,Brandin Podziemski,16,12,13,7,13717,2024-04-12 02:00:00,Portland Trail Blazers,Golden State Warriors
37,463,Domantas,Sabonis,Sacramento Kings,13718,18,PF,35,8,12,66.7,2,4,50.0,0,0,0,2,8,10,4,2,2,4,0,-16,Domantas Sabonis,32,28,22,14,13718,2024-04-12 02:00:00,Sacramento Kings,New Orleans Pelicans
38,36,Harrison,Barnes,Sacramento Kings,13718,22,SF,33,9,15,60.0,2,2,100.0,2,6,33.3,1,4,5,4,2,1,0,0,-18,Harrison Barnes,31,27,26,9,13718,2024-04-12 02:00:00,Sacramento Kings,New Orleans Pelicans
39,3475,Keegan,Murray,Sacramento Kings,13718,19,SF,36,6,14,42.9,2,2,100.0,5,10,50.0,2,3,5,1,3,2,0,0,-9,Keegan Murray,25,24,20,6,13718,2024-04-12 02:00:00,Sacramento Kings,New Orleans Pelicans
40,776,De'Aaron,Fox,Sacramento Kings,13718,33,PG,41,11,18,61.1,8,10,80.0,3,7,42.9,0,5,5,8,3,2,6,0,+3,De'Aaron Fox,46,38,41,13,13718,2024-04-12 02:00:00,Sacramento Kings,New Orleans Pelicans
41,3436,Keon,Ellis,Sacramento Kings,13718,5,G,23,2,5,40.0,0,0,0,1,3,33.3,0,1,1,0,1,0,0,0,-5,Keon Ellis,6,6,5,1,13718,2024-04-12 02:00:00,Sacramento Kings,New Orleans Pelicans
42,331,Trey,Lyles,Sacramento Kings,13718,6,PF,15,2,4,50.0,0,0,0,2,4,50.0,0,1,1,2,0,0,0,0,+6,Trey Lyles,9,7,8,3,13718,2024-04-12 02:00:00,Sacramento Kings,New Orleans Pelicans
43,4022,Sasha,Vezenkov,Sacramento Kings,13718,5,F,11,2,5,40.0,0,0,0,1,4,25.0,0,2,2,0,1,0,0,0,0,Sasha Vezenkov,7,7,5,2,13718,2024-04-12 02:00:00,Sacramento Kings,New Orleans Pelicans
44,4021,Jalen,Slawson,Sacramento Kings,13718,0,F,1,0,0,0,0,0,0,0,0,0,0,0,0,0,0,0,0,0,0,Jalen Slawson,0,0,0,0,13718,2024-04-12 02:00:00,Sacramento Kings,New Orleans Pelicans
45,2805,Kessler,Edwards,Sacramento Kings,13718,0,SF,1,0,0,0,0,0,0,0,0,0,0,0,0,0,0,0,0,0,+2,Kessler Edwards,0,0,0,0,13718,2024-04-12 02:00:00,Sacramento Kings,New Orleans Pelicans
46,313,Alex,Len,Sacramento Kings,13718,2,C,11,1,1,100.0,0,0,0,0,0,0,0,1,1,1,3,0,1,0,+2,Alex Len,4,3,3,2,13718,2024-04-12 02:00:00,Sacramento Kings,New Orleans Pelicans
47,2834,Davion,Mitchell,Sacramento Kings,13718,13,PG,27,5,8,62.5,1,2,50.0,2,2,100.0,0,2,2,5,1,0,1,0,-6,Davion Mitchell,20,15,18,7,13718,2024-04-12 02:00:00,Sacramento Kings,New Orleans Pelicans
48,2803,Chris,Duarte,Sacramento Kings,13718,0,SG,4,0,2,0,0,0,0,0,2,0,0,0,0,1,0,0,0,0,-4,Chris Duarte,1,0,1,1,13718,2024-04-12 02:00:00,Sacramento Kings,New Orleans Pelicans
49,4020,Colby,Jones,Sacramento Kings,13718,0,G,3,0,0,0,0,0,0,0,0,0,0,0,0,0,1,0,2,0,-15,Colby Jones,0,0,0,0,13718,2024-04-12 02:00:00,Sacramento Kings,New Orleans Pelicans
50,1902,Zion,Williamson,New Orleans Pelicans,13718,31,PF,31,13,21,61.9,5,5,100.0,0,1,0,1,3,4,6,0,3,4,1,+16,Zion Williamson,41,35,37,10,13718,2024-04-12 02:00:00,Sacramento Kings,New Orleans Pelicans
51,2822,Herbert,Jones,New Orleans Pelicans,13718,5,SF,29,2,7,28.6,0,0,0,1,4,25.0,1,4,5,6,4,0,3,0,+13,Herbert Jones,16,10,11,11,13718,2024-04-12 02:00:00,Sacramento Kings,New Orleans Pelicans
52,525,Jonas,Valanciunas,New Orleans Pelicans,13718,13,C,33,5,8,62.5,3,5,60.0,0,0,0,1,9,10,3,4,1,2,0,+16,Jonas Valanciunas,26,23,16,13,13718,2024-04-12 02:00:00,Sacramento Kings,New Orleans Pelicans
53,347,CJ,McCollum,New Orleans Pelicans,13718,31,SG,40,11,18,61.1,0,0,0,9,12,75.0,1,3,4,7,0,2,0,0,-11,CJ McCollum,42,35,38,11,13718,2024-04-12 02:00:00,Sacramento Kings,New Orleans Pelicans
54,2837,Trey,Murphy III,New Orleans Pelicans,13718,27,SG,45,7,14,50.0,7,8,87.5,6,12,50.0,0,5,5,4,1,0,1,0,+15,Trey Murphy III,36,32,31,9,13718,2024-04-12 02:00:00,Sacramento Kings,New Orleans Pelicans
55,2846,Jeremiah,Robinson-Earl,New Orleans Pelicans,13718,0,F,2,0,0,0,0,0,0,0,0,0,0,0,0,0,0,0,1,0,-8,Jeremiah Robinson-Earl,0,0,0,0,13718,2024-04-12 02:00:00,Sacramento Kings,New Orleans Pelicans
56,2668,Naji,Marshall,New Orleans Pelicans,13718,2,SF,4,1,1,100.0,0,0,0,0,0,0,0,1,1,0,0,0,1,0,+2,Naji Marshall,3,3,2,1,13718,2024-04-12 02:00:00,Sacramento Kings,New Orleans Pelicans
57,571,Cody,Zeller,New Orleans Pelicans,13718,2,C,9,1,1,100.0,0,0,0,0,0,0,0,1,1,2,1,0,0,0,+1,Cody Zeller,5,3,4,3,13718,2024-04-12 02:00:00,Sacramento Kings,New Orleans Pelicans
58,2941,Jose,Alvarado,New Orleans Pelicans,13718,14,PG,22,5,8,62.5,0,0,0,4,6,66.7,1,5,6,6,4,0,0,0,+17,Jose Alvarado,26,20,20,12,13718,2024-04-12 02:00:00,Sacramento Kings,New Orleans Pelicans
59,3406,Dyson,Daniels,New Orleans Pelicans,13718,10,G,25,4,8,50.0,0,0,0,2,5,40.0,0,4,4,1,2,1,1,1,-1,Dyson Daniels,15,14,11,5,13718,2024-04-12 02:00:00,Sacramento Kings,New Orleans Pelicans
60,431,Bobby,Portis,Milwaukee Bucks,13710,30,F,30,14,18,77.8,0,0,0,2,2,100.0,2,7,9,3,3,5,4,0,+22,Bobby Portis,42,39,33,12,13710,2024-04-11 00:00:00,Milwaukee Bucks,Orlando Magic
61,323,Brook,Lopez,Milwaukee Bucks,13710,10,C,31,4,10,40.0,0,1,0,2,6,33.3,2,2,4,4,0,1,1,3,+12,Brook Lopez,18,14,14,8,13710,2024-04-11 00:00:00,Milwaukee Bucks,Orlando Magic
62,53,Patrick,Beverley,Milwaukee Bucks,13710,13,PG,30,4,6,66.7,2,2,100.0,3,3,100.0,2,6,8,6,2,1,0,0,+27,Patrick Beverley,27,21,19,14,13710,2024-04-11 00:00:00,Milwaukee Bucks,Orlando Magic
63,319,Damian,Lillard,Milwaukee Bucks,13710,29,PG,34,10,19,52.6,6,7,85.7,3,8,37.5,0,6,6,9,2,0,4,0,+11,Damian Lillard,44,35,38,15,13710,2024-04-11 00:00:00,Milwaukee Bucks,Orlando Magic
64,46,Malik,Beasley,Milwaukee Bucks,13710,8,SG,25,3,9,33.3,0,0,0,2,8,25.0,0,5,5,0,4,0,0,0,-3,Malik Beasley,13,13,8,5,13710,2024-04-11 00:00:00,Milwaukee Bucks,Orlando Magic
65,121,Jae,Crowder,Milwaukee Bucks,13710,14,PF,31,4,9,44.4,4,5,80.0,2,6,33.3,2,2,4,1,1,0,0,1,+16,Jae Crowder,19,18,15,5,13710,2024-04-11 00:00:00,Milwaukee Bucks,Orlando Magic
66,3997,Chris,Livingston,Milwaukee Bucks,13710,1,F,3,0,1,0,1,2,50.0,0,1,0,0,1,1,0,1,0,0,0,-9,Chris Livingston,2,2,1,1,13710,2024-04-11 00:00:00,Milwaukee Bucks,Orlando Magic
67,2408,Thanasis,Antetokounmpo,Milwaukee Bucks,13710,0,SF,3,0,0,0,0,0,0,0,0,0,0,0,0,1,1,0,1,0,-7,Thanasis Antetokounmpo,1,0,1,1,13710,2024-04-11 00:00:00,Milwaukee Bucks,Orlando Magic
68,115,Pat,Connaughton,Milwaukee Bucks,13710,5,SG,25,2,5,40.0,1,1,100.0,0,2,0,1,1,2,3,3,0,1,0,+16,Pat Connaughton,10,7,8,5,13710,2024-04-11 00:00:00,Milwaukee Bucks,Orlando Magic
69,3443,A.J.,Green,Milwaukee Bucks,13710,2,G,16,0,3,0,2,2,100.0,0,2,0,0,0,0,0,1,1,1,0,+14,A.J. Green,2,2,2,0,13710,2024-04-11 00:00:00,Milwaukee Bucks,Orlando Magic
70,4047,Andre Jr.,Jackson,Milwaukee Bucks,13710,5,G,10,2,3,66.7,0,0,0,1,2,50.0,1,2,3,0,2,1,0,0,-2,Andre Jr. Jackson,8,8,5,3,13710,2024-04-11 00:00:00,Milwaukee Bucks,Orlando Magic
71,3497,TyTy,Washington Jr.,Milwaukee Bucks,13710,0,G,3,0,1,0,0,0,0,0,0,0,0,1,1,0,0,0,0,0,-7,TyTy Washington Jr.,1,1,0,1,13710,2024-04-11 00:00:00,Milwaukee Bucks,Orlando Magic
72,3414,Paolo,Banchero,Orlando Magic,13710,20,PF,34,7,15,46.7,5,8,62.5,1,2,50.0,0,6,6,6,0,1,2,0,-8,Paolo Banchero,32,26,26,12,13710,2024-04-11 00:00:00,Milwaukee Bucks,Orlando Magic
73,950,Wendell,Carter Jr.,Orlando Magic,13710,9,C,23,3,9,33.3,2,2,100.0,1,4,25.0,2,1,3,0,2,0,1,0,-14,Wendell Carter Jr.,12,12,9,3,13710,2024-04-11 00:00:00,Milwaukee Bucks,Orlando Magic
74,779,Markelle,Fultz,Orlando Magic,13710,6,PG,22,3,5,60.0,0,0,0,0,0,0,0,2,2,1,0,2,1,0,-10,Markelle Fultz,9,8,7,3,13710,2024-04-11 00:00:00,Milwaukee Bucks,Orlando Magic
75,2852,Jalen,Suggs,Orlando Magic,13710,18,SG,27,6,11,54.5,4,6,66.7,2,6,33.3,1,2,3,0,5,1,0,0,-14,Jalen Suggs,21,21,18,3,13710,2024-04-11 00:00:00,Milwaukee Bucks,Orlando Magic
76,3449,Caleb,Houstan,Orlando Magic,13710,0,G,11,0,5,0,0,0,0,0,5,0,0,2,2,1,0,0,0,0,-10,Caleb Houstan,3,2,1,3,13710,2024-04-11 00:00:00,Milwaukee Bucks,Orlando Magic
77,801,Jonathan,Isaac,Orlando Magic,13710,0,PF,13,0,2,0,0,0,0,0,0,0,0,1,1,0,0,1,0,0,-12,Jonathan Isaac,1,1,0,1,13710,2024-04-11 00:00:00,Milwaukee Bucks,Orlando Magic
78,1883,Chuma,Okeke,Orlando Magic,13710,0,PF,4,0,0,0,0,0,0,0,0,0,0,1,1,1,0,0,0,0,+4,Chuma Okeke,2,1,1,2,13710,2024-04-11 00:00:00,Milwaukee Bucks,Orlando Magic
79,1892,Admiral,Schofield,Orlando Magic,13710,3,SF,4,1,2,50.0,0,0,0,1,1,100.0,1,1,2,1,1,0,1,0,+4,Admiral Schofield,6,5,4,3,13710,2024-04-11 00:00:00,Milwaukee Bucks,Orlando Magic
80,1037,Moritz,Wagner,Orlando Magic,13710,7,C,21,3,6,50.0,1,1,100.0,0,2,0,1,3,4,0,3,0,2,0,-8,Moritz Wagner,11,11,7,4,13710,2024-04-11 00:00:00,Milwaukee Bucks,Orlando Magic
81,1848,Goga,Bitadze,Orlando Magic,13710,2,C,4,0,1,0,2,4,50.0,0,0,0,0,3,3,0,0,0,0,0,+4,Goga Bitadze,5,5,2,3,13710,2024-04-11 00:00:00,Milwaukee Bucks,Orlando Magic
82,2563,Cole,Anthony,Orlando Magic,13710,23,PG,33,9,14,64.3,2,2,100.0,3,4,75.0,0,4,4,4,1,0,5,1,-12,Cole Anthony,31,27,27,8,13710,2024-04-11 00:00:00,Milwaukee Bucks,Orlando Magic
83,258,Joe,Ingles,Orlando Magic,13710,3,SG,15,1,2,50.0,0,0,0,1,1,100.0,0,3,3,3,1,0,2,0,-10,Joe Ingles,9,6,6,6,13710,2024-04-11 00:00:00,Milwaukee Bucks,Orlando Magic
84,4010,Anthony,Black,Orlando Magic,13710,5,G,22,2,2,100.0,0,0,0,1,1,100.0,0,0,0,1,2,0,1,0,-8,Anthony Black,6,5,6,1,13710,2024-04-11 00:00:00,Milwaukee Bucks,Orlando Magic
85,4011,Jett,Howard,Orlando Magic,13710,3,G,6,1,4,25.0,0,0,0,1,4,25.0,0,0,0,1,0,1,0,0,+4,Jett Howard,4,3,4,1,13710,2024-04-11 00:00:00,Milwaukee Bucks,Orlando Magic
86,3448,Chet,Holmgren,Oklahoma City Thunder,13711,9,PF,15,3,8,37.5,2,2,100.0,1,2,50.0,1,5,6,2,3,1,0,0,+8,Chet Holmgren,17,15,11,8,13711,2024-04-11 00:00:00,Oklahoma City Thunder,San Antonio Spurs
87,3504,Jalen,Williams,Oklahoma City Thunder,13711,10,F,24,5,11,45.5,0,0,0,0,2,0,0,7,7,2,1,3,1,1,+25,Jalen Williams,19,17,12,9,13711,2024-04-11 00:00:00,Oklahoma City Thunder,San Antonio Spurs
88,972,Shai,Gilgeous-Alexander,Oklahoma City Thunder,13711,26,PG,26,10,18,55.6,5,5,100.0,1,3,33.3,0,6,6,5,1,0,1,0,+26,Shai Gilgeous-Alexander,37,32,31,11,13711,2024-04-11 00:00:00,Oklahoma City Thunder,San Antonio Spurs
89,2808,Josh,Giddey,Oklahoma City Thunder,13711,20,SG,29,7,12,58.3,5,5,100.0,1,3,33.3,0,12,12,7,1,1,3,0,+22,Josh Giddey,39,32,27,19,13711,2024-04-11 00:00:00,Oklahoma City Thunder,San Antonio Spurs
90,4009,Cason,Wallace,Oklahoma City Thunder,13711,0,G,25,0,5,0,0,0,0,0,4,0,0,4,4,3,1,3,0,1,+24,Cason Wallace,7,4,3,7,13711,2024-04-11 00:00:00,Oklahoma City Thunder,San Antonio Spurs
91,3404,Lindy,Waters III,Oklahoma City Thunder,13711,9,F,9,3,6,50.0,0,0,0,3,6,50.0,0,2,2,0,1,0,0,0,0,Lindy Waters III,11,11,9,2,13711,2024-04-11 00:00:00,Oklahoma City Thunder,San Antonio Spurs
92,4084,A.,Flagler,Oklahoma City Thunder,13711,3,F,9,1,4,25.0,0,0,0,1,3,33.3,0,0,0,3,0,0,0,0,0,A. Flagler,6,3,6,3,13711,2024-04-11 00:00:00,Oklahoma City Thunder,San Antonio Spurs
93,3505,Jaylin,Williams,Oklahoma City Thunder,13711,8,F,13,3,4,75.0,0,1,0,2,2,100.0,2,6,8,3,1,1,0,1,+22,Jaylin Williams,19,16,11,11,13711,2024-04-11 00:00:00,Oklahoma City Thunder,San Antonio Spurs
94,227,Gordon,Hayward,Oklahoma City Thunder,13711,18,SF,20,6,8,75.0,4,6,66.7,2,3,66.7,0,1,1,0,1,1,3,0,+23,Gordon Hayward,19,19,18,1,13711,2024-04-11 00:00:00,Oklahoma City Thunder,San Antonio Spurs
95,1044,Kenrich,Williams,Oklahoma City Thunder,13711,3,SF,15,1,6,16.7,0,0,0,1,3,33.3,0,1,1,3,0,0,1,0,+11,Kenrich Williams,7,4,6,4,13711,2024-04-11 00:00:00,Oklahoma City Thunder,San Antonio Spurs
96,54,Bismack,Biyombo,Oklahoma City Thunder,13711,6,C,12,3,3,100.0,0,0,0,0,0,0,1,5,6,0,0,0,0,1,+4,Bismack Biyombo,12,12,6,6,13711,2024-04-11 00:00:00,Oklahoma City Thunder,San Antonio Spurs
97,384,Mike,Muscala,Oklahoma City Thunder,13711,0,C,15,0,4,0,0,0,0,0,1,0,2,2,4,2,3,0,1,0,-1,Mike Muscala,6,4,2,6,13711,2024-04-11 00:00:00,Oklahoma City Thunder,San Antonio Spurs
98,2604,Isaiah,Joe,Oklahoma City Thunder,13711,8,SG,12,3,6,50.0,0,0,0,2,4,50.0,1,2,3,0,2,0,1,2,+9,Isaiah Joe,11,11,8,3,13711,2024-04-11 00:00:00,Oklahoma City Thunder,San Antonio Spurs
99,2863,Aaron,Wiggins,Oklahoma City Thunder,13711,7,SG,17,2,6,33.3,1,2,50.0,2,2,100.0,0,2,2,3,1,2,1,0,+17,Aaron Wiggins,12,9,10,5,13711,2024-04-11 00:00:00,Oklahoma City Thunder,San Antonio Spurs
100,762,Zach,Collins,San Antonio Spurs,13711,20,PF,26,8,17,47.1,2,3,66.7,2,5,40.0,0,7,7,2,3,1,5,2,-30,Zach Collins,29,27,22,9,13711,2024-04-11 00:00:00,Oklahoma City Thunder,San Antonio Spurs
101,2830,Sandro,Mamukelashvili,San Antonio Spurs,13711,0,PF,26,0,8,0,0,0,0,0,3,0,0,11,11,2,0,0,1,0,-28,Sandro Mamukelashvili,13,11,2,13,13711,2024-04-11 00:00:00,Oklahoma City Thunder,San Antonio Spurs
102,3425,Julian,Champagnie,San Antonio Spurs,13711,5,F,24,1,7,14.3,3,4,75.0,0,6,0,0,3,3,0,3,1,2,1,-35,Julian Champagnie,8,8,5,3,13711,2024-04-11 00:00:00,Oklahoma City Thunder,San Antonio Spurs
103,2606,Tre,Jones,San Antonio Spurs,13711,13,PG,28,6,14,42.9,0,0,0,1,4,25.0,0,6,6,7,1,3,2,1,-23,Tre Jones,26,19,20,13,13711,2024-04-11 00:00:00,Oklahoma City Thunder,San Antonio Spurs
104,3419,Malaki,Branham,San Antonio Spurs,13711,7,G,20,3,8,37.5,0,0,0,1,4,25.0,0,2,2,1,2,0,1,0,-21,Malaki Branham,10,9,8,3,13711,2024-04-11 00:00:00,Oklahoma City Thunder,San Antonio Spurs
105,2809,RaiQuan,Gray,San Antonio Spurs,13711,13,F,13,5,8,62.5,0,0,0,3,5,60.0,0,0,0,2,0,1,0,0,+3,RaiQuan Gray,15,13,15,2,13711,2024-04-11 00:00:00,Oklahoma City Thunder,San Antonio Spurs
106,973,Devonte',Graham,San Antonio Spurs,13711,2,PG,21,1,7,14.3,0,0,0,0,4,0,0,3,3,1,0,0,1,0,-21,Devonte' Graham,6,5,3,4,13711,2024-04-11 00:00:00,Oklahoma City Thunder,San Antonio Spurs
107,3418,Jamaree,Bouyea,San Antonio Spurs,13711,2,G,12,1,1,100.0,0,0,0,0,0,0,0,1,1,1,0,1,0,0,-4,Jamaree Bouyea,4,3,3,2,13711,2024-04-11 00:00:00,Oklahoma City Thunder,San Antonio Spurs
108,2804,David,Duke Jr.,San Antonio Spurs,13711,6,G,18,2,8,25.0,2,2,100.0,0,2,0,1,6,7,4,1,1,1,0,-5,David Duke Jr.,17,13,10,11,13711,2024-04-11 00:00:00,Oklahoma City Thunder,San Antonio Spurs
109,3499,Blake,Wesley,San Antonio Spurs,13711,7,G,25,1,11,9.1,4,4,100.0,1,4,25.0,0,2,2,1,1,0,2,0,-9,Blake Wesley,10,9,8,3,13711,2024-04-11 00:00:00,Oklahoma City Thunder,San Antonio Spurs
110,4024,Sidy,Cissoko,San Antonio Spurs,13711,14,G,28,4,7,57.1,5,7,71.4,1,3,33.3,3,2,5,3,3,0,0,0,-17,Sidy Cissoko,22,19,17,8,13711,2024-04-11 00:00:00,Oklahoma City Thunder,San Antonio Spurs
111,195,Aaron,Gordon,Denver Nuggets,13712,5,PF,28,2,7,28.6,1,2,50.0,0,2,0,1,4,5,9,0,1,2,0,+9,Aaron Gordon,19,10,14,14,13712,2024-04-11 02:00:00,Denver Nuggets,Minnesota Timberwolves
112,1014,Michael,Porter Jr.,Denver Nuggets,13712,18,SF,37,7,14,50.0,2,2,100.0,2,4,50.0,3,5,8,2,2,0,1,0,+7,Michael Porter Jr.,28,26,20,10,13712,2024-04-11 02:00:00,Denver Nuggets,Minnesota Timberwolves
113,279,Nikola,Jokic,Denver Nuggets,13712,41,C,38,16,20,80.0,7,12,58.3,2,2,100.0,2,9,11,7,5,3,2,0,+6,Nikola Jokic,59,52,48,18,13712,2024-04-11 02:00:00,Denver Nuggets,Minnesota Timberwolves
114,383,Jamal,Murray,Denver Nuggets,13712,20,PG,27,8,13,61.5,0,0,0,4,6,66.7,2,2,4,6,1,0,4,0,+7,Jamal Murray,30,24,26,10,13712,2024-04-11 02:00:00,Denver Nuggets,Minnesota Timberwolves
115,89,Kentavious,Caldwell-Pope,Denver Nuggets,13712,9,SG,26,4,9,44.4,0,0,0,1,5,20.0,1,2,3,1,4,0,0,1,-2,Kentavious Caldwell-Pope,13,12,10,4,13712,2024-04-11 02:00:00,Denver Nuggets,Minnesota Timberwolves
116,2627,Zeke,Nnaji,Denver Nuggets,13712,0,PF,2,0,1,0,0,0,0,0,1,0,0,1,1,0,0,0,0,0,-3,Zeke Nnaji,1,1,0,1,13712,2024-04-11 02:00:00,Denver Nuggets,Minnesota Timberwolves
117,3967,Hunter,Tyson,Denver Nuggets,13712,0,F,1,0,0,0,0,0,0,0,0,0,0,0,0,0,0,1,0,0,-1,Hunter Tyson,0,0,0,0,13712,2024-04-11 02:00:00,Denver Nuggets,Minnesota Timberwolves
118,3498,Peyton,Watson,Denver Nuggets,13712,3,F,23,1,2,50.0,1,2,50.0,0,0,0,1,3,4,4,2,0,0,6,+4,Peyton Watson,11,7,7,8,13712,2024-04-11 02:00:00,Denver Nuggets,Minnesota Timberwolves
119,243,Justin,Holiday,Denver Nuggets,13712,3,SF,8,1,1,100.0,0,0,0,1,1,100.0,0,1,1,0,1,1,0,0,+9,Justin Holiday,4,4,3,1,13712,2024-04-11 02:00:00,Denver Nuggets,Minnesota Timberwolves
120,2814,Jay,Huff,Denver Nuggets,13712,0,C,1,0,0,0,0,0,0,0,0,0,0,0,0,0,1,0,0,0,-1,Jay Huff,0,0,0,0,13712,2024-04-11 02:00:00,Denver Nuggets,Minnesota Timberwolves
121,264,Reggie,Jackson,Denver Nuggets,13712,9,PG,20,3,9,33.3,2,2,100.0,1,3,33.3,0,2,2,1,4,0,3,0,+3,Reggie Jackson,12,11,10,3,13712,2024-04-11 02:00:00,Denver Nuggets,Minnesota Timberwolves
122,3965,Jalen,Pickett,Denver Nuggets,13712,0,G,0,0,0,0,0,0,0,0,0,0,0,0,0,0,0,0,0,0,-1,Jalen Pickett,0,0,0,0,13712,2024-04-11 02:00:00,Denver Nuggets,Minnesota Timberwolves
123,3420,Christian,Braun,Denver Nuggets,13712,8,G,27,4,7,57.1,0,1,0,0,1,0,1,4,5,1,1,1,1,1,+9,Christian Braun,14,13,9,6,13712,2024-04-11 02:00:00,Denver Nuggets,Minnesota Timberwolves
124,3966,Julian,Strawther,Denver Nuggets,13712,0,G,1,0,0,0,0,2,0,0,0,0,0,0,0,0,0,0,0,0,-1,Julian Strawther,0,0,0,0,13712,2024-04-11 02:00:00,Denver Nuggets,Minnesota Timberwolves
125,2621,Jaden,McDaniels,Minnesota Timberwolves,13712,9,PF,34,4,8,50.0,0,0,0,1,4,25.0,0,2,2,3,2,1,0,0,-17,Jaden McDaniels,14,11,12,5,13712,2024-04-11 02:00:00,Denver Nuggets,Minnesota Timberwolves
126,192,Rudy,Gobert,Minnesota Timberwolves,13712,13,C,39,6,7,85.7,1,3,33.3,0,0,0,5,10,15,3,5,2,2,1,-17,Rudy Gobert,31,28,16,18,13712,2024-04-11 02:00:00,Denver Nuggets,Minnesota Timberwolves
127,2146,Naz,Reid,Minnesota Timberwolves,13712,13,C,30,6,19,31.6,1,5,20.0,0,4,0,1,5,6,2,4,2,0,1,+3,Naz Reid,21,19,15,8,13712,2024-04-11 02:00:00,Denver Nuggets,Minnesota Timberwolves
128,114,Mike,Conley,Minnesota Timberwolves,13712,19,PG,30,7,12,58.3,0,0,0,5,9,55.6,1,3,4,2,0,1,3,0,-10,Mike Conley,25,23,21,6,13712,2024-04-11 02:00:00,Denver Nuggets,Minnesota Timberwolves
129,2584,Anthony,Edwards,Minnesota Timberwolves,13712,25,SG,35,9,18,50.0,5,7,71.4,2,6,33.3,0,2,2,4,1,0,1,0,-16,Anthony Edwards,31,27,29,6,13712,2024-04-11 02:00:00,Denver Nuggets,Minnesota Timberwolves
130,806,Justin,Jackson,Minnesota Timberwolves,13712,0,F,0,0,0,0,0,0,0,0,0,0,0,0,0,0,0,0,0,0,0,Justin Jackson,0,0,0,0,13712,2024-04-11 02:00:00,Denver Nuggets,Minnesota Timberwolves
131,3470,Josh,Minott,Minnesota Timberwolves,13712,5,F,3,2,2,100.0,0,0,0,1,1,100.0,0,0,0,0,0,0,0,0,+7,Josh Minott,5,5,5,0,13712,2024-04-11 02:00:00,Denver Nuggets,Minnesota Timberwolves
132,4001,Leonard,Miller,Minnesota Timberwolves,13712,3,F,3,1,1,100.0,1,2,50.0,0,0,0,0,2,2,1,1,0,0,0,+7,Leonard Miller,6,5,4,3,13712,2024-04-11 02:00:00,Denver Nuggets,Minnesota Timberwolves
133,18,Kyle,Anderson,Minnesota Timberwolves,13712,4,SF,15,1,5,20.0,2,2,100.0,0,1,0,0,1,1,2,4,0,0,2,-11,Kyle Anderson,7,5,6,3,13712,2024-04-11 02:00:00,Denver Nuggets,Minnesota Timberwolves
134,2807,Luka,Garza,Minnesota Timberwolves,13712,0,C,3,0,0,0,0,0,0,0,0,0,0,0,0,0,1,1,0,0,+7,Luka Garza,0,0,0,0,13712,2024-04-11 02:00:00,Denver Nuggets,Minnesota Timberwolves
135,845,Monte,Morris,Minnesota Timberwolves,13712,6,PG,15,2,4,50.0,0,0,0,2,2,100.0,0,1,1,1,1,0,0,1,-4,Monte Morris,8,7,7,2,13712,2024-04-11 02:00:00,Denver Nuggets,Minnesota Timberwolves
136,997,Jordan,McLaughlin,Minnesota Timberwolves,13712,0,PG,10,0,0,0,0,0,0,0,0,0,0,0,0,1,0,1,0,0,0,Jordan McLaughlin,1,0,1,1,13712,2024-04-11 02:00:00,Denver Nuggets,Minnesota Timberwolves
137,1845,Nickeil,Alexander-Walker,Minnesota Timberwolves,13712,5,SG,18,2,4,50.0,0,0,0,1,1,100.0,1,0,1,2,1,1,2,0,-8,Nickeil Alexander-Walker,8,6,7,3,13712,2024-04-11 02:00:00,Denver Nuggets,Minnesota Timberwolves
138,3154,Daishen,Nix,Minnesota Timberwolves,13712,5,SG,3,1,1,100.0,2,2,100.0,1,1,100.0,1,0,1,1,1,0,1,0,+7,Daishen Nix,7,6,6,2,13712,2024-04-11 02:00:00,Denver Nuggets,Minnesota Timberwolves
139,3474,Wendell,Moore Jr.,Minnesota Timberwolves,13712,0,G,3,0,1,0,0,0,0,0,1,0,0,0,0,1,0,0,0,0,+7,Wendell Moore Jr.,1,0,1,1,13712,2024-04-11 02:00:00,Denver Nuggets,Minnesota Timberwolves
140,520,P.J.,Tucker,LA Clippers,13713,10,PF,23,4,5,80.0,0,0,0,2,2,100.0,1,4,5,1,0,1,0,0,+13,P.J. Tucker,16,15,11,6,13713,2024-04-11 02:30:00,LA Clippers,Phoenix Suns
141,426,Mason,Plumlee,LA Clippers,13713,12,C,35,4,9,44.4,4,4,100.0,0,1,0,1,11,12,4,2,1,2,0,-6,Mason Plumlee,28,24,16,16,13713,2024-04-11 02:30:00,LA Clippers,Phoenix Suns
142,2816,Bones,Hyland,LA Clippers,13713,37,PG,43,15,29,51.7,1,1,100.0,6,12,50.0,0,4,4,9,4,3,4,0,-7,Bones Hyland,50,41,46,13,13713,2024-04-11 02:30:00,LA Clippers,Phoenix Suns
143,1877,Terance,Mann,LA Clippers,13713,3,SG,8,1,3,33.3,1,1,100.0,0,1,0,0,3,3,0,0,0,0,0,-3,Terance Mann,6,6,3,3,13713,2024-04-11 02:30:00,LA Clippers,Phoenix Suns
144,2115,Amir,Coffey,LA Clippers,13713,11,SG,37,4,13,30.8,1,2,50.0,2,6,33.3,1,4,5,1,2,1,0,1,-18,Amir Coffey,17,16,12,6,13713,2024-04-11 02:30:00,LA Clippers,Phoenix Suns
145,886,Daniel,Theis,LA Clippers,13713,2,C,10,1,2,50.0,0,0,0,0,1,0,0,3,3,0,1,0,3,0,-9,Daniel Theis,5,5,2,3,13713,2024-04-11 02:30:00,LA Clippers,Phoenix Suns
146,2792,Brandon,Boston Jr.,LA Clippers,13713,23,SG,40,10,24,41.7,1,2,50.0,2,9,22.2,4,3,7,2,1,2,3,1,-15,Brandon Boston Jr.,32,30,25,9,13713,2024-04-11 02:30:00,LA Clippers,Phoenix Suns
147,3396,Xavier,Moon,LA Clippers,13713,6,G,16,3,5,60.0,0,0,0,0,1,0,1,2,3,4,0,0,0,0,-5,Xavier Moon,13,9,10,7,13713,2024-04-11 02:30:00,LA Clippers,Phoenix Suns
148,3983,Kobe,Brown,LA Clippers,13713,4,G,28,2,5,40.0,0,0,0,0,3,0,1,1,2,2,3,1,0,1,-30,Kobe Brown,8,6,6,4,13713,2024-04-11 02:30:00,LA Clippers,Phoenix Suns
149,153,Kevin,Durant,Phoenix Suns,13713,24,PF,37,10,21,47.6,2,2,100.0,2,9,22.2,0,9,9,3,0,1,4,2,+8,Kevin Durant,36,33,27,12,13713,2024-04-11 02:30:00,LA Clippers,Phoenix Suns
150,851,Royce,O'Neale,Phoenix Suns,13713,15,PF,33,6,12,50.0,0,0,0,3,9,33.3,2,5,7,5,2,3,1,1,+5,Royce O'Neale,27,22,20,12,13713,2024-04-11 02:30:00,LA Clippers,Phoenix Suns
151,398,Jusuf,Nurkic,Phoenix Suns,13713,3,C,30,1,1,100.0,1,2,50.0,0,0,0,3,16,19,10,2,0,4,1,+10,Jusuf Nurkic,32,22,13,29,13713,2024-04-11 02:30:00,LA Clippers,Phoenix Suns
152,45,Bradley,Beal,Phoenix Suns,13713,26,SG,34,9,17,52.9,4,4,100.0,4,7,57.1,0,5,5,4,2,0,3,0,+16,Bradley Beal,35,31,30,9,13713,2024-04-11 02:30:00,LA Clippers,Phoenix Suns
153,64,Devin,Booker,Phoenix Suns,13713,37,SG,39,13,24,54.2,6,6,100.0,5,12,41.7,1,0,1,4,1,1,1,1,+9,Devin Booker,42,38,41,5,13713,2024-04-11 02:30:00,LA Clippers,Phoenix Suns
154,570,Thaddeus,Young,Phoenix Suns,13713,0,F,13,0,2,0,0,0,0,0,1,0,2,0,2,2,2,2,0,0,+2,Thaddeus Young,4,2,2,4,13713,2024-04-11 02:30:00,LA Clippers,Phoenix Suns
155,3483,David,Roddy,Phoenix Suns,13713,0,F,1,0,1,0,0,0,0,0,0,0,0,0,0,0,0,0,0,0,+2,David Roddy,0,0,0,0,13713,2024-04-11 02:30:00,LA Clippers,Phoenix Suns
156,1010,Josh,Okogie,Phoenix Suns,13713,0,SF,1,0,0,0,0,0,0,0,0,0,0,1,1,0,0,0,0,1,+2,Josh Okogie,1,1,0,1,13713,2024-04-11 02:30:00,LA Clippers,Phoenix Suns
157,1875,Nassir,Little,Phoenix Suns,13713,0,SF,1,0,1,0,0,0,0,0,1,0,0,0,0,0,0,0,0,0,+2,Nassir Little,0,0,0,0,13713,2024-04-11 02:30:00,LA Clippers,Phoenix Suns
158,1849,Bol,Bol,Phoenix Suns,13713,0,C,1,0,0,0,0,0,0,0,0,0,0,0,0,0,0,0,0,0,+2,Bol Bol,0,0,0,0,13713,2024-04-11 02:30:00,LA Clippers,Phoenix Suns
159,196,Eric,Gordon,Phoenix Suns,13713,11,SG,24,4,10,40.0,1,1,100.0,2,6,33.3,0,0,0,0,0,1,0,0,+2,Eric Gordon,11,11,11,0,13713,2024-04-11 02:30:00,LA Clippers,Phoenix Suns
160,926,Grayson,Allen,Phoenix Suns,13713,6,SG,23,2,5,40.0,0,0,0,2,5,40.0,1,3,4,1,4,0,0,0,+18,Grayson Allen,11,10,7,5,13713,2024-04-11 02:30:00,LA Clippers,Phoenix Suns
161,2610,Saben,Lee,Phoenix Suns,13713,2,G,1,1,1,100.0,0,0,0,0,0,0,0,0,0,0,0,0,0,0,+2,Saben Lee,2,2,2,0,13713,2024-04-11 02:30:00,LA Clippers,Phoenix Suns
162,999,Chimezie,Metu,Detroit Pistons,13714,15,PF,32,5,10,50.0,2,2,100.0,3,6,50.0,0,8,8,3,2,0,1,0,-20,Chimezie Metu,26,23,18,11,13714,2024-04-11 23:00:00,Detroit Pistons,Chicago Bulls
163,945,Troy,Brown Jr.,Detroit Pistons,13714,4,SF,36,1,6,16.7,2,2,100.0,0,3,0,1,3,4,3,2,1,1,0,-9,Troy Brown Jr.,11,8,7,7,13714,2024-04-11 23:00:00,Detroit Pistons,Chicago Bulls
164,3433,Jalen,Duren,Detroit Pistons,13714,20,C,31,7,9,77.8,6,7,85.7,0,0,0,2,9,11,3,3,0,4,0,-14,Jalen Duren,34,31,23,14,13714,2024-04-11 23:00:00,Detroit Pistons,Chicago Bulls
165,3451,Jaden,Ivey,Detroit Pistons,13714,16,PG,31,6,13,46.2,1,3,33.3,3,5,60.0,0,2,2,6,1,1,4,0,-16,Jaden Ivey,24,18,22,8,13714,2024-04-11 23:00:00,Detroit Pistons,Chicago Bulls
166,3970,Marcus,Sasser,Detroit Pistons,13714,20,G,33,8,15,53.3,0,0,0,4,10,40.0,0,0,0,5,0,2,4,1,-17,Marcus Sasser,25,20,25,5,13714,2024-04-11 23:00:00,Detroit Pistons,Chicago Bulls
167,3417,Buddy,Boeheim,Detroit Pistons,13714,3,F,2,1,1,100.0,0,0,0,1,1,100.0,0,0,0,0,0,0,0,0,+3,Buddy Boeheim,3,3,3,0,13714,2024-04-11 23:00:00,Detroit Pistons,Chicago Bulls
168,2666,James,Wiseman,Detroit Pistons,13714,2,C,17,1,2,50.0,0,2,0,0,0,0,2,4,6,2,0,0,0,0,-8,James Wiseman,10,8,4,8,13714,2024-04-11 23:00:00,Detroit Pistons,Chicago Bulls
169,2587,Malachi,Flynn,Detroit Pistons,13714,12,PG,15,4,8,50.0,3,5,60.0,1,2,50.0,1,1,2,1,0,0,3,0,-5,Malachi Flynn,15,14,13,3,13714,2024-04-11 23:00:00,Detroit Pistons,Chicago Bulls
170,177,Evan,Fournier,Detroit Pistons,13714,5,SG,26,2,7,28.6,1,2,50.0,0,4,0,0,1,1,3,3,0,2,0,-18,Evan Fournier,9,6,8,4,13714,2024-04-11 23:00:00,Detroit Pistons,Chicago Bulls
171,3481,Jared,Rhoden,Detroit Pistons,13714,8,G,18,3,6,50.0,0,0,0,2,4,50.0,1,3,4,1,1,0,1,1,-6,Jared Rhoden,13,12,9,5,13714,2024-04-11 23:00:00,Detroit Pistons,Chicago Bulls
172,136,DeMar,DeRozan,Chicago Bulls,13714,39,SF,36,14,22,63.6,7,8,87.5,4,6,66.7,0,4,4,7,0,3,1,0,+15,DeMar DeRozan,50,43,46,11,13714,2024-04-11 23:00:00,Detroit Pistons,Chicago Bulls
173,534,Nikola,Vucevic,Chicago Bulls,13714,27,C,37,12,21,57.1,1,2,50.0,2,6,33.3,2,9,11,4,3,2,0,1,+26,Nikola Vucevic,42,38,31,15,13714,2024-04-11 23:00:00,Detroit Pistons,Chicago Bulls
174,1900,Coby,White,Chicago Bulls,13714,18,PG,37,7,15,46.7,0,0,0,4,8,50.0,0,3,3,5,3,0,3,1,+24,Coby White,26,21,23,8,13714,2024-04-11 23:00:00,Detroit Pistons,Chicago Bulls
175,631,Alex,Caruso,Chicago Bulls,13714,8,SG,34,3,6,50.0,1,2,50.0,1,3,33.3,1,3,4,10,3,2,2,0,+23,Alex Caruso,22,12,18,14,13714,2024-04-11 23:00:00,Detroit Pistons,Chicago Bulls
176,2404,Javonte,Green,Chicago Bulls,13714,11,G,30,5,6,83.3,1,2,50.0,0,1,0,0,8,8,0,3,1,1,2,+14,Javonte Green,19,19,11,8,13714,2024-04-11 23:00:00,Detroit Pistons,Chicago Bulls
177,3952,Henri,Drell,Chicago Bulls,13714,0,F,2,0,1,0,0,0,0,0,1,0,0,1,1,0,1,0,0,0,-3,Henri Drell,1,1,0,1,13714,2024-04-11 23:00:00,Detroit Pistons,Chicago Bulls
178,3494,Dalen,Terry,Chicago Bulls,13714,12,F,17,5,9,55.6,0,0,0,2,4,50.0,0,2,2,0,2,1,0,0,0,Dalen Terry,14,14,12,2,13714,2024-04-11 23:00:00,Detroit Pistons,Chicago Bulls
179,765,Torrey,Craig,Chicago Bulls,13714,3,SF,10,1,2,50.0,1,1,100.0,0,0,0,2,0,2,1,0,1,0,0,+9,Torrey Craig,6,5,4,3,13714,2024-04-11 23:00:00,Detroit Pistons,Chicago Bulls
180,3951,Onuralp,Bitim,Chicago Bulls,13714,0,SF,2,0,2,0,0,0,0,0,1,0,0,0,0,0,0,0,0,0,-3,Onuralp Bitim,0,0,0,0,13714,2024-04-11 23:00:00,Detroit Pistons,Chicago Bulls
181,3955,Adama,Sanogo,Chicago Bulls,13714,4,C,11,2,5,40.0,0,0,0,0,0,0,6,0,6,0,0,0,1,0,-4,Adama Sanogo,10,10,4,6,13714,2024-04-11 23:00:00,Detroit Pistons,Chicago Bulls
182,949,Jevon,Carter,Chicago Bulls,13714,5,PG,21,2,6,33.3,0,0,0,1,5,20.0,0,1,1,1,0,3,0,1,+12,Jevon Carter,7,6,6,2,13714,2024-04-11 23:00:00,Detroit Pistons,Chicago Bulls
183,3964,Andrew,Funk,Chicago Bulls,13714,0,G,2,0,1,0,0,0,0,0,1,0,0,0,0,0,0,1,0,0,-3,Andrew Funk,0,0,0,0,13714,2024-04-11 23:00:00,Detroit Pistons,Chicago Bulls
184,882,Jayson,Tatum,Boston Celtics,13715,18,SF,32,5,13,38.5,7,9,77.8,1,7,14.3,1,3,4,7,3,2,2,1,-30,Jayson Tatum,29,22,25,11,13715,2024-04-11 23:30:00,Boston Celtics,New York Knicks
185,432,Kristaps,Porzingis,Boston Celtics,13715,14,C,25,5,12,41.7,2,2,100.0,2,5,40.0,2,6,8,1,2,0,1,2,-14,Kristaps Porzingis,23,22,15,9,13715,2024-04-11 23:30:00,Boston Celtics,New York Knicks
186,242,Jrue,Holiday,Boston Celtics,13715,7,PG,29,3,7,42.9,0,0,0,1,4,25.0,1,4,5,1,2,1,2,2,-26,Jrue Holiday,13,12,8,6,13715,2024-04-11 23:30:00,Boston Celtics,New York Knicks
187,897,Derrick,White,Boston Celtics,13715,2,PG,29,1,5,20.0,0,0,0,0,3,0,0,2,2,2,3,1,1,1,-29,Derrick White,6,4,4,4,13715,2024-04-11 23:30:00,Boston Celtics,New York Knicks
188,75,Jaylen,Brown,Boston Celtics,13715,15,SG,29,6,15,40.0,2,3,66.7,1,5,20.0,1,1,2,1,3,0,3,2,-29,Jaylen Brown,18,17,16,3,13715,2024-04-11 23:30:00,Boston Celtics,New York Knicks
189,2656,Xavier,Tillman,Boston Celtics,13715,2,F,6,1,1,100.0,0,0,0,0,0,0,0,0,0,1,0,0,0,0,+6,Xavier Tillman,3,2,3,1,13715,2024-04-11 23:30:00,Boston Celtics,New York Knicks
190,2812,Sam,Hauser,Boston Celtics,13715,15,SF,22,5,8,62.5,2,2,100.0,3,5,60.0,1,3,4,3,0,0,0,1,+16,Sam Hauser,22,19,18,7,13715,2024-04-11 23:30:00,Boston Celtics,New York Knicks
191,248,Al,Horford,Boston Celtics,13715,6,C,16,2,3,66.7,0,0,0,2,3,66.7,0,2,2,1,2,1,1,2,-18,Al Horford,9,8,7,3,13715,2024-04-11 23:30:00,Boston Celtics,New York Knicks
192,819,Luke,Kornet,Boston Celtics,13715,2,C,7,1,2,50.0,0,0,0,0,0,0,1,1,2,0,0,0,1,1,+15,Luke Kornet,4,4,2,2,13715,2024-04-11 23:30:00,Boston Celtics,New York Knicks
193,2635,Payton,Pritchard,Boston Celtics,13715,16,PG,21,7,13,53.8,0,0,0,2,4,50.0,2,2,4,6,0,0,0,0,+22,Payton Pritchard,26,20,22,10,13715,2024-04-11 23:30:00,Boston Celtics,New York Knicks
194,1006,Svi,Mykhailiuk,Boston Celtics,13715,9,SG,13,3,5,60.0,0,0,0,3,4,75.0,1,1,2,2,0,0,0,0,+21,Svi Mykhailiuk,13,11,11,4,13715,2024-04-11 23:30:00,Boston Celtics,New York Knicks
195,2851,Jaden,Springer,Boston Celtics,13715,3,G,13,1,2,50.0,0,0,0,1,2,50.0,0,1,1,0,1,2,1,0,+21,Jaden Springer,4,4,3,1,13715,2024-04-11 23:30:00,Boston Celtics,New York Knicks
196,732,O.G.,Anunoby,New York Knicks,13715,12,SF,26,5,10,50.0,0,0,0,2,3,66.7,1,4,5,1,1,1,1,1,+20,O.G. Anunoby,18,17,13,6,13715,2024-04-11 23:30:00,Boston Celtics,New York Knicks
197,978,Isaiah,Hartenstein,New York Knicks,13715,11,C,33,5,11,45.5,1,3,33.3,0,0,0,7,6,13,6,4,1,4,2,0,Isaiah Hartenstein,30,24,17,19,13715,2024-04-11 23:30:00,Boston Celtics,New York Knicks
198,946,Jalen,Brunson,New York Knicks,13715,39,PG,30,15,23,65.2,3,5,60.0,6,11,54.5,0,2,2,4,2,0,2,0,+28,Jalen Brunson,45,41,43,6,13715,2024-04-11 23:30:00,Boston Celtics,New York Knicks
199,791,Josh,Hart,New York Knicks,13715,16,SG,32,7,15,46.7,1,1,100.0,1,4,25.0,2,14,16,5,2,1,1,0,+18,Josh Hart,37,32,21,21,13715,2024-04-11 23:30:00,Boston Celtics,New York Knicks
200,962,Donte,DiVincenzo,New York Knicks,13715,17,SG,41,7,15,46.7,0,0,0,3,7,42.9,0,4,4,4,1,1,1,0,-8,Donte DiVincenzo,25,21,21,8,13715,2024-04-11 23:30:00,Boston Celtics,New York Knicks
201,2561,Precious,Achiuwa,New York Knicks,13715,2,PF,16,1,6,16.7,0,0,0,0,1,0,2,3,5,0,0,0,1,1,-9,Precious Achiuwa,7,7,2,5,13715,2024-04-11 23:30:00,Boston Celtics,New York Knicks
202,60,Bojan,Bogdanovic,New York Knicks,13715,14,SF,25,6,10,60.0,0,0,0,2,6,33.3,1,2,3,0,0,1,1,0,-2,Bojan Bogdanovic,17,17,14,3,13715,2024-04-11 23:30:00,Boston Celtics,New York Knicks
203,1020,Mitchell,Robinson,New York Knicks,13715,5,C,15,2,3,66.7,1,1,100.0,0,0,0,4,0,4,0,1,1,0,0,+7,Mitchell Robinson,9,9,5,4,13715,2024-04-11 23:30:00,Boston Celtics,New York Knicks
204,2832,Miles,McBride,New York Knicks,13715,2,PG,22,1,6,16.7,0,0,0,0,4,0,0,0,0,4,1,1,1,0,-9,Miles McBride,6,2,6,4,13715,2024-04-11 23:30:00,Boston Celtics,New York Knicks
205,136,DeMar,DeRozan,Chicago Bulls,13697,34,SF,42,12,22,54.5,9,11,81.8,1,3,33.3,0,5,5,6,2,0,4,0,-6,DeMar DeRozan,45,39,40,11,13697,2024-04-10 00:00:00,Chicago Bulls,New York Knicks
206,534,Nikola,Vucevic,Chicago Bulls,13697,26,C,39,12,16,75.0,0,0,0,2,3,66.7,2,3,5,1,2,0,0,1,-14,Nikola Vucevic,32,31,27,6,13697,2024-04-10 00:00:00,Chicago Bulls,New York Knicks
207,1900,Coby,White,Chicago Bulls,13697,24,PG,42,11,22,50.0,0,2,0,2,8,25.0,0,3,3,6,3,1,2,0,-10,Coby White,33,27,30,9,13697,2024-04-10 00:00:00,Chicago Bulls,New York Knicks
208,631,Alex,Caruso,Chicago Bulls,13697,9,SG,37,3,7,42.9,0,0,0,3,5,60.0,2,3,5,6,3,2,1,2,-10,Alex Caruso,20,14,15,11,13697,2024-04-10 00:00:00,Chicago Bulls,New York Knicks
209,2404,Javonte,Green,Chicago Bulls,13697,9,G,31,3,8,37.5,3,4,75.0,0,3,0,5,7,12,0,3,0,0,0,-11,Javonte Green,21,21,9,12,13697,2024-04-10 00:00:00,Chicago Bulls,New York Knicks
210,3494,Dalen,Terry,Chicago Bulls,13697,4,F,19,2,3,66.7,0,0,0,0,0,0,1,2,3,1,3,0,1,1,-1,Dalen Terry,8,7,5,4,13697,2024-04-10 00:00:00,Chicago Bulls,New York Knicks
211,765,Torrey,Craig,Chicago Bulls,13697,4,SF,15,1,3,33.3,1,2,50.0,1,1,100.0,1,1,2,0,2,0,0,1,0,Torrey Craig,6,6,4,2,13697,2024-04-10 00:00:00,Chicago Bulls,New York Knicks
212,147,Andre,Drummond,Chicago Bulls,13697,4,C,5,2,2,100.0,0,0,0,0,0,0,1,1,2,0,0,1,0,0,+1,Andre Drummond,6,6,4,2,13697,2024-04-10 00:00:00,Chicago Bulls,New York Knicks
213,3955,Adama,Sanogo,Chicago Bulls,13697,0,C,5,0,0,0,0,0,0,0,0,0,0,1,1,0,0,0,1,0,+2,Adama Sanogo,1,1,0,1,13697,2024-04-10 00:00:00,Chicago Bulls,New York Knicks
214,949,Jevon,Carter,Chicago Bulls,13697,3,PG,6,1,5,20.0,0,0,0,1,5,20.0,0,1,1,0,0,0,0,0,-6,Jevon Carter,4,4,3,1,13697,2024-04-10 00:00:00,Chicago Bulls,New York Knicks
215,732,O.G.,Anunoby,New York Knicks,13697,24,SF,35,10,18,55.6,0,0,0,4,6,66.7,0,3,3,1,4,0,2,1,+12,O.G. Anunoby,28,27,25,4,13697,2024-04-10 00:00:00,Chicago Bulls,New York Knicks
216,978,Isaiah,Hartenstein,New York Knicks,13697,11,C,28,5,5,100.0,1,2,50.0,0,0,0,2,2,4,6,2,1,2,3,+9,Isaiah Hartenstein,21,15,17,10,13697,2024-04-10 00:00:00,Chicago Bulls,New York Knicks
217,946,Jalen,Brunson,New York Knicks,13697,45,PG,42,13,24,54.2,12,12,100.0,7,12,58.3,0,3,3,8,0,1,1,0,+9,Jalen Brunson,56,48,53,11,13697,2024-04-10 00:00:00,Chicago Bulls,New York Knicks
218,791,Josh,Hart,New York Knicks,13697,17,SG,46,6,7,85.7,4,4,100.0,1,1,100.0,2,11,13,7,3,1,1,0,+17,Josh Hart,37,30,24,20,13697,2024-04-10 00:00:00,Chicago Bulls,New York Knicks
219,962,Donte,DiVincenzo,New York Knicks,13697,21,SG,38,8,15,53.3,2,2,100.0,3,9,33.3,1,3,4,6,3,1,3,0,+7,Donte DiVincenzo,31,25,27,10,13697,2024-04-10 00:00:00,Chicago Bulls,New York Knicks
220,60,Bojan,Bogdanovic,New York Knicks,13697,3,SF,9,1,4,25.0,0,0,0,1,2,50.0,0,1,1,1,0,0,1,0,+1,Bojan Bogdanovic,5,4,4,2,13697,2024-04-10 00:00:00,Chicago Bulls,New York Knicks
221,1020,Mitchell,Robinson,New York Knicks,13697,0,C,20,0,0,0,0,0,0,0,0,0,0,1,1,0,1,2,0,0,+2,Mitchell Robinson,1,1,0,1,13697,2024-04-10 00:00:00,Chicago Bulls,New York Knicks
222,2832,Miles,McBride,New York Knicks,13697,7,PG,22,3,10,30.0,0,0,0,1,6,16.7,1,1,2,2,2,0,0,0,-2,Miles McBride,11,9,9,4,13697,2024-04-10 00:00:00,Chicago Bulls,New York Knicks
223,3489,Jabari,Smith Jr.,Houston Rockets,13698,23,PF,41,9,17,52.9,2,2,100.0,3,5,60.0,1,6,7,5,3,0,2,2,+8,Jabari Smith Jr.,35,30,28,12,13698,2024-04-10 00:00:00,Houston Rockets,Orlando Magic
224,3977,Amen,Thompson,Houston Rockets,13698,13,F,38,6,7,85.7,1,2,50.0,0,0,0,3,5,8,4,2,2,4,1,+1,Amen Thompson,25,21,17,12,13698,2024-04-10 00:00:00,Houston Rockets,Orlando Magic
225,749,Dillon,Brooks,Houston Rockets,13698,15,SF,33,5,10,50.0,2,2,100.0,3,4,75.0,0,5,5,3,6,0,1,0,+20,Dillon Brooks,23,20,18,8,13698,2024-04-10 00:00:00,Houston Rockets,Orlando Magic
226,527,Fred,VanVleet,Houston Rockets,13698,37,PG,38,13,22,59.1,5,6,83.3,6,11,54.5,1,7,8,6,4,1,2,1,+21,Fred VanVleet,51,45,43,14,13698,2024-04-10 00:00:00,Houston Rockets,Orlando Magic
227,2810,Jalen,Green,Houston Rockets,13698,14,SG,34,6,17,35.3,0,2,0,2,9,22.2,0,5,5,5,1,1,2,0,+17,Jalen Green,24,19,19,10,13698,2024-04-10 00:00:00,Houston Rockets,Orlando Magic
228,207,Jeff,Green,Houston Rockets,13698,6,PF,17,2,4,50.0,2,2,100.0,0,1,0,1,1,2,2,1,1,1,0,+5,Jeff Green,10,8,8,4,13698,2024-04-10 00:00:00,Houston Rockets,Orlando Magic
229,869,Samardo,Samuels,Houston Rockets,13698,0,F,1,0,1,0,0,0,0,0,0,0,0,0,0,0,0,0,0,0,-2,Samardo Samuels,0,0,0,0,13698,2024-04-10 00:00:00,Houston Rockets,Orlando Magic
230,3978,Cam,Whitmore,Houston Rockets,13698,2,F,6,1,4,25.0,0,0,0,0,3,0,0,0,0,0,2,0,0,0,-3,Cam Whitmore,2,2,2,0,13698,2024-04-10 00:00:00,Houston Rockets,Orlando Magic
231,82,Reggie,Bullock,Houston Rockets,13698,0,SF,9,0,0,0,0,0,0,0,0,0,0,0,0,0,0,1,0,1,-7,Reggie Bullock,0,0,0,0,13698,2024-04-10 00:00:00,Houston Rockets,Orlando Magic
232,1485,Jock,Landale,Houston Rockets,13698,8,C,23,3,4,75.0,1,2,50.0,1,2,50.0,0,2,2,4,2,1,0,2,+4,Jock Landale,14,10,12,6,13698,2024-04-10 00:00:00,Houston Rockets,Orlando Magic
233,2672,Nate,Hinton,Houston Rockets,13698,0,G,1,0,0,0,0,0,0,0,0,0,0,0,0,0,0,1,0,0,-2,Nate Hinton,0,0,0,0,13698,2024-04-10 00:00:00,Houston Rockets,Orlando Magic
234,3931,Jeenathan,Williams,Houston Rockets,13698,0,G,1,0,0,0,0,0,0,0,0,0,0,0,0,0,0,0,0,0,-2,Jeenathan Williams,0,0,0,0,13698,2024-04-10 00:00:00,Houston Rockets,Orlando Magic
235,3414,Paolo,Banchero,Orlando Magic,13698,21,PF,36,7,19,36.8,7,7,100.0,0,5,0,0,7,7,6,1,0,4,0,-20,Paolo Banchero,34,28,27,13,13698,2024-04-10 00:00:00,Houston Rockets,Orlando Magic
236,950,Wendell,Carter Jr.,Orlando Magic,13698,7,C,21,3,7,42.9,0,0,0,1,3,33.3,3,3,6,2,2,1,2,0,-11,Wendell Carter Jr.,15,13,9,8,13698,2024-04-10 00:00:00,Houston Rockets,Orlando Magic
237,779,Markelle,Fultz,Orlando Magic,13698,18,PG,34,8,18,44.4,2,2,100.0,0,2,0,2,2,4,2,3,0,3,1,-10,Markelle Fultz,24,22,20,6,13698,2024-04-10 00:00:00,Houston Rockets,Orlando Magic
238,220,Gary,Harris,Orlando Magic,13698,6,SG,31,2,3,66.7,0,0,0,2,2,100.0,1,4,5,2,2,1,0,0,-9,Gary Harris,13,11,8,7,13698,2024-04-10 00:00:00,Houston Rockets,Orlando Magic
239,2852,Jalen,Suggs,Orlando Magic,13698,21,SG,29,7,13,53.8,5,5,100.0,2,5,40.0,0,2,2,4,3,2,1,2,-11,Jalen Suggs,27,23,25,6,13698,2024-04-10 00:00:00,Houston Rockets,Orlando Magic
240,801,Jonathan,Isaac,Orlando Magic,13698,10,PF,22,4,6,66.7,1,2,50.0,1,2,50.0,2,6,8,1,1,2,1,1,-5,Jonathan Isaac,19,18,11,9,13698,2024-04-10 00:00:00,Houston Rockets,Orlando Magic
241,1883,Chuma,Okeke,Orlando Magic,13698,2,PF,2,1,1,100.0,0,0,0,0,0,0,0,1,1,0,0,0,0,0,0,Chuma Okeke,3,3,2,1,13698,2024-04-10 00:00:00,Houston Rockets,Orlando Magic
242,1037,Moritz,Wagner,Orlando Magic,13698,12,C,22,4,8,50.0,4,4,100.0,0,0,0,2,3,5,1,1,1,1,0,+6,Moritz Wagner,18,17,13,6,13698,2024-04-10 00:00:00,Houston Rockets,Orlando Magic
243,1848,Goga,Bitadze,Orlando Magic,13698,0,C,2,0,0,0,0,0,0,0,0,0,0,0,0,0,0,0,0,0,0,Goga Bitadze,0,0,0,0,13698,2024-04-10 00:00:00,Houston Rockets,Orlando Magic
244,2563,Cole,Anthony,Orlando Magic,13698,2,PG,12,1,4,25.0,0,0,0,0,0,0,0,0,0,2,2,1,0,0,-1,Cole Anthony,4,2,4,2,13698,2024-04-10 00:00:00,Houston Rockets,Orlando Magic
245,258,Joe,Ingles,Orlando Magic,13698,7,SG,18,2,6,33.3,2,3,66.7,1,4,25.0,0,3,3,2,0,0,1,1,+3,Joe Ingles,12,10,9,5,13698,2024-04-10 00:00:00,Houston Rockets,Orlando Magic
246,2671,Trevelin,Queen,Orlando Magic,13698,0,SG,2,0,0,0,0,0,0,0,0,0,0,1,1,0,0,0,0,0,0,Trevelin Queen,1,1,0,1,13698,2024-04-10 00:00:00,Houston Rockets,Orlando Magic
247,3449,Caleb,Houstan,Orlando Magic,13698,0,G,8,0,0,0,0,0,0,0,0,0,0,0,0,0,0,1,0,0,-2,Caleb Houstan,0,0,0,0,13698,2024-04-10 00:00:00,Houston Rockets,Orlando Magic
248,4010,Anthony,Black,Orlando Magic,13698,0,G,2,0,0,0,0,0,0,0,0,0,0,0,0,0,0,0,0,0,0,Anthony Black,0,0,0,0,13698,2024-04-10 00:00:00,Houston Rockets,Orlando Magic
249,4011,Jett,Howard,Orlando Magic,13698,0,G,2,0,1,0,0,0,0,0,1,0,0,0,0,1,0,0,1,1,0,Jett Howard,1,0,1,1,13698,2024-04-10 00:00:00,Houston Rockets,Orlando Magic
250,1853,Brandon,Clarke,Memphis Grizzlies,13699,14,PF,27,7,12,58.3,0,0,0,0,1,0,0,1,1,0,1,1,0,1,-13,Brandon Clarke,15,15,14,1,13699,2024-04-10 00:00:00,Memphis Grizzlies,San Antonio Spurs
251,3994,GG,Jackson,Memphis Grizzlies,13699,11,F,28,4,17,23.5,1,2,50.0,2,8,25.0,1,3,4,2,1,0,0,1,-14,GG Jackson,17,15,13,6,13699,2024-04-10 00:00:00,Memphis Grizzlies,San Antonio Spurs
252,4003,Trey,Jemison,Memphis Grizzlies,13699,14,C,30,6,14,42.9,2,2,100.0,0,0,0,5,4,9,2,3,1,1,1,-4,Trey Jemison,25,23,16,11,13699,2024-04-10 00:00:00,Memphis Grizzlies,San Antonio Spurs
253,3341,Jordan,Goodwin,Memphis Grizzlies,13699,10,G,36,5,15,33.3,0,0,0,0,2,0,8,11,19,5,1,0,1,0,-7,Jordan Goodwin,34,29,15,24,13699,2024-04-10 00:00:00,Memphis Grizzlies,San Antonio Spurs
254,3477,Scotty,Pippen Jr.,Memphis Grizzlies,13699,14,G,32,4,15,26.7,6,7,85.7,0,5,0,2,5,7,5,2,4,3,1,-3,Scotty Pippen Jr.,26,21,19,12,13699,2024-04-10 00:00:00,Memphis Grizzlies,San Antonio Spurs
255,3501,Jack,White,Memphis Grizzlies,13699,6,F,26,2,7,28.6,0,0,0,2,5,40.0,0,2,2,0,1,1,0,1,-13,Jack White,8,8,6,2,13699,2024-04-10 00:00:00,Memphis Grizzlies,San Antonio Spurs
256,2884,DeJon,Jarreau,Memphis Grizzlies,13699,0,F,0,0,0,0,0,0,0,0,0,0,0,0,0,0,0,0,0,0,0,DeJon Jarreau,0,0,0,0,13699,2024-04-10 00:00:00,Memphis Grizzlies,San Antonio Spurs
257,11,Tony,Allen,Memphis Grizzlies,13699,6,F,31,3,9,33.3,0,0,0,0,3,0,1,3,4,2,4,2,0,0,-11,Tony Allen,12,10,8,6,13699,2024-04-10 00:00:00,Memphis Grizzlies,San Antonio Spurs
258,4086,M.,Pereira,Memphis Grizzlies,13699,0,F,0,0,0,0,0,0,0,0,0,0,0,0,0,0,0,0,0,0,0,M. Pereira,0,0,0,0,13699,2024-04-10 00:00:00,Memphis Grizzlies,San Antonio Spurs
259,2678,Zavier,Simpson,Memphis Grizzlies,13699,12,G,31,5,15,33.3,0,0,0,2,6,33.3,0,3,3,5,0,1,2,0,-10,Zavier Simpson,20,15,17,8,13699,2024-04-10 00:00:00,Memphis Grizzlies,San Antonio Spurs
260,2830,Sandro,Mamukelashvili,San Antonio Spurs,13699,11,PF,26,4,6,66.7,2,2,100.0,1,3,33.3,4,12,16,4,1,0,2,1,+11,Sandro Mamukelashvili,31,27,15,20,13699,2024-04-10 00:00:00,Memphis Grizzlies,San Antonio Spurs
261,3425,Julian,Champagnie,San Antonio Spurs,13699,17,F,30,6,12,50.0,2,2,100.0,3,8,37.5,1,2,3,1,1,2,3,0,+2,Julian Champagnie,21,20,18,4,13699,2024-04-10 00:00:00,Memphis Grizzlies,San Antonio Spurs
262,4026,Victor,Wembanyama,San Antonio Spurs,13699,18,C,31,9,19,47.4,0,0,0,0,5,0,1,6,7,6,1,0,1,7,+15,Victor Wembanyama,31,25,24,13,13699,2024-04-10 00:00:00,Memphis Grizzlies,San Antonio Spurs
263,2606,Tre,Jones,San Antonio Spurs,13699,8,PG,32,4,10,40.0,0,0,0,0,4,0,2,5,7,4,0,1,0,0,+20,Tre Jones,19,15,12,11,13699,2024-04-10 00:00:00,Memphis Grizzlies,San Antonio Spurs
264,3419,Malaki,Branham,San Antonio Spurs,13699,10,G,28,4,13,30.8,0,0,0,2,8,25.0,0,4,4,2,1,1,1,0,-1,Malaki Branham,16,14,12,6,13699,2024-04-10 00:00:00,Memphis Grizzlies,San Antonio Spurs
265,762,Zach,Collins,San Antonio Spurs,13699,5,PF,18,2,5,40.0,1,1,100.0,0,1,0,0,7,7,3,0,0,1,1,+1,Zach Collins,15,12,8,10,13699,2024-04-10 00:00:00,Memphis Grizzlies,San Antonio Spurs
266,2809,RaiQuan,Gray,San Antonio Spurs,13699,0,F,4,0,0,0,0,0,0,0,0,0,0,2,2,0,0,0,1,0,-4,RaiQuan Gray,2,2,0,2,13699,2024-04-10 00:00:00,Memphis Grizzlies,San Antonio Spurs
267,973,Devonte',Graham,San Antonio Spurs,13699,3,PG,21,1,6,16.7,0,0,0,1,6,16.7,0,0,0,4,2,0,2,1,+14,Devonte' Graham,7,3,7,4,13699,2024-04-10 00:00:00,Memphis Grizzlies,San Antonio Spurs
268,3418,Jamaree,Bouyea,San Antonio Spurs,13699,4,G,3,2,2,100.0,0,0,0,0,0,0,0,0,0,0,2,0,0,0,-1,Jamaree Bouyea,4,4,4,0,13699,2024-04-10 00:00:00,Memphis Grizzlies,San Antonio Spurs
269,2804,David,Duke Jr.,San Antonio Spurs,13699,3,G,3,1,1,100.0,0,0,0,1,1,100.0,0,0,0,1,0,0,0,0,-1,David Duke Jr.,4,3,4,1,13699,2024-04-10 00:00:00,Memphis Grizzlies,San Antonio Spurs
270,3499,Blake,Wesley,San Antonio Spurs,13699,13,G,23,5,7,71.4,1,1,100.0,2,3,66.7,0,2,2,3,2,0,5,0,+13,Blake Wesley,18,15,16,5,13699,2024-04-10 00:00:00,Memphis Grizzlies,San Antonio Spurs
271,4024,Sidy,Cissoko,San Antonio Spurs,13699,10,G,21,4,6,66.7,2,2,100.0,0,1,0,2,1,3,2,2,1,0,1,+6,Sidy Cissoko,15,13,12,5,13699,2024-04-10 00:00:00,Memphis Grizzlies,San Antonio Spurs
272,2621,Jaden,McDaniels,Minnesota Timberwolves,13700,9,PF,28,3,6,50.0,2,2,100.0,1,4,25.0,0,5,5,2,6,1,0,1,-10,Jaden McDaniels,16,14,11,7,13700,2024-04-10 00:00:00,Minnesota Timberwolves,Washington Wizards
273,192,Rudy,Gobert,Minnesota Timberwolves,13700,19,C,38,5,9,55.6,9,13,69.2,0,0,0,5,11,16,3,3,2,1,4,+12,Rudy Gobert,38,35,22,19,13700,2024-04-10 00:00:00,Minnesota Timberwolves,Washington Wizards
274,2146,Naz,Reid,Minnesota Timberwolves,13700,3,C,8,1,5,20.0,0,0,0,1,2,50.0,0,2,2,0,1,1,0,1,-15,Naz Reid,5,5,3,2,13700,2024-04-10 00:00:00,Minnesota Timberwolves,Washington Wizards
275,114,Mike,Conley,Minnesota Timberwolves,13700,15,PG,28,5,11,45.5,0,0,0,5,9,55.6,1,1,2,3,1,1,2,0,+14,Mike Conley,20,17,18,5,13700,2024-04-10 00:00:00,Minnesota Timberwolves,Washington Wizards
276,2584,Anthony,Edwards,Minnesota Timberwolves,13700,51,SG,38,17,29,58.6,11,11,100.0,6,13,46.2,1,5,6,7,0,0,2,0,+6,Anthony Edwards,64,57,58,13,13700,2024-04-10 00:00:00,Minnesota Timberwolves,Washington Wizards
277,3470,Josh,Minott,Minnesota Timberwolves,13700,0,F,1,0,0,0,0,0,0,0,0,0,0,0,0,0,0,0,0,0,-6,Josh Minott,0,0,0,0,13700,2024-04-10 00:00:00,Minnesota Timberwolves,Washington Wizards
278,4001,Leonard,Miller,Minnesota Timberwolves,13700,0,F,1,0,0,0,0,0,0,0,0,0,0,0,0,0,0,0,0,0,-6,Leonard Miller,0,0,0,0,13700,2024-04-10 00:00:00,Minnesota Timberwolves,Washington Wizards
279,540,T.J.,Warren,Minnesota Timberwolves,13700,0,SF,1,0,0,0,0,0,0,0,0,0,0,0,0,0,0,0,0,0,-6,T.J. Warren,0,0,0,0,13700,2024-04-10 00:00:00,Minnesota Timberwolves,Washington Wizards
280,18,Kyle,Anderson,Minnesota Timberwolves,13700,1,SF,26,0,3,0,1,2,50.0,0,0,0,0,2,2,3,2,1,0,0,+7,Kyle Anderson,6,3,4,5,13700,2024-04-10 00:00:00,Minnesota Timberwolves,Washington Wizards
281,845,Monte,Morris,Minnesota Timberwolves,13700,3,PG,12,1,4,25.0,0,0,0,1,2,50.0,0,4,4,0,0,0,0,0,+7,Monte Morris,7,7,3,4,13700,2024-04-10 00:00:00,Minnesota Timberwolves,Washington Wizards
282,997,Jordan,McLaughlin,Minnesota Timberwolves,13700,6,PG,25,2,3,66.7,2,2,100.0,0,1,0,2,1,3,7,0,1,0,0,+27,Jordan McLaughlin,16,9,13,10,13700,2024-04-10 00:00:00,Minnesota Timberwolves,Washington Wizards
283,1845,Nickeil,Alexander-Walker,Minnesota Timberwolves,13700,23,SG,31,9,19,47.4,1,2,50.0,4,9,44.4,1,3,4,5,1,2,2,2,+27,Nickeil Alexander-Walker,32,27,28,9,13700,2024-04-10 00:00:00,Minnesota Timberwolves,Washington Wizards
284,3154,Daishen,Nix,Minnesota Timberwolves,13700,0,SG,1,0,1,0,0,0,0,0,1,0,0,0,0,0,0,0,1,0,-6,Daishen Nix,0,0,0,0,13700,2024-04-10 00:00:00,Minnesota Timberwolves,Washington Wizards
285,3474,Wendell,Moore Jr.,Minnesota Timberwolves,13700,0,G,1,0,0,0,0,0,0,0,0,0,0,0,0,0,0,0,0,0,-6,Wendell Moore Jr.,0,0,0,0,13700,2024-04-10 00:00:00,Minnesota Timberwolves,Washington Wizards
286,2590,Anthony,Gill,Washington Wizards,13700,15,PF,36,6,11,54.5,2,2,100.0,1,3,33.3,1,8,9,3,2,0,0,3,-3,Anthony Gill,27,24,18,12,13700,2024-04-10 00:00:00,Minnesota Timberwolves,Washington Wizards
287,3413,Patrick,Baldwin Jr.,Washington Wizards,13700,15,F,38,6,11,54.5,0,0,0,3,8,37.5,1,5,6,4,4,2,1,0,-5,Patrick Baldwin Jr.,25,21,19,10,13700,2024-04-10 00:00:00,Minnesota Timberwolves,Washington Wizards
288,2825,Corey,Kispert,Washington Wizards,13700,25,SF,36,9,17,52.9,2,2,100.0,5,10,50.0,1,2,3,5,0,0,2,0,-4,Corey Kispert,33,28,30,8,13700,2024-04-10 00:00:00,Minnesota Timberwolves,Washington Wizards
289,2564,Deni,Avdija,Washington Wizards,13700,15,SF,35,4,12,33.3,4,5,80.0,3,5,60.0,0,6,6,5,4,0,2,1,+3,Deni Avdija,26,21,20,11,13700,2024-04-10 00:00:00,Minnesota Timberwolves,Washington Wizards
290,1887,Jordan,Poole,Washington Wizards,13700,24,SG,33,9,22,40.9,1,1,100.0,5,13,38.5,1,2,3,6,2,1,2,0,-8,Jordan Poole,33,27,30,9,13700,2024-04-10 00:00:00,Minnesota Timberwolves,Washington Wizards
291,2838,Eugene,Omoruyi,Washington Wizards,13700,7,F,12,2,4,50.0,1,2,50.0,2,2,100.0,2,0,2,0,2,1,2,0,-6,Eugene Omoruyi,9,9,7,2,13700,2024-04-10 00:00:00,Minnesota Timberwolves,Washington Wizards
292,2796,Jared,Butler,Washington Wizards,13700,4,SG,22,2,5,40.0,0,0,0,0,1,0,0,6,6,3,3,1,0,0,-19,Jared Butler,13,10,7,9,13700,2024-04-10 00:00:00,Minnesota Timberwolves,Washington Wizards
293,3576,Jules,Bernard,Washington Wizards,13700,6,G,8,3,3,100.0,0,0,0,0,0,0,1,2,3,0,2,0,2,0,0,Jules Bernard,9,9,6,3,13700,2024-04-10 00:00:00,Minnesota Timberwolves,Washington Wizards
294,3428,Johnny,Davis,Washington Wizards,13700,10,G,20,3,4,75.0,3,5,60.0,1,1,100.0,0,3,3,0,3,0,2,0,-3,Johnny Davis,13,13,10,3,13700,2024-04-10 00:00:00,Minnesota Timberwolves,Washington Wizards
295,3448,Chet,Holmgren,Oklahoma City Thunder,13701,15,PF,34,5,9,55.6,3,6,50.0,2,5,40.0,3,6,9,2,1,2,0,2,+11,Chet Holmgren,26,24,17,11,13701,2024-04-10 00:00:00,Oklahoma City Thunder,Sacramento Kings
296,3504,Jalen,Williams,Oklahoma City Thunder,13701,11,F,36,5,11,45.5,0,0,0,1,2,50.0,0,6,6,4,0,1,2,0,+3,Jalen Williams,21,17,15,10,13701,2024-04-10 00:00:00,Oklahoma City Thunder,Sacramento Kings
297,972,Shai,Gilgeous-Alexander,Oklahoma City Thunder,13701,40,PG,38,11,21,52.4,16,20,80.0,2,3,66.7,1,6,7,4,2,2,5,2,+6,Shai Gilgeous-Alexander,51,47,44,11,13701,2024-04-10 00:00:00,Oklahoma City Thunder,Sacramento Kings
298,2808,Josh,Giddey,Oklahoma City Thunder,13701,4,SG,21,2,7,28.6,0,0,0,0,4,0,0,4,4,3,5,1,4,2,+2,Josh Giddey,11,8,7,7,13701,2024-04-10 00:00:00,Oklahoma City Thunder,Sacramento Kings
299,2040,Luguentz,Dort,Oklahoma City Thunder,13701,18,G,30,6,11,54.5,3,4,75.0,3,6,50.0,0,2,2,2,2,2,0,0,+6,Luguentz Dort,22,20,20,4,13701,2024-04-10 00:00:00,Oklahoma City Thunder,Sacramento Kings
300,3505,Jaylin,Williams,Oklahoma City Thunder,13701,4,F,16,2,3,66.7,0,0,0,0,1,0,0,1,1,2,3,0,1,0,-11,Jaylin Williams,7,5,6,3,13701,2024-04-10 00:00:00,Oklahoma City Thunder,Sacramento Kings
301,1044,Kenrich,Williams,Oklahoma City Thunder,13701,0,SF,6,0,2,0,0,0,0,0,1,0,1,1,2,0,1,0,0,0,-14,Kenrich Williams,2,2,0,2,13701,2024-04-10 00:00:00,Oklahoma City Thunder,Sacramento Kings
302,384,Mike,Muscala,Oklahoma City Thunder,13701,0,C,1,0,0,0,0,0,0,0,0,0,0,1,1,0,0,0,0,0,+1,Mike Muscala,1,1,0,1,13701,2024-04-10 00:00:00,Oklahoma City Thunder,Sacramento Kings
303,2604,Isaiah,Joe,Oklahoma City Thunder,13701,10,SG,20,4,7,57.1,0,0,0,2,5,40.0,0,4,4,1,3,2,1,0,+7,Isaiah Joe,15,14,11,5,13701,2024-04-10 00:00:00,Oklahoma City Thunder,Sacramento Kings
304,2863,Aaron,Wiggins,Oklahoma City Thunder,13701,7,SG,19,3,4,75.0,1,1,100.0,0,1,0,1,3,4,1,1,0,0,1,+15,Aaron Wiggins,12,11,8,5,13701,2024-04-10 00:00:00,Oklahoma City Thunder,Sacramento Kings
305,4009,Cason,Wallace,Oklahoma City Thunder,13701,3,G,18,1,5,20.0,0,0,0,1,2,50.0,0,2,2,2,0,1,0,1,+9,Cason Wallace,7,5,5,4,13701,2024-04-10 00:00:00,Oklahoma City Thunder,Sacramento Kings
306,463,Domantas,Sabonis,Sacramento Kings,13701,8,PF,34,2,7,28.6,4,7,57.1,0,0,0,8,5,13,5,5,1,5,0,-18,Domantas Sabonis,26,21,13,18,13701,2024-04-10 00:00:00,Oklahoma City Thunder,Sacramento Kings
307,36,Harrison,Barnes,Sacramento Kings,13701,10,SF,27,1,8,12.5,8,10,80.0,0,4,0,2,4,6,0,1,1,1,0,-3,Harrison Barnes,16,16,10,6,13701,2024-04-10 00:00:00,Oklahoma City Thunder,Sacramento Kings
308,3475,Keegan,Murray,Sacramento Kings,13701,15,SF,38,5,16,31.3,2,2,100.0,3,10,30.0,3,7,10,2,0,0,0,0,-8,Keegan Murray,27,25,17,12,13701,2024-04-10 00:00:00,Oklahoma City Thunder,Sacramento Kings
309,776,De'Aaron,Fox,Sacramento Kings,13701,33,PG,43,12,29,41.4,2,4,50.0,7,17,41.2,0,8,8,6,2,2,2,0,-3,De'Aaron Fox,47,41,39,14,13701,2024-04-10 00:00:00,Oklahoma City Thunder,Sacramento Kings
310,3436,Keon,Ellis,Sacramento Kings,13701,26,G,36,9,17,52.9,0,0,0,8,15,53.3,2,4,6,5,5,2,5,2,-4,Keon Ellis,37,32,31,11,13701,2024-04-10 00:00:00,Oklahoma City Thunder,Sacramento Kings
311,331,Trey,Lyles,Sacramento Kings,13701,3,PF,22,1,7,14.3,0,0,0,1,5,20.0,3,4,7,0,1,2,1,1,+3,Trey Lyles,10,10,3,7,13701,2024-04-10 00:00:00,Oklahoma City Thunder,Sacramento Kings
312,313,Alex,Len,Sacramento Kings,13701,0,C,10,0,0,0,0,0,0,0,0,0,2,2,4,2,3,0,1,1,+7,Alex Len,6,4,2,6,13701,2024-04-10 00:00:00,Oklahoma City Thunder,Sacramento Kings
313,2834,Davion,Mitchell,Sacramento Kings,13701,8,PG,22,3,10,30.0,1,1,100.0,1,6,16.7,0,1,1,2,2,0,1,0,-6,Davion Mitchell,11,9,10,3,13701,2024-04-10 00:00:00,Oklahoma City Thunder,Sacramento Kings
314,4020,Colby,Jones,Sacramento Kings,13701,2,G,9,0,2,0,2,2,100.0,0,1,0,1,0,1,1,3,0,1,0,-3,Colby Jones,4,3,3,2,13701,2024-04-10 00:00:00,Oklahoma City Thunder,Sacramento Kings
315,1891,Luka,Samanic,Utah Jazz,13702,15,F,35,6,15,40.0,2,2,100.0,1,3,33.3,3,7,10,3,0,0,1,0,-24,Luka Samanic,28,25,18,13,13702,2024-04-10 01:00:00,Utah Jazz,Denver Nuggets
316,4031,Taylor,Hendricks,Utah Jazz,13702,3,F,22,1,5,20.0,0,0,0,1,2,50.0,1,4,5,1,0,1,0,1,-7,Taylor Hendricks,9,8,4,6,13702,2024-04-10 01:00:00,Utah Jazz,Denver Nuggets
317,2785,Omer,Yurtseven,Utah Jazz,13702,20,C,37,9,14,64.3,2,2,100.0,0,1,0,4,7,11,2,1,2,3,0,-16,Omer Yurtseven,33,31,22,13,13702,2024-04-10 01:00:00,Utah Jazz,Denver Nuggets
318,3454,Johnny,Juzang,Utah Jazz,13702,5,G,32,2,8,25.0,0,0,0,1,4,25.0,0,2,2,3,2,0,1,0,-22,Johnny Juzang,10,7,8,5,13702,2024-04-10 01:00:00,Utah Jazz,Denver Nuggets
319,4029,Keyonte,George,Utah Jazz,13702,10,G,30,4,11,36.4,0,0,0,2,9,22.2,1,2,3,5,0,0,5,0,-15,Keyonte George,18,13,15,8,13702,2024-04-10 01:00:00,Utah Jazz,Denver Nuggets
320,1847,Darius,Bazley,Utah Jazz,13702,8,F,25,2,5,40.0,4,4,100.0,0,2,0,1,4,5,0,0,1,0,0,-3,Darius Bazley,13,13,8,5,13702,2024-04-10 01:00:00,Utah Jazz,Denver Nuggets
321,4034,Brice,Sensabaugh,Utah Jazz,13702,10,F,21,2,9,22.2,5,5,100.0,1,2,50.0,1,4,5,2,2,0,0,0,+4,Brice Sensabaugh,17,15,12,7,13702,2024-04-10 01:00:00,Utah Jazz,Denver Nuggets
322,1867,Talen,Horton-Tucker,Utah Jazz,13702,24,SG,32,10,23,43.5,0,0,0,4,8,50.0,0,3,3,2,4,1,4,1,-5,Talen Horton-Tucker,29,27,26,5,13702,2024-04-10 01:00:00,Utah Jazz,Denver Nuggets
323,2842,Jason,Preston,Utah Jazz,13702,0,G,6,0,1,0,0,0,0,0,0,0,0,0,0,1,0,0,0,0,+8,Jason Preston,1,0,1,1,13702,2024-04-10 01:00:00,Utah Jazz,Denver Nuggets
324,1014,Michael,Porter Jr.,Denver Nuggets,13702,12,SF,29,5,13,38.5,0,0,0,2,7,28.6,1,4,5,0,1,1,0,1,+15,Michael Porter Jr.,17,17,12,5,13702,2024-04-10 01:00:00,Utah Jazz,Denver Nuggets
325,279,Nikola,Jokic,Denver Nuggets,13702,28,C,34,12,20,60.0,2,2,100.0,2,2,100.0,5,8,13,7,2,3,5,1,+23,Nikola Jokic,48,41,35,20,13702,2024-04-10 01:00:00,Utah Jazz,Denver Nuggets
326,383,Jamal,Murray,Denver Nuggets,13702,28,PG,27,11,20,55.0,2,4,50.0,4,10,40.0,0,2,2,4,1,4,1,4,+22,Jamal Murray,34,30,32,6,13702,2024-04-10 01:00:00,Utah Jazz,Denver Nuggets
327,89,Kentavious,Caldwell-Pope,Denver Nuggets,13702,6,SG,29,3,5,60.0,0,0,0,0,2,0,1,1,2,4,3,0,1,1,+18,Kentavious Caldwell-Pope,12,8,10,6,13702,2024-04-10 01:00:00,Utah Jazz,Denver Nuggets
328,3420,Christian,Braun,Denver Nuggets,13702,11,G,28,4,6,66.7,0,0,0,3,4,75.0,1,1,2,5,1,2,0,0,+17,Christian Braun,18,13,16,7,13702,2024-04-10 01:00:00,Utah Jazz,Denver Nuggets
329,2627,Zeke,Nnaji,Denver Nuggets,13702,6,PF,12,3,3,100.0,0,3,0,0,0,0,2,1,3,0,0,0,0,1,-5,Zeke Nnaji,9,9,6,3,13702,2024-04-10 01:00:00,Utah Jazz,Denver Nuggets
330,3967,Hunter,Tyson,Denver Nuggets,13702,0,F,2,0,1,0,0,0,0,0,1,0,0,0,0,0,0,0,0,0,-2,Hunter Tyson,0,0,0,0,13702,2024-04-10 01:00:00,Utah Jazz,Denver Nuggets
331,3498,Peyton,Watson,Denver Nuggets,13702,5,F,30,2,7,28.6,1,2,50.0,0,1,0,0,9,9,4,1,0,1,2,+3,Peyton Watson,18,14,9,13,13702,2024-04-10 01:00:00,Utah Jazz,Denver Nuggets
332,243,Justin,Holiday,Denver Nuggets,13702,6,SF,18,2,5,40.0,0,0,0,2,4,50.0,0,1,1,0,1,0,0,0,-5,Justin Holiday,7,7,6,1,13702,2024-04-10 01:00:00,Utah Jazz,Denver Nuggets
333,2814,Jay,Huff,Denver Nuggets,13702,0,C,2,0,0,0,0,0,0,0,0,0,1,0,1,0,0,1,0,1,-2,Jay Huff,1,1,0,1,13702,2024-04-10 01:00:00,Utah Jazz,Denver Nuggets
334,264,Reggie,Jackson,Denver Nuggets,13702,9,PG,24,4,13,30.8,0,0,0,1,6,16.7,2,2,4,5,0,1,0,1,0,Reggie Jackson,18,13,14,9,13702,2024-04-10 01:00:00,Utah Jazz,Denver Nuggets
335,3965,Jalen,Pickett,Denver Nuggets,13702,0,G,2,0,0,0,0,0,0,0,0,0,0,0,0,1,0,0,0,0,-2,Jalen Pickett,1,0,1,1,13702,2024-04-10 01:00:00,Utah Jazz,Denver Nuggets
336,3966,Julian,Strawther,Denver Nuggets,13702,0,G,2,0,1,0,0,0,0,0,0,0,0,1,1,0,0,0,1,0,-2,Julian Strawther,1,1,0,1,13702,2024-04-10 01:00:00,Utah Jazz,Denver Nuggets
337,1862,Rui,Hachimura,Los Angeles Lakers,13703,20,PF,31,7,21,33.3,4,4,100.0,2,7,28.6,2,9,11,2,0,1,0,2,-6,Rui Hachimura,33,31,22,13,13703,2024-04-10 02:00:00,Los Angeles Lakers,Golden State Warriors
338,265,LeBron,James,Los Angeles Lakers,13703,33,SF,36,14,22,63.6,4,5,80.0,1,3,33.3,1,6,7,11,0,2,4,0,-6,LeBron James,51,40,44,18,13703,2024-04-10 02:00:00,Los Angeles Lakers,Golden State Warriors
339,1864,Jaxson,Hayes,Los Angeles Lakers,13703,11,C,28,5,6,83.3,1,2,50.0,0,0,0,3,3,6,1,4,1,2,1,-7,Jaxson Hayes,18,17,12,7,13703,2024-04-10 02:00:00,Los Angeles Lakers,Golden State Warriors
340,462,D'Angelo,Russell,Los Angeles Lakers,13703,14,PG,37,3,11,27.3,6,6,100.0,2,7,28.6,0,2,2,7,2,0,0,0,-11,D'Angelo Russell,23,16,21,9,13703,2024-04-10 02:00:00,Los Angeles Lakers,Golden State Warriors
341,2845,Austin,Reaves,Los Angeles Lakers,13703,22,SG,35,8,15,53.3,2,3,66.7,4,7,57.1,3,4,7,6,3,0,0,0,0,Austin Reaves,35,29,28,13,13703,2024-04-10 02:00:00,Los Angeles Lakers,Golden State Warriors
342,437,Taurean,Prince,Los Angeles Lakers,13703,2,PF,19,1,6,16.7,0,0,0,0,3,0,0,1,1,0,1,1,0,0,-18,Taurean Prince,3,3,2,1,13703,2024-04-10 02:00:00,Los Angeles Lakers,Golden State Warriors
343,3991,Maxwell,Lewis,Los Angeles Lakers,13703,2,F,2,0,0,0,2,3,66.7,0,0,0,0,0,0,1,1,0,0,0,+2,Maxwell Lewis,3,2,3,1,13703,2024-04-10 02:00:00,Los Angeles Lakers,Golden State Warriors
344,1889,Cam,Reddish,Los Angeles Lakers,13703,0,SF,10,0,2,0,0,0,0,0,0,0,0,0,0,1,1,0,0,0,-3,Cam Reddish,1,0,1,1,13703,2024-04-10 02:00:00,Los Angeles Lakers,Golden State Warriors
345,3987,Colin,Castleton,Los Angeles Lakers,13703,2,C,2,1,2,50.0,0,0,0,0,0,0,1,0,1,0,0,1,0,0,+2,Colin Castleton,3,3,2,1,13703,2024-04-10 02:00:00,Los Angeles Lakers,Golden State Warriors
346,142,Spencer,Dinwiddie,Los Angeles Lakers,13703,12,PG,22,4,7,57.1,1,1,100.0,3,5,60.0,0,4,4,0,1,0,0,0,-13,Spencer Dinwiddie,16,16,12,4,13703,2024-04-10 02:00:00,Los Angeles Lakers,Golden State Warriors
347,1775,Gabe,Vincent,Los Angeles Lakers,13703,0,PG,15,0,3,0,0,0,0,0,3,0,0,1,1,1,1,2,1,0,-14,Gabe Vincent,2,1,1,2,13703,2024-04-10 02:00:00,Los Angeles Lakers,Golden State Warriors
348,2620,Skylar,Mays,Los Angeles Lakers,13703,0,SG,2,0,0,0,0,0,0,0,0,0,0,0,0,1,0,0,0,0,+2,Skylar Mays,1,0,1,1,13703,2024-04-10 02:00:00,Los Angeles Lakers,Golden State Warriors
349,3427,Max,Christie,Los Angeles Lakers,13703,2,G,2,1,1,100.0,0,0,0,0,0,0,0,0,0,0,0,0,0,0,+2,Max Christie,2,2,2,0,13703,2024-04-10 02:00:00,Los Angeles Lakers,Golden State Warriors
350,204,Draymond,Green,Golden State Warriors,13703,15,PF,32,5,7,71.4,0,2,0,5,7,71.4,0,6,6,10,2,0,4,1,+11,Draymond Green,31,21,25,16,13703,2024-04-10 02:00:00,Los Angeles Lakers,Golden State Warriors
351,3973,Trayce,JacksonDavis,Golden State Warriors,13703,7,F,25,2,5,40.0,3,5,60.0,0,0,0,2,5,7,0,0,0,1,3,-1,Trayce JacksonDavis,14,14,7,7,13703,2024-04-10 02:00:00,Los Angeles Lakers,Golden State Warriors
352,548,Andrew,Wiggins,Golden State Warriors,13703,17,SF,29,7,12,58.3,0,0,0,3,5,60.0,1,3,4,0,3,0,0,3,+10,Andrew Wiggins,21,21,17,4,13703,2024-04-10 02:00:00,Los Angeles Lakers,Golden State Warriors
353,124,Stephen,Curry,Golden State Warriors,13703,23,PG,32,7,9,77.8,3,4,75.0,6,6,100.0,0,7,7,8,2,1,1,2,+13,Stephen Curry,38,30,31,15,13703,2024-04-10 02:00:00,Los Angeles Lakers,Golden State Warriors
354,514,Klay,Thompson,Golden State Warriors,13703,27,SG,33,10,16,62.5,2,2,100.0,5,10,50.0,0,0,0,3,2,1,2,1,+11,Klay Thompson,30,27,30,3,13703,2024-04-10 02:00:00,Los Angeles Lakers,Golden State Warriors
355,2827,Jonathan,Kuminga,Golden State Warriors,13703,8,PF,21,2,8,25.0,3,4,75.0,1,3,33.3,0,6,6,3,3,1,0,0,+10,Jonathan Kuminga,17,14,11,9,13703,2024-04-10 02:00:00,Los Angeles Lakers,Golden State Warriors
356,2806,Usman,Garuba,Golden State Warriors,13703,0,PF,2,0,0,0,0,0,0,0,0,0,0,0,0,0,0,0,1,1,-2,Usman Garuba,0,0,0,0,13703,2024-04-10 02:00:00,Los Angeles Lakers,Golden State Warriors
357,3485,Gui,Santos,Golden State Warriors,13703,2,F,2,1,1,100.0,0,0,0,0,0,0,0,0,0,0,0,0,0,0,-2,Gui Santos,2,2,2,0,13703,2024-04-10 02:00:00,Los Angeles Lakers,Golden State Warriors
358,415,Chris,Paul,Golden State Warriors,13703,11,PG,25,5,10,50.0,0,0,0,1,4,25.0,0,6,6,9,2,0,3,0,+21,Chris Paul,26,17,20,15,13703,2024-04-10 02:00:00,Los Angeles Lakers,Golden State Warriors
359,593,Gary,Payton II,Golden State Warriors,13703,9,SG,14,3,6,50.0,1,2,50.0,2,3,66.7,0,1,1,1,2,0,1,1,+1,Gary Payton II,11,10,10,2,13703,2024-04-10 02:00:00,Los Angeles Lakers,Golden State Warriors
360,2836,Moses,Moody,Golden State Warriors,13703,0,SG,2,0,0,0,0,0,0,0,0,0,0,1,1,1,0,0,1,0,-2,Moses Moody,2,1,1,2,13703,2024-04-10 02:00:00,Los Angeles Lakers,Golden State Warriors
361,3480,Lester,Quinones,Golden State Warriors,13703,2,G,2,0,0,0,2,2,100.0,0,0,0,0,1,1,0,0,0,0,0,-2,Lester Quinones,3,3,2,1,13703,2024-04-10 02:00:00,Los Angeles Lakers,Golden State Warriors
362,3492,Pat,Spencer,Golden State Warriors,13703,0,G,2,0,0,0,0,0,0,0,0,0,0,0,0,0,1,0,0,0,-2,Pat Spencer,0,0,0,0,13703,2024-04-10 02:00:00,Los Angeles Lakers,Golden State Warriors
363,3975,Brandin,Podziemski,Golden State Warriors,13703,13,G,20,5,6,83.3,0,0,0,3,3,100.0,1,2,3,2,0,0,1,0,+4,Brandin Podziemski,18,16,15,5,13703,2024-04-10 02:00:00,Los Angeles Lakers,Golden State Warriors
364,153,Kevin,Durant,Phoenix Suns,13704,21,PF,40,8,22,36.4,3,5,60.0,2,5,40.0,0,2,2,2,2,2,1,0,-14,Kevin Durant,25,23,23,4,13704,2024-04-10 02:00:00,Phoenix Suns,LA Clippers
365,966,Drew,Eubanks,Phoenix Suns,13704,6,PF,12,3,6,50.0,0,0,0,0,0,0,3,2,5,1,0,1,0,0,-20,Drew Eubanks,12,11,7,6,13704,2024-04-10 02:00:00,Phoenix Suns,LA Clippers
366,45,Bradley,Beal,Phoenix Suns,13704,19,SG,39,6,13,46.2,6,6,100.0,1,2,50.0,2,5,7,3,2,1,2,5,-11,Bradley Beal,29,26,22,10,13704,2024-04-10 02:00:00,Phoenix Suns,LA Clippers
367,926,Grayson,Allen,Phoenix Suns,13704,9,SG,31,3,13,23.1,3,4,75.0,0,8,0,1,5,6,2,3,3,0,0,-2,Grayson Allen,17,15,11,8,13704,2024-04-10 02:00:00,Phoenix Suns,LA Clippers
368,64,Devin,Booker,Phoenix Suns,13704,12,SG,40,1,11,9.1,10,11,90.9,0,4,0,1,2,3,5,2,2,3,0,-7,Devin Booker,20,15,17,8,13704,2024-04-10 02:00:00,Phoenix Suns,LA Clippers
369,851,Royce,O'Neale,Phoenix Suns,13704,10,PF,29,3,10,30.0,2,2,100.0,2,7,28.6,0,11,11,4,3,2,0,1,+8,Royce O'Neale,25,21,14,15,13704,2024-04-10 02:00:00,Phoenix Suns,LA Clippers
370,570,Thaddeus,Young,Phoenix Suns,13704,0,F,8,0,1,0,0,0,0,0,0,0,1,1,2,0,0,0,0,0,-10,Thaddeus Young,2,2,0,2,13704,2024-04-10 02:00:00,Phoenix Suns,LA Clippers
371,2859,Ish,Wainright,Phoenix Suns,13704,0,F,1,0,0,0,0,0,0,0,0,0,0,0,0,0,0,0,0,0,+2,Ish Wainright,0,0,0,0,13704,2024-04-10 02:00:00,Phoenix Suns,LA Clippers
372,1010,Josh,Okogie,Phoenix Suns,13704,0,SF,1,0,0,0,0,0,0,0,0,0,0,0,0,0,0,0,0,0,+2,Josh Okogie,0,0,0,0,13704,2024-04-10 02:00:00,Phoenix Suns,LA Clippers
373,1875,Nassir,Little,Phoenix Suns,13704,2,SF,1,1,1,100.0,0,0,0,0,0,0,0,0,0,0,0,0,0,0,+2,Nassir Little,2,2,2,0,13704,2024-04-10 02:00:00,Phoenix Suns,LA Clippers
374,1849,Bol,Bol,Phoenix Suns,13704,2,C,7,1,2,50.0,0,0,0,0,1,0,0,2,2,0,1,1,0,0,-13,Bol Bol,4,4,2,2,13704,2024-04-10 02:00:00,Phoenix Suns,LA Clippers
375,196,Eric,Gordon,Phoenix Suns,13704,11,SG,29,4,9,44.4,0,0,0,3,8,37.5,0,0,0,0,0,4,2,1,-4,Eric Gordon,11,11,11,0,13704,2024-04-10 02:00:00,Phoenix Suns,LA Clippers
376,4087,I.,Thomas,Phoenix Suns,13704,0,G,1,0,1,0,0,0,0,0,0,0,0,0,0,0,0,0,0,0,+2,I. Thomas,0,0,0,0,13704,2024-04-10 02:00:00,Phoenix Suns,LA Clippers
377,189,Paul,George,LA Clippers,13704,23,F,39,7,15,46.7,6,6,100.0,3,5,60.0,0,7,7,5,4,1,6,1,+12,Paul George,35,30,28,12,13704,2024-04-10 02:00:00,Phoenix Suns,LA Clippers
378,575,Ivica,Zubac,LA Clippers,13704,17,C,28,8,13,61.5,1,1,100.0,0,0,0,2,11,13,2,0,0,3,2,+17,Ivica Zubac,32,30,19,15,13704,2024-04-10 02:00:00,Phoenix Suns,LA Clippers
379,544,Russell,Westbrook,LA Clippers,13704,16,PG,40,7,17,41.2,0,0,0,2,4,50.0,2,13,15,15,3,2,5,0,+17,Russell Westbrook,46,31,31,30,13704,2024-04-10 02:00:00,Phoenix Suns,LA Clippers
380,1877,Terance,Mann,LA Clippers,13704,17,SG,38,8,10,80.0,0,0,0,1,1,100.0,4,6,10,1,4,0,2,0,+7,Terance Mann,28,27,18,11,13704,2024-04-10 02:00:00,Phoenix Suns,LA Clippers
381,434,Norman,Powell,LA Clippers,13704,10,G,33,4,12,33.3,0,0,0,2,4,50.0,0,5,5,1,5,0,1,0,+25,Norman Powell,16,15,11,6,13704,2024-04-10 02:00:00,Phoenix Suns,LA Clippers
382,426,Mason,Plumlee,LA Clippers,13704,2,C,8,0,0,0,2,2,100.0,0,0,0,0,0,0,0,0,0,0,0,+7,Mason Plumlee,2,2,2,0,13704,2024-04-10 02:00:00,Phoenix Suns,LA Clippers
383,2816,Bones,Hyland,LA Clippers,13704,7,PG,17,3,9,33.3,0,0,0,1,4,25.0,1,8,9,2,2,0,0,0,-10,Bones Hyland,18,16,9,11,13704,2024-04-10 02:00:00,Phoenix Suns,LA Clippers
384,2115,Amir,Coffey,LA Clippers,13704,13,SG,34,4,11,36.4,2,2,100.0,3,8,37.5,1,3,4,2,4,2,0,0,-4,Amir Coffey,19,17,15,6,13704,2024-04-10 02:00:00,Phoenix Suns,LA Clippers
385,2792,Brandon,Boston Jr.,LA Clippers,13704,0,SG,1,0,0,0,0,0,0,0,0,0,0,0,0,0,0,0,0,0,-2,Brandon Boston Jr.,0,0,0,0,13704,2024-04-10 02:00:00,Phoenix Suns,LA Clippers
386,3396,Xavier,Moon,LA Clippers,13704,0,G,1,0,0,0,0,0,0,0,0,0,0,0,0,0,0,0,0,0,-2,Xavier Moon,0,0,0,0,13704,2024-04-10 02:00:00,Phoenix Suns,LA Clippers
387,3983,Kobe,Brown,LA Clippers,13704,0,G,1,0,0,0,0,0,0,0,0,0,0,0,0,0,0,0,1,0,-2,Kobe Brown,0,0,0,0,13704,2024-04-10 02:00:00,Phoenix Suns,LA Clippers
388,3496,Jabari,Walker,Portland Trail Blazers,13705,4,F,28,2,5,40.0,0,0,0,0,1,0,2,8,10,0,2,0,1,0,-18,Jabari Walker,14,14,4,10,13705,2024-04-10 02:00:00,Portland Trail Blazers,New Orleans Pelicans
389,4017,Kris,Murray,Portland Trail Blazers,13705,14,F,37,4,8,50.0,2,2,100.0,4,6,66.7,3,2,5,2,5,1,4,2,-8,Kris Murray,21,19,16,7,13705,2024-04-10 02:00:00,Portland Trail Blazers,New Orleans Pelicans
390,930,Deandre,Ayton,Portland Trail Blazers,13705,30,C,36,15,22,68.2,0,0,0,0,1,0,3,10,13,1,2,1,3,0,-26,Deandre Ayton,44,43,31,14,13705,2024-04-10 02:00:00,Portland Trail Blazers,New Orleans Pelicans
391,3408,Scoot,Henderson,Portland Trail Blazers,13705,19,G,41,7,18,38.9,3,3,100.0,2,10,20.0,2,1,3,15,4,1,8,0,-31,Scoot Henderson,37,22,34,18,13705,2024-04-10 02:00:00,Portland Trail Blazers,New Orleans Pelicans
392,4069,R.,Rupert,Portland Trail Blazers,13705,6,G,33,2,9,22.2,0,0,0,2,6,33.3,0,4,4,4,1,0,1,0,+1,R. Rupert,14,10,10,8,13705,2024-04-10 02:00:00,Portland Trail Blazers,New Orleans Pelicans
393,3714,Justin,Minaya,Portland Trail Blazers,13705,3,F,22,1,4,25.0,0,0,0,1,3,33.3,1,3,4,2,2,0,0,0,+9,Justin Minaya,9,7,5,6,13705,2024-04-10 02:00:00,Portland Trail Blazers,New Orleans Pelicans
394,4018,Duop,Reath,Portland Trail Blazers,13705,12,C,12,5,8,62.5,0,1,0,2,3,66.7,2,3,5,1,2,0,0,0,+18,Duop Reath,18,17,13,6,13705,2024-04-10 02:00:00,Portland Trail Blazers,New Orleans Pelicans
395,2788,Dalano,Banton,Portland Trail Blazers,13705,12,G,31,4,11,36.4,2,2,100.0,2,8,25.0,0,3,3,3,1,0,4,1,+5,Dalano Banton,18,15,15,6,13705,2024-04-10 02:00:00,Portland Trail Blazers,New Orleans Pelicans
396,1902,Zion,Williamson,New Orleans Pelicans,13705,22,PF,33,7,18,38.9,8,9,88.9,0,0,0,2,5,7,3,1,1,2,1,+11,Zion Williamson,32,29,25,10,13705,2024-04-10 02:00:00,Portland Trail Blazers,New Orleans Pelicans
397,2822,Herbert,Jones,New Orleans Pelicans,13705,7,SF,38,1,5,20.0,4,4,100.0,1,4,25.0,2,2,4,2,2,2,1,0,+29,Herbert Jones,13,11,9,6,13705,2024-04-10 02:00:00,Portland Trail Blazers,New Orleans Pelicans
398,525,Jonas,Valanciunas,New Orleans Pelicans,13705,11,C,21,5,12,41.7,1,2,50.0,0,2,0,2,6,8,5,0,2,0,0,+18,Jonas Valanciunas,24,19,16,13,13705,2024-04-10 02:00:00,Portland Trail Blazers,New Orleans Pelicans
399,347,CJ,McCollum,New Orleans Pelicans,13705,29,SG,34,10,19,52.6,4,4,100.0,5,10,50.0,1,4,5,3,0,2,1,0,+18,CJ McCollum,37,34,32,8,13705,2024-04-10 02:00:00,Portland Trail Blazers,New Orleans Pelicans
400,2837,Trey,Murphy III,New Orleans Pelicans,13705,31,SG,38,9,17,52.9,8,8,100.0,5,12,41.7,1,7,8,3,1,2,0,0,+22,Trey Murphy III,42,39,34,11,13705,2024-04-10 02:00:00,Portland Trail Blazers,New Orleans Pelicans
401,385,Larry,Nance Jr.,New Orleans Pelicans,13705,2,PF,20,0,2,0,2,2,100.0,0,1,0,4,0,4,2,0,2,1,0,-3,Larry Nance Jr.,8,6,4,6,13705,2024-04-10 02:00:00,Portland Trail Blazers,New Orleans Pelicans
402,3195,Matt,Ryan,New Orleans Pelicans,13705,0,F,2,0,0,0,0,0,0,0,0,0,0,1,1,1,1,0,0,0,-10,Matt Ryan,2,1,1,2,13705,2024-04-10 02:00:00,Portland Trail Blazers,New Orleans Pelicans
403,2846,Jeremiah,Robinson-Earl,New Orleans Pelicans,13705,2,F,2,1,1,100.0,0,0,0,0,0,0,0,0,0,0,0,0,0,0,-10,Jeremiah Robinson-Earl,2,2,2,0,13705,2024-04-10 02:00:00,Portland Trail Blazers,New Orleans Pelicans
404,571,Cody,Zeller,New Orleans Pelicans,13705,0,C,2,0,1,0,0,0,0,0,0,0,1,1,2,0,1,0,0,0,-10,Cody Zeller,2,2,0,2,13705,2024-04-10 02:00:00,Portland Trail Blazers,New Orleans Pelicans
405,2941,Jose,Alvarado,New Orleans Pelicans,13705,2,PG,20,1,6,16.7,0,0,0,0,5,0,0,0,0,1,2,1,0,0,+1,Jose Alvarado,3,2,3,1,13705,2024-04-10 02:00:00,Portland Trail Blazers,New Orleans Pelicans
406,2990,Jalen,Crutcher,New Orleans Pelicans,13705,0,G,0,0,0,0,0,0,0,0,0,0,0,0,0,0,0,0,0,0,0,Jalen Crutcher,0,0,0,0,13705,2024-04-10 02:00:00,Portland Trail Blazers,New Orleans Pelicans
407,3421,Izaiah,Brockington,New Orleans Pelicans,13705,0,G,0,0,0,0,0,0,0,0,0,0,0,0,0,0,0,0,0,0,0,Izaiah Brockington,0,0,0,0,13705,2024-04-10 02:00:00,Portland Trail Blazers,New Orleans Pelicans
408,4002,Jordan,Hawkins,New Orleans Pelicans,13705,0,G,2,0,2,0,0,0,0,0,1,0,0,0,0,0,0,0,1,0,-10,Jordan Hawkins,0,0,0,0,13705,2024-04-10 02:00:00,Portland Trail Blazers,New Orleans Pelicans
409,3406,Dyson,Daniels,New Orleans Pelicans,13705,4,G,28,2,4,50.0,0,0,0,0,1,0,0,6,6,5,1,1,3,1,-6,Dyson Daniels,15,10,9,11,13705,2024-04-10 02:00:00,Portland Trail Blazers,New Orleans Pelicans
410,2835,Evan,Mobley,Cleveland Cavaliers,13706,12,PF,31,4,10,40.0,2,2,100.0,2,4,50.0,3,9,12,1,1,3,4,4,+12,Evan Mobley,25,24,13,13,13706,2024-04-10 23:00:00,Cleveland Cavaliers,Memphis Grizzlies
411,727,Jarrett,Allen,Cleveland Cavaliers,13706,16,C,34,7,13,53.8,2,2,100.0,0,1,0,6,4,10,5,1,0,1,3,-2,Jarrett Allen,31,26,21,15,13706,2024-04-10 23:00:00,Cleveland Cavaliers,Memphis Grizzlies
412,1860,Darius,Garland,Cleveland Cavaliers,13706,16,PG,31,5,13,38.5,4,5,80.0,2,9,22.2,0,6,6,9,2,0,3,1,+23,Darius Garland,31,22,25,15,13706,2024-04-10 23:00:00,Cleveland Cavaliers,Memphis Grizzlies
413,840,Donovan,Mitchell,Cleveland Cavaliers,13706,29,SG,34,9,17,52.9,6,7,85.7,5,10,50.0,1,3,4,8,2,3,3,1,+2,Donovan Mitchell,41,33,37,12,13706,2024-04-10 23:00:00,Cleveland Cavaliers,Memphis Grizzlies
414,2051,Max,Strus,Cleveland Cavaliers,13706,8,SG,30,3,5,60.0,0,1,0,2,3,66.7,1,5,6,1,2,1,0,0,-1,Max Strus,15,14,9,7,13706,2024-04-10 23:00:00,Cleveland Cavaliers,Memphis Grizzlies
415,3957,Pete,Nance,Cleveland Cavaliers,13706,0,F,2,0,1,0,0,0,0,0,0,0,0,0,0,0,0,1,0,0,-4,Pete Nance,0,0,0,0,13706,2024-04-10 23:00:00,Cleveland Cavaliers,Memphis Grizzlies
416,3472,Isaiah,Mobley,Cleveland Cavaliers,13706,0,F,2,0,2,0,0,0,0,0,0,0,1,0,1,0,1,0,0,0,-4,Isaiah Mobley,1,1,0,1,13706,2024-04-10 23:00:00,Cleveland Cavaliers,Memphis Grizzlies
417,3956,Emoni,Bates,Cleveland Cavaliers,13706,0,F,2,0,0,0,0,0,0,0,0,0,0,0,0,0,0,0,0,0,-4,Emoni Bates,0,0,0,0,13706,2024-04-10 23:00:00,Cleveland Cavaliers,Memphis Grizzlies
418,391,Georges,Niang,Cleveland Cavaliers,13706,4,SF,18,1,3,33.3,1,2,50.0,1,2,50.0,0,2,2,1,2,0,1,1,+19,Georges Niang,7,6,5,3,13706,2024-04-10 23:00:00,Cleveland Cavaliers,Memphis Grizzlies
419,2630,Isaac,Okoro,Cleveland Cavaliers,13706,7,SF,27,2,5,40.0,2,6,33.3,1,4,25.0,0,4,4,0,1,1,0,0,+13,Isaac Okoro,11,11,7,4,13706,2024-04-10 23:00:00,Cleveland Cavaliers,Memphis Grizzlies
420,281,Damian,Jones,Cleveland Cavaliers,13706,0,C,2,0,0,0,0,0,0,0,0,0,0,0,0,0,0,0,0,0,-2,Damian Jones,0,0,0,0,13706,2024-04-10 23:00:00,Cleveland Cavaliers,Memphis Grizzlies
421,317,Caris,LeVert,Cleveland Cavaliers,13706,18,SG,28,6,13,46.2,4,4,100.0,2,4,50.0,0,2,2,2,3,2,1,0,+12,Caris LeVert,22,20,20,4,13706,2024-04-10 23:00:00,Cleveland Cavaliers,Memphis Grizzlies
422,4043,Craig Jr.,Porter,Cleveland Cavaliers,13706,0,G,2,0,0,0,0,0,0,0,0,0,0,0,0,0,0,0,0,0,-4,Craig Jr. Porter,0,0,0,0,13706,2024-04-10 23:00:00,Cleveland Cavaliers,Memphis Grizzlies
423,2647,Lamar,Stevens,Memphis Grizzlies,13706,16,PF,37,4,13,30.8,6,6,100.0,2,5,40.0,2,4,6,3,2,1,1,4,+7,Lamar Stevens,25,22,19,9,13706,2024-04-10 23:00:00,Cleveland Cavaliers,Memphis Grizzlies
424,3460,Jake,LaRavia,Memphis Grizzlies,13706,32,F,40,10,18,55.6,4,5,80.0,8,11,72.7,1,6,7,1,1,2,5,1,-16,Jake LaRavia,40,39,33,8,13706,2024-04-10 23:00:00,Cleveland Cavaliers,Memphis Grizzlies
425,3994,GG,Jackson,Memphis Grizzlies,13706,22,F,36,7,21,33.3,6,6,100.0,2,10,20.0,0,2,2,2,2,2,1,1,-13,GG Jackson,26,24,24,4,13706,2024-04-10 23:00:00,Cleveland Cavaliers,Memphis Grizzlies
426,4003,Trey,Jemison,Memphis Grizzlies,13706,4,C,36,2,7,28.6,0,0,0,0,0,0,2,7,9,3,2,1,1,4,-17,Trey Jemison,16,13,7,12,13706,2024-04-10 23:00:00,Cleveland Cavaliers,Memphis Grizzlies
427,3477,Scotty,Pippen Jr.,Memphis Grizzlies,13706,18,G,36,7,15,46.7,2,2,100.0,2,4,50.0,2,2,4,6,3,2,3,0,+4,Scotty Pippen Jr.,28,22,24,10,13706,2024-04-10 23:00:00,Cleveland Cavaliers,Memphis Grizzlies
428,3501,Jack,White,Memphis Grizzlies,13706,0,F,15,0,3,0,0,0,0,0,1,0,2,2,4,1,0,1,1,0,-5,Jack White,5,4,1,5,13706,2024-04-10 23:00:00,Cleveland Cavaliers,Memphis Grizzlies
429,11,Tony,Allen,Memphis Grizzlies,13706,2,F,16,1,2,50.0,0,0,0,0,0,0,0,4,4,1,6,0,0,0,-13,Tony Allen,7,6,3,5,13706,2024-04-10 23:00:00,Cleveland Cavaliers,Memphis Grizzlies
430,2678,Zavier,Simpson,Memphis Grizzlies,13706,4,G,24,2,5,40.0,0,0,0,0,1,0,1,7,8,4,5,1,1,0,-7,Zavier Simpson,16,12,8,12,13706,2024-04-10 23:00:00,Cleveland Cavaliers,Memphis Grizzlies
431,92,Clint,Capela,Atlanta Hawks,13707,15,C,21,7,10,70.0,1,2,50.0,0,0,0,0,6,6,0,0,1,0,0,+14,Clint Capela,21,21,15,6,13707,2024-04-10 23:30:00,Atlanta Hawks,Charlotte Hornets
432,1046,Trae,Young,Atlanta Hawks,13707,14,PG,21,5,5,100.0,2,2,100.0,2,2,100.0,0,4,4,11,1,1,5,0,+16,Trae Young,29,18,25,15,13707,2024-04-10 23:30:00,Atlanta Hawks,Charlotte Hornets
433,743,Bogdan,Bogdanovic,Atlanta Hawks,13707,19,SG,22,6,11,54.5,2,2,100.0,5,10,50.0,0,1,1,8,2,1,2,0,+12,Bogdan Bogdanovic,28,20,27,9,13707,2024-04-10 23:30:00,Atlanta Hawks,Charlotte Hornets
434,2327,Garrison,Mathews,Atlanta Hawks,13707,10,SG,31,4,12,33.3,0,0,0,2,9,22.2,0,3,3,4,0,0,0,0,+14,Garrison Mathews,17,13,14,7,13707,2024-04-10 23:30:00,Atlanta Hawks,Charlotte Hornets
435,2608,Vit,Krejci,Atlanta Hawks,13707,19,G,33,8,14,57.1,0,0,0,3,8,37.5,1,3,4,2,2,2,3,0,-5,Vit Krejci,25,23,21,6,13707,2024-04-10 23:30:00,Atlanta Hawks,Charlotte Hornets
436,1858,Bruno,Fernando,Atlanta Hawks,13707,5,PF,25,1,3,33.3,3,6,50.0,0,0,0,0,6,6,0,5,0,2,0,-14,Bruno Fernando,11,11,5,6,13707,2024-04-10 23:30:00,Atlanta Hawks,Charlotte Hornets
437,3939,Mouhamed,Gueye,Atlanta Hawks,13707,3,F,17,1,3,33.3,0,0,0,1,1,100.0,2,5,7,3,4,1,0,1,0,Mouhamed Gueye,13,10,6,10,13707,2024-04-10 23:30:00,Atlanta Hawks,Charlotte Hornets
438,1903,Dylan,Windler,Atlanta Hawks,13707,12,G,26,4,7,57.1,0,0,0,4,7,57.1,2,1,3,1,1,0,1,0,-20,Dylan Windler,16,15,13,4,13707,2024-04-10 23:30:00,Atlanta Hawks,Charlotte Hornets
439,2589,Trent,Forrest,Atlanta Hawks,13707,6,G,20,3,5,60.0,0,1,0,0,0,0,1,1,2,5,0,1,2,0,-13,Trent Forrest,13,8,11,7,13707,2024-04-10 23:30:00,Atlanta Hawks,Charlotte Hornets
440,3938,Kobe,Bufkin,Atlanta Hawks,13707,11,G,24,4,12,33.3,2,3,66.7,1,3,33.3,1,1,2,1,5,0,1,1,-9,Kobe Bufkin,14,13,12,3,13707,2024-04-10 23:30:00,Atlanta Hawks,Charlotte Hornets
441,1901,Grant,Williams,Charlotte Hornets,13707,16,PF,27,5,6,83.3,4,4,100.0,2,3,66.7,1,5,6,5,5,1,3,0,-1,Grant Williams,27,22,21,11,13707,2024-04-10 23:30:00,Atlanta Hawks,Charlotte Hornets
442,3950,Brandon,Miller,Charlotte Hornets,13707,27,F,33,9,17,52.9,4,4,100.0,5,11,45.5,0,3,3,2,2,0,1,0,+1,Brandon Miller,32,30,29,5,13707,2024-04-10 23:30:00,Atlanta Hawks,Charlotte Hornets
443,941,Miles,Bridges,Charlotte Hornets,13707,18,SF,30,7,14,50.0,2,2,100.0,2,5,40.0,1,2,3,3,0,0,2,0,-9,Miles Bridges,24,21,21,6,13707,2024-04-10 23:30:00,Atlanta Hawks,Charlotte Hornets
444,2831,Tre,Mann,Charlotte Hornets,13707,16,PG,37,5,13,38.5,5,6,83.3,1,4,25.0,1,2,3,7,0,7,1,0,+2,Tre Mann,26,19,23,10,13707,2024-04-10 23:30:00,Atlanta Hawks,Charlotte Hornets
445,2739,Vasilije,Micic,Charlotte Hornets,13707,2,G,22,0,3,0,2,2,100.0,0,2,0,0,2,2,5,0,1,2,0,-14,Vasilije Micic,9,4,7,7,13707,2024-04-10 23:30:00,Atlanta Hawks,Charlotte Hornets
446,2633,Aleksej,Pokusevski,Charlotte Hornets,13707,10,F,26,3,6,50.0,2,2,100.0,2,2,100.0,0,6,6,1,2,1,1,1,+5,Aleksej Pokusevski,17,16,11,7,13707,2024-04-10 23:30:00,Atlanta Hawks,Charlotte Hornets
447,2856,JT,Thor,Charlotte Hornets,13707,6,F,18,3,5,60.0,0,0,0,0,2,0,2,2,4,1,2,0,1,0,+10,JT Thor,11,10,7,5,13707,2024-04-10 23:30:00,Atlanta Hawks,Charlotte Hornets
448,52,Davis,Bertans,Charlotte Hornets,13707,6,SF,18,2,7,28.6,1,1,100.0,1,6,16.7,0,1,1,0,1,0,1,1,+10,Davis Bertans,7,7,6,1,13707,2024-04-10 23:30:00,Atlanta Hawks,Charlotte Hornets
449,2482,Marques,Bolden,Charlotte Hornets,13707,2,C,3,1,1,100.0,0,0,0,0,0,0,0,2,2,0,0,0,0,0,+1,Marques Bolden,4,4,2,2,13707,2024-04-10 23:30:00,Atlanta Hawks,Charlotte Hornets
450,2639,Nick,Richards,Charlotte Hornets,13707,7,C,19,3,4,75.0,1,1,100.0,0,0,0,0,2,2,1,6,1,1,0,+1,Nick Richards,10,9,8,3,13707,2024-04-10 23:30:00,Atlanta Hawks,Charlotte Hornets
451,3469,Bryce,McGowens,Charlotte Hornets,13707,5,G,8,2,3,66.7,0,0,0,1,1,100.0,0,1,1,0,0,0,0,0,-1,Bryce McGowens,6,6,5,1,13707,2024-04-10 23:30:00,Atlanta Hawks,Charlotte Hornets
452,3944,Noah,Clowney,Brooklyn Nets,13708,10,F,39,5,8,62.5,0,0,0,0,2,0,2,5,7,1,0,1,2,7,+5,Noah Clowney,18,17,11,8,13708,2024-04-10 23:30:00,Brooklyn Nets,Toronto Raptors
453,940,Mikal,Bridges,Brooklyn Nets,13708,11,SF,23,3,9,33.3,2,2,100.0,3,8,37.5,1,2,3,2,0,0,1,0,+1,Mikal Bridges,16,14,13,5,13708,2024-04-10 23:30:00,Brooklyn Nets,Toronto Raptors
454,1854,Nic,Claxton,Brooklyn Nets,13708,14,C,33,6,7,85.7,2,4,50.0,0,0,0,2,9,11,4,1,0,3,5,-7,Nic Claxton,29,25,18,15,13708,2024-04-10 23:30:00,Brooklyn Nets,Toronto Raptors
455,472,Dennis,Schroder,Brooklyn Nets,13708,21,PG,36,7,18,38.9,5,5,100.0,2,8,25.0,2,5,7,9,4,2,1,0,+5,Dennis Schroder,37,28,30,16,13708,2024-04-10 23:30:00,Brooklyn Nets,Toronto Raptors
456,2855,Cam,Thomas,Brooklyn Nets,13708,23,SG,37,7,22,31.8,4,4,100.0,5,10,50.0,1,3,4,0,3,0,2,1,-2,Cam Thomas,27,27,23,4,13708,2024-04-10 23:30:00,Brooklyn Nets,Toronto Raptors
457,2861,Trendon,Watford,Brooklyn Nets,13708,6,PF,16,2,5,40.0,2,5,40.0,0,2,0,0,7,7,5,1,0,0,0,+3,Trendon Watford,18,13,11,12,13708,2024-04-10 23:30:00,Brooklyn Nets,Toronto Raptors
458,3946,Jalen,Wilson,Brooklyn Nets,13708,2,F,20,1,3,33.3,0,0,0,0,2,0,2,4,6,2,2,0,0,0,+3,Jalen Wilson,10,8,4,8,13708,2024-04-10 23:30:00,Brooklyn Nets,Toronto Raptors
459,1871,Cameron,Johnson,Brooklyn Nets,13708,13,SF,27,4,8,50.0,4,4,100.0,1,4,25.0,0,3,3,1,4,1,2,0,+6,Cameron Johnson,17,16,14,4,13708,2024-04-10 23:30:00,Brooklyn Nets,Toronto Raptors
460,2848,Day'Ron,Sharpe,Brooklyn Nets,13708,6,C,11,3,6,50.0,0,0,0,0,0,0,4,4,8,1,1,0,2,2,+6,Day'Ron Sharpe,15,14,7,9,13708,2024-04-10 23:30:00,Brooklyn Nets,Toronto Raptors
461,507,Garrett,Temple,Toronto Raptors,13708,3,SF,36,1,6,16.7,0,0,0,1,3,33.3,4,2,6,4,1,2,3,0,-11,Garrett Temple,13,9,7,10,13708,2024-04-10 23:30:00,Brooklyn Nets,Toronto Raptors
462,4089,M.,Williams,Toronto Raptors,13708,7,C,24,3,10,30.0,0,0,0,1,1,100.0,5,9,14,1,4,2,1,0,0,M. Williams,22,21,8,15,13708,2024-04-10 23:30:00,Brooklyn Nets,Toronto Raptors
463,2636,Immanuel,Quickley,Toronto Raptors,13708,32,SG,34,10,24,41.7,8,8,100.0,4,11,36.4,1,6,7,9,5,1,4,1,+5,Immanuel Quickley,48,39,41,16,13708,2024-04-10 23:30:00,Brooklyn Nets,Toronto Raptors
464,3411,Ochai,Agbaji,Toronto Raptors,13708,7,G,34,3,6,50.0,1,1,100.0,0,1,0,0,1,1,1,1,0,0,0,-4,Ochai Agbaji,9,8,8,2,13708,2024-04-10 23:30:00,Brooklyn Nets,Toronto Raptors
465,4027,Gradey,Dick,Toronto Raptors,13708,24,G,34,9,20,45.0,0,0,0,6,14,42.9,1,3,4,0,3,0,1,0,-2,Gradey Dick,28,28,24,4,13708,2024-04-10 23:30:00,Brooklyn Nets,Toronto Raptors
466,1880,Jalen,McDaniels,Toronto Raptors,13708,3,PF,14,0,3,0,3,4,75.0,0,1,0,1,0,1,0,3,1,0,0,0,Jalen McDaniels,4,4,3,1,13708,2024-04-10 23:30:00,Brooklyn Nets,Toronto Raptors
467,3445,Mouhamadou,Gueye,Toronto Raptors,13708,3,F,23,1,7,14.3,1,1,100.0,0,0,0,1,3,4,1,4,1,0,3,-4,Mouhamadou Gueye,8,7,4,5,13708,2024-04-10 23:30:00,Brooklyn Nets,Toronto Raptors
468,2628,Jordan,Nwora,Toronto Raptors,13708,11,SF,18,4,10,40.0,1,2,50.0,2,5,40.0,1,3,4,2,1,0,0,1,-6,Jordan Nwora,17,15,13,6,13708,2024-04-10 23:30:00,Brooklyn Nets,Toronto Raptors
469,3440,Javon,Freeman-Liberty,Toronto Raptors,13708,12,G,24,4,8,50.0,2,2,100.0,2,4,50.0,1,3,4,1,0,1,0,0,+2,Javon Freeman-Liberty,17,16,13,5,13708,2024-04-10 23:30:00,Brooklyn Nets,Toronto Raptors
470,3453,Nikola,Jovic,Miami Heat,13709,6,F,24,3,9,33.3,0,0,0,0,4,0,1,4,5,4,3,0,1,0,-9,Nikola Jovic,15,11,10,9,13709,2024-04-10 23:30:00,Miami Heat,Dallas Mavericks
471,86,Jimmy,Butler,Miami Heat,13709,12,SF,36,5,8,62.5,0,0,0,2,3,66.7,1,3,4,3,0,2,5,0,-9,Jimmy Butler,19,16,15,7,13709,2024-04-10 23:30:00,Miami Heat,Dallas Mavericks
472,2242,Caleb,Martin,Miami Heat,13709,14,SF,38,5,14,35.7,2,2,100.0,2,4,50.0,2,2,4,6,3,1,2,1,-16,Caleb Martin,24,18,20,10,13709,2024-04-10 23:30:00,Miami Heat,Dallas Mavericks
473,724,Bam,Adebayo,Miami Heat,13709,8,C,30,3,13,23.1,2,2,100.0,0,2,0,2,1,3,0,2,0,0,0,-20,Bam Adebayo,11,11,8,3,13709,2024-04-10 23:30:00,Miami Heat,Dallas Mavericks
474,1866,Tyler,Herro,Miami Heat,13709,21,PG,36,6,15,40.0,7,7,100.0,2,5,40.0,1,6,7,6,0,0,4,0,-5,Tyler Herro,34,28,27,13,13709,2024-04-10 23:30:00,Miami Heat,Dallas Mavericks
475,326,Kevin,Love,Miami Heat,13709,16,PF,18,6,9,66.7,0,0,0,4,5,80.0,1,10,11,0,3,0,2,0,-1,Kevin Love,27,27,16,11,13709,2024-04-10 23:30:00,Miami Heat,Dallas Mavericks
476,3424,Jamal,Cain,Miami Heat,13709,0,F,1,0,0,0,0,0,0,0,0,0,0,0,0,0,0,0,0,0,0,Jamal Cain,0,0,0,0,13709,2024-04-10 23:30:00,Miami Heat,Dallas Mavericks
477,1815,Haywood,Highsmith,Miami Heat,13709,2,F,24,1,3,33.3,0,0,0,0,1,0,4,6,10,1,2,0,0,0,-17,Haywood Highsmith,13,12,3,11,13709,2024-04-10 23:30:00,Miami Heat,Dallas Mavericks
478,3493,Cole,Swider,Miami Heat,13709,0,F,1,0,1,0,0,0,0,0,1,0,0,0,0,1,0,0,0,0,0,Cole Swider,1,0,1,1,13709,2024-04-10 23:30:00,Miami Heat,Dallas Mavericks
479,3482,Orlando,Robinson,Miami Heat,13709,0,C,1,0,0,0,0,0,0,0,0,0,0,0,0,0,0,0,0,0,0,Orlando Robinson,0,0,0,0,13709,2024-04-10 23:30:00,Miami Heat,Dallas Mavericks
480,365,Patty,Mills,Miami Heat,13709,7,PG,11,2,4,50.0,2,2,100.0,1,3,33.3,0,0,0,0,2,0,0,0,-11,Patty Mills,7,7,7,0,13709,2024-04-10 23:30:00,Miami Heat,Dallas Mavericks
481,4085,Jamie Jr.,Jaquez,Miami Heat,13709,6,G,18,2,4,50.0,0,0,0,2,2,100.0,0,2,2,1,1,0,1,0,-7,Jamie Jr. Jaquez,9,8,7,3,13709,2024-04-10 23:30:00,Miami Heat,Dallas Mavericks
482,3503,Alondes,Williams,Miami Heat,13709,0,G,1,0,1,0,0,0,0,0,0,0,0,0,0,0,0,0,0,0,0,Alondes Williams,0,0,0,0,13709,2024-04-10 23:30:00,Miami Heat,Dallas Mavericks
483,1897,P.J.,Washington,Dallas Mavericks,13709,12,PF,35,5,11,45.5,0,1,0,2,6,33.3,1,5,6,2,1,2,1,1,+10,P.J. Washington,20,18,14,8,13709,2024-04-10 23:30:00,Miami Heat,Dallas Mavericks
484,283,Derrick,Jones Jr.,Dallas Mavericks,13709,12,SF,26,5,12,41.7,1,2,50.0,1,5,20.0,2,0,2,0,3,2,0,2,-1,Derrick Jones Jr.,14,14,12,2,13709,2024-04-10 23:30:00,Miami Heat,Dallas Mavericks
485,1859,Daniel,Gafford,Dallas Mavericks,13709,12,C,26,6,6,100.0,0,0,0,0,0,0,0,5,5,3,0,1,0,3,+2,Daniel Gafford,20,17,15,8,13709,2024-04-10 23:30:00,Miami Heat,Dallas Mavericks
486,261,Kyrie,Irving,Dallas Mavericks,13709,25,PG,37,10,15,66.7,0,0,0,5,8,62.5,0,3,3,4,2,2,1,0,+11,Kyrie Irving,32,28,29,7,13709,2024-04-10 23:30:00,Miami Heat,Dallas Mavericks
487,963,Luka,Doncic,Dallas Mavericks,13709,29,PG,36,9,23,39.1,7,8,87.5,4,15,26.7,1,8,9,9,4,0,3,0,+7,Luka Doncic,47,38,38,18,13709,2024-04-10 23:30:00,Miami Heat,Dallas Mavericks
488,374,Markieff,Morris,Dallas Mavericks,13709,0,PF,2,0,0,0,0,0,0,0,0,0,0,0,0,0,0,0,0,0,+4,Markieff Morris,0,0,0,0,13709,2024-04-10 23:30:00,Miami Heat,Dallas Mavericks
489,817,Maxi,Kleber,Dallas Mavericks,13709,4,PF,20,1,1,100.0,2,2,100.0,0,0,0,1,1,2,1,0,0,0,2,+13,Maxi Kleber,7,6,5,3,13709,2024-04-10 23:30:00,Miami Heat,Dallas Mavericks
490,3960,OlivierMaxence,Prosper,Dallas Mavericks,13709,4,F,2,2,2,100.0,0,0,0,0,0,0,0,0,0,0,0,0,0,0,+4,OlivierMaxence Prosper,4,4,4,0,13709,2024-04-10 23:30:00,Miami Heat,Dallas Mavericks
491,215,Tim,Hardaway Jr.,Dallas Mavericks,13709,5,SF,18,2,8,25.0,0,0,0,1,6,16.7,1,1,2,1,0,0,1,0,+16,Tim Hardaway Jr.,8,7,6,3,13709,2024-04-10 23:30:00,Miami Heat,Dallas Mavericks
492,2593,Josh,Green,Dallas Mavericks,13709,3,SG,14,1,5,20.0,0,0,0,1,3,33.3,1,3,4,2,2,1,0,0,+7,Josh Green,9,7,5,6,13709,2024-04-10 23:30:00,Miami Heat,Dallas Mavericks
493,164,Dante,Exum,Dallas Mavericks,13709,3,G,19,1,2,50.0,0,0,0,1,1,100.0,1,2,3,2,0,0,0,0,+10,Dante Exum,8,6,5,5,13709,2024-04-10 23:30:00,Miami Heat,Dallas Mavericks
494,2890,A.J.,Lawson,Dallas Mavericks,13709,0,G,2,0,0,0,0,0,0,0,0,0,0,2,2,1,0,0,0,0,+4,A.J. Lawson,3,2,1,3,13709,2024-04-10 23:30:00,Miami Heat,Dallas Mavericks
495,3398,Brandon,Williams,Dallas Mavericks,13709,2,G,2,1,1,100.0,0,0,0,0,0,0,0,0,0,1,0,0,0,0,+4,Brandon Williams,3,2,3,1,13709,2024-04-10 23:30:00,Miami Heat,Dallas Mavericks
496,3407,Jaden,Hardy,Dallas Mavericks,13709,0,G,2,0,1,0,0,0,0,0,0,0,0,1,1,1,1,0,1,0,+4,Jaden Hardy,2,1,1,2,13709,2024-04-10 23:30:00,Miami Heat,Dallas Mavericks
497,1901,Grant,Williams,Charlotte Hornets,13692,12,PF,32,5,12,41.7,1,2,50.0,1,5,20.0,1,2,3,4,3,0,1,0,-16,Grant Williams,19,15,16,7,13692,2024-04-09 23:00:00,Charlotte Hornets,Dallas Mavericks
498,3950,Brandon,Miller,Charlotte Hornets,13692,21,F,35,6,15,40.0,5,5,100.0,4,8,50.0,1,5,6,4,3,3,3,0,-20,Brandon Miller,31,27,25,10,13692,2024-04-09 23:00:00,Charlotte Hornets,Dallas Mavericks
499,941,Miles,Bridges,Charlotte Hornets,13692,22,SF,36,8,15,53.3,4,4,100.0,2,4,50.0,1,4,5,3,3,1,2,1,-20,Miles Bridges,30,27,25,8,13692,2024-04-09 23:00:00,Charlotte Hornets,Dallas Mavericks
500,2831,Tre,Mann,Charlotte Hornets,13692,11,PG,35,5,13,38.5,1,2,50.0,0,2,0,1,4,5,6,0,1,0,0,-11,Tre Mann,22,16,17,11,13692,2024-04-09 23:00:00,Charlotte Hornets,Dallas Mavericks
501,2739,Vasilije,Micic,Charlotte Hornets,13692,6,G,26,3,10,30.0,0,0,0,0,3,0,0,2,2,4,3,1,2,1,-26,Vasilije Micic,12,8,10,6,13692,2024-04-09 23:00:00,Charlotte Hornets,Dallas Mavericks
502,3948,Leaky,Black,Charlotte Hornets,13692,0,F,4,0,1,0,0,0,0,0,1,0,0,0,0,0,0,0,0,0,-2,Leaky Black,0,0,0,0,13692,2024-04-09 23:00:00,Charlotte Hornets,Dallas Mavericks
503,2633,Aleksej,Pokusevski,Charlotte Hornets,13692,4,F,13,1,2,50.0,2,4,50.0,0,0,0,0,4,4,1,0,0,0,1,-4,Aleksej Pokusevski,9,8,5,5,13692,2024-04-09 23:00:00,Charlotte Hornets,Dallas Mavericks
504,2856,JT,Thor,Charlotte Hornets,13692,5,F,4,2,2,100.0,1,2,50.0,0,0,0,2,1,3,0,0,0,0,0,-2,JT Thor,8,8,5,3,13692,2024-04-09 23:00:00,Charlotte Hornets,Dallas Mavericks
505,52,Davis,Bertans,Charlotte Hornets,13692,13,SF,23,5,11,45.5,0,0,0,3,7,42.9,0,4,4,0,2,0,0,0,-11,Davis Bertans,17,17,13,4,13692,2024-04-09 23:00:00,Charlotte Hornets,Dallas Mavericks
506,2482,Marques,Bolden,Charlotte Hornets,13692,0,C,4,0,0,0,0,0,0,0,0,0,0,0,0,0,0,0,0,0,-2,Marques Bolden,0,0,0,0,13692,2024-04-09 23:00:00,Charlotte Hornets,Dallas Mavericks
507,2639,Nick,Richards,Charlotte Hornets,13692,8,C,20,4,4,100.0,0,0,0,0,0,0,2,5,7,1,2,0,2,0,-12,Nick Richards,16,15,9,8,13692,2024-04-09 23:00:00,Charlotte Hornets,Dallas Mavericks
508,3469,Bryce,McGowens,Charlotte Hornets,13692,2,G,4,0,2,0,2,2,100.0,0,1,0,0,0,0,0,0,1,0,0,-2,Bryce McGowens,2,2,2,0,13692,2024-04-09 23:00:00,Charlotte Hornets,Dallas Mavericks
509,4042,Nick Jr.,Smith,Charlotte Hornets,13692,0,G,4,0,2,0,0,0,0,0,1,0,0,0,0,1,0,1,1,0,-2,Nick Jr. Smith,1,0,1,1,13692,2024-04-09 23:00:00,Charlotte Hornets,Dallas Mavericks
510,1897,P.J.,Washington,Dallas Mavericks,13692,1,PF,28,0,7,0,1,2,50.0,0,6,0,2,5,7,3,3,1,3,0,+10,P.J. Washington,11,8,4,10,13692,2024-04-09 23:00:00,Charlotte Hornets,Dallas Mavericks
511,283,Derrick,Jones Jr.,Dallas Mavericks,13692,9,SF,24,4,8,50.0,0,0,0,1,5,20.0,2,1,3,3,2,0,0,1,+22,Derrick Jones Jr.,15,12,12,6,13692,2024-04-09 23:00:00,Charlotte Hornets,Dallas Mavericks
512,1859,Daniel,Gafford,Dallas Mavericks,13692,26,C,25,12,12,100.0,2,4,50.0,0,0,0,2,5,7,1,1,1,0,2,+11,Daniel Gafford,34,33,27,8,13692,2024-04-09 23:00:00,Charlotte Hornets,Dallas Mavericks
513,261,Kyrie,Irving,Dallas Mavericks,13692,18,PG,37,6,15,40.0,4,5,80.0,2,8,25.0,2,6,8,9,3,2,2,3,+24,Kyrie Irving,35,26,27,17,13692,2024-04-09 23:00:00,Charlotte Hornets,Dallas Mavericks
514,963,Luka,Doncic,Dallas Mavericks,13692,39,PG,35,13,25,52.0,5,7,71.4,8,17,47.1,2,10,12,10,2,0,4,1,+22,Luka Doncic,61,51,49,22,13692,2024-04-09 23:00:00,Charlotte Hornets,Dallas Mavericks
515,374,Markieff,Morris,Dallas Mavericks,13692,0,PF,4,0,1,0,0,0,0,0,0,0,0,1,1,1,1,0,0,0,+2,Markieff Morris,2,1,1,2,13692,2024-04-09 23:00:00,Charlotte Hornets,Dallas Mavericks
516,817,Maxi,Kleber,Dallas Mavericks,13692,10,PF,19,4,5,80.0,0,0,0,2,3,66.7,4,2,6,1,2,0,1,0,+13,Maxi Kleber,17,16,11,7,13692,2024-04-09 23:00:00,Charlotte Hornets,Dallas Mavericks
517,3960,OlivierMaxence,Prosper,Dallas Mavericks,13692,3,F,4,1,1,100.0,0,0,0,1,1,100.0,0,1,1,0,0,0,0,0,+2,OlivierMaxence Prosper,4,4,3,1,13692,2024-04-09 23:00:00,Charlotte Hornets,Dallas Mavericks
518,215,Tim,Hardaway Jr.,Dallas Mavericks,13692,15,SF,23,6,10,60.0,0,0,0,3,7,42.9,0,4,4,1,0,1,1,0,+1,Tim Hardaway Jr.,20,19,16,5,13692,2024-04-09 23:00:00,Charlotte Hornets,Dallas Mavericks
519,164,Dante,Exum,Dallas Mavericks,13692,2,G,20,1,5,20.0,0,0,0,0,3,0,1,3,4,3,3,0,0,0,+15,Dante Exum,9,6,5,7,13692,2024-04-09 23:00:00,Charlotte Hornets,Dallas Mavericks
520,2890,A.J.,Lawson,Dallas Mavericks,13692,2,G,4,1,2,50.0,0,0,0,0,0,0,0,0,0,0,1,0,1,0,+2,A.J. Lawson,2,2,2,0,13692,2024-04-09 23:00:00,Charlotte Hornets,Dallas Mavericks
521,3398,Brandon,Williams,Dallas Mavericks,13692,2,G,4,1,1,100.0,0,0,0,0,0,0,0,0,0,1,0,0,0,0,+2,Brandon Williams,3,2,3,1,13692,2024-04-09 23:00:00,Charlotte Hornets,Dallas Mavericks
522,3407,Jaden,Hardy,Dallas Mavericks,13692,3,G,13,1,1,100.0,1,2,50.0,0,0,0,1,1,2,2,1,1,2,0,+4,Jaden Hardy,7,5,5,4,13692,2024-04-09 23:00:00,Charlotte Hornets,Dallas Mavericks
523,40,Nicolas,Batum,Philadelphia 76ers,13693,2,PF,29,1,4,25.0,0,0,0,0,3,0,1,2,3,1,1,0,1,1,+9,Nicolas Batum,6,5,3,4,13693,2024-04-09 23:00:00,Philadelphia 76ers,Detroit Pistons
524,222,Tobias,Harris,Philadelphia 76ers,13693,15,PF,28,6,13,46.2,3,4,75.0,0,2,0,4,8,12,4,0,0,0,1,+4,Tobias Harris,31,27,19,16,13693,2024-04-09 23:00:00,Philadelphia 76ers,Detroit Pistons
525,159,Joel,Embiid,Philadelphia 76ers,13693,37,C,36,12,22,54.5,9,10,90.0,4,9,44.4,2,9,11,8,4,3,5,2,+17,Joel Embiid,56,48,45,19,13693,2024-04-09 23:00:00,Philadelphia 76ers,Detroit Pistons
526,417,Cameron,Payne,Philadelphia 76ers,13693,5,PG,27,2,3,66.7,0,0,0,1,2,50.0,1,4,5,6,2,3,0,0,+9,Cameron Payne,16,10,11,11,13693,2024-04-09 23:00:00,Philadelphia 76ers,Detroit Pistons
527,407,Kelly,Oubre Jr.,Philadelphia 76ers,13693,17,SG,29,6,16,37.5,4,4,100.0,1,5,20.0,1,2,3,0,2,0,0,3,+8,Kelly Oubre Jr.,20,20,17,3,13693,2024-04-09 23:00:00,Philadelphia 76ers,Detroit Pistons
528,2638,Paul,Reed,Philadelphia 76ers,13693,8,SF,13,4,7,57.1,0,0,0,0,0,0,4,2,6,0,2,1,0,0,+3,Paul Reed,14,14,8,6,13693,2024-04-09 23:00:00,Philadelphia 76ers,Detroit Pistons
529,932,Mo,Bamba,Philadelphia 76ers,13693,2,C,3,0,1,0,2,2,100.0,0,0,0,0,1,1,0,1,0,0,1,-3,Mo Bamba,3,3,2,1,13693,2024-04-09 23:00:00,Philadelphia 76ers,Detroit Pistons
530,236,Buddy,Hield,Philadelphia 76ers,13693,18,SG,25,6,12,50.0,1,2,50.0,5,9,55.6,2,4,6,0,2,0,1,0,+21,Buddy Hield,24,24,18,6,13693,2024-04-09 23:00:00,Philadelphia 76ers,Detroit Pistons
531,998,De'Anthony,Melton,Philadelphia 76ers,13693,5,SG,16,2,9,22.2,0,0,0,1,5,20.0,1,2,3,3,1,2,0,0,+9,De'Anthony Melton,11,8,8,6,13693,2024-04-09 23:00:00,Philadelphia 76ers,Detroit Pistons
532,2878,Jeff,Dowtin,Philadelphia 76ers,13693,8,G,21,4,7,57.1,0,1,0,0,0,0,0,0,0,6,0,1,0,0,+9,Jeff Dowtin,14,8,14,6,13693,2024-04-09 23:00:00,Philadelphia 76ers,Detroit Pistons
533,4012,Terquavion,Smith,Philadelphia 76ers,13693,0,G,2,0,0,0,0,0,0,0,0,0,0,0,0,0,1,0,0,0,-1,Terquavion Smith,0,0,0,0,13693,2024-04-09 23:00:00,Philadelphia 76ers,Detroit Pistons
534,4049,Ricky IV,Council,Philadelphia 76ers,13693,3,G,10,1,4,25.0,0,0,0,1,2,50.0,0,1,1,1,2,1,0,0,+5,Ricky IV Council,5,4,4,2,13693,2024-04-09 23:00:00,Philadelphia 76ers,Detroit Pistons
535,999,Chimezie,Metu,Detroit Pistons,13693,7,PF,35,3,10,30.0,0,0,0,1,4,25.0,3,8,11,2,1,0,3,0,-9,Chimezie Metu,20,18,9,13,13693,2024-04-09 23:00:00,Philadelphia 76ers,Detroit Pistons
536,945,Troy,Brown Jr.,Detroit Pistons,13693,0,SF,23,0,2,0,0,0,0,0,1,0,1,2,3,0,1,2,0,0,-7,Troy Brown Jr.,3,3,0,3,13693,2024-04-09 23:00:00,Philadelphia 76ers,Detroit Pistons
537,3433,Jalen,Duren,Detroit Pistons,13693,15,C,28,5,12,41.7,5,6,83.3,0,0,0,0,11,11,2,3,0,2,0,-5,Jalen Duren,28,26,17,13,13693,2024-04-09 23:00:00,Philadelphia 76ers,Detroit Pistons
538,3451,Jaden,Ivey,Detroit Pistons,13693,25,PG,32,8,17,47.1,3,6,50.0,6,9,66.7,3,2,5,4,2,0,5,1,-10,Jaden Ivey,34,30,29,9,13693,2024-04-09 23:00:00,Philadelphia 76ers,Detroit Pistons
539,3970,Marcus,Sasser,Detroit Pistons,13693,10,G,27,3,10,30.0,2,2,100.0,2,4,50.0,1,2,3,5,2,0,3,0,-6,Marcus Sasser,18,13,15,8,13693,2024-04-09 23:00:00,Philadelphia 76ers,Detroit Pistons
540,3417,Buddy,Boeheim,Detroit Pistons,13693,0,F,3,0,1,0,0,0,0,0,1,0,0,0,0,0,0,0,0,0,+3,Buddy Boeheim,0,0,0,0,13693,2024-04-09 23:00:00,Philadelphia 76ers,Detroit Pistons
541,2666,James,Wiseman,Detroit Pistons,13693,8,C,20,1,5,20.0,6,6,100.0,0,0,0,1,5,6,2,2,0,1,0,-13,James Wiseman,16,14,10,8,13693,2024-04-09 23:00:00,Philadelphia 76ers,Detroit Pistons
542,2587,Malachi,Flynn,Detroit Pistons,13693,12,PG,21,5,9,55.6,0,0,0,2,4,50.0,0,0,0,4,2,0,2,0,-12,Malachi Flynn,16,12,16,4,13693,2024-04-09 23:00:00,Philadelphia 76ers,Detroit Pistons
543,177,Evan,Fournier,Detroit Pistons,13693,21,SG,26,7,11,63.6,4,4,100.0,3,5,60.0,0,3,3,0,1,1,0,2,-19,Evan Fournier,24,24,21,3,13693,2024-04-09 23:00:00,Philadelphia 76ers,Detroit Pistons
544,1882,Jaylen,Nowell,Detroit Pistons,13693,2,SG,10,1,2,50.0,0,0,0,0,0,0,0,1,1,1,0,0,0,0,-12,Jaylen Nowell,4,3,3,2,13693,2024-04-09 23:00:00,Philadelphia 76ers,Detroit Pistons
545,3481,Jared,Rhoden,Detroit Pistons,13693,2,G,15,1,5,20.0,0,0,0,0,2,0,0,1,1,0,3,0,0,2,0,Jared Rhoden,3,3,2,1,13693,2024-04-09 23:00:00,Philadelphia 76ers,Detroit Pistons
546,404,Kelly,Olynyk,Toronto Raptors,13694,22,PF,34,6,7,85.7,9,10,90.0,1,1,100.0,1,4,5,4,2,1,1,0,-17,Kelly Olynyk,31,27,26,9,13694,2024-04-09 23:00:00,Toronto Raptors,Indiana Pacers
547,1058,Gary,Trent Jr.,Toronto Raptors,13694,16,SG,34,7,19,36.8,2,4,50.0,0,7,0,1,2,3,4,5,4,3,0,-9,Gary Trent Jr.,23,19,20,7,13694,2024-04-09 23:00:00,Toronto Raptors,Indiana Pacers
548,1846,RJ,Barrett,Toronto Raptors,13694,23,SG,33,10,19,52.6,3,3,100.0,0,3,0,2,2,4,4,2,1,5,0,-12,RJ Barrett,31,27,27,8,13694,2024-04-09 23:00:00,Toronto Raptors,Indiana Pacers
549,3411,Ochai,Agbaji,Toronto Raptors,13694,2,G,29,0,6,0,2,2,100.0,0,2,0,1,2,3,1,3,0,1,3,-7,Ochai Agbaji,6,5,3,4,13694,2024-04-09 23:00:00,Toronto Raptors,Indiana Pacers
550,3440,Javon,Freeman-Liberty,Toronto Raptors,13694,20,G,33,7,10,70.0,4,4,100.0,2,3,66.7,3,5,8,1,3,1,1,0,-11,Javon Freeman-Liberty,29,28,21,9,13694,2024-04-09 23:00:00,Toronto Raptors,Indiana Pacers
551,1880,Jalen,McDaniels,Toronto Raptors,13694,7,PF,16,3,7,42.9,1,2,50.0,0,1,0,1,1,2,0,1,0,0,0,-6,Jalen McDaniels,9,9,7,2,13694,2024-04-09 23:00:00,Toronto Raptors,Indiana Pacers
552,944,Bruce,Brown,Toronto Raptors,13694,16,SF,28,7,12,58.3,2,4,50.0,0,1,0,0,3,3,5,0,0,2,0,-16,Bruce Brown,24,19,21,8,13694,2024-04-09 23:00:00,Toronto Raptors,Indiana Pacers
553,2628,Jordan,Nwora,Toronto Raptors,13694,11,SF,19,4,6,66.7,1,2,50.0,2,2,100.0,2,1,3,2,1,1,2,2,-7,Jordan Nwora,16,14,13,5,13694,2024-04-09 23:00:00,Toronto Raptors,Indiana Pacers
554,4089,M.,Williams,Toronto Raptors,13694,6,C,14,3,8,37.5,0,2,0,0,1,0,5,4,9,0,3,0,0,1,0,M. Williams,15,15,6,9,13694,2024-04-09 23:00:00,Toronto Raptors,Indiana Pacers
555,479,Pascal,Siakam,Indiana Pacers,13694,16,PF,27,6,10,60.0,4,4,100.0,0,0,0,5,4,9,3,4,0,3,2,+13,Pascal Siakam,28,25,19,12,13694,2024-04-09 23:00:00,Toronto Raptors,Indiana Pacers
556,2626,Aaron,Nesmith,Indiana Pacers,13694,8,SF,26,3,8,37.5,2,2,100.0,0,4,0,1,3,4,2,4,2,2,0,+6,Aaron Nesmith,14,12,10,6,13694,2024-04-09 23:00:00,Toronto Raptors,Indiana Pacers
557,522,Myles,Turner,Indiana Pacers,13694,16,C,21,6,10,60.0,1,4,25.0,3,7,42.9,1,3,4,1,3,0,2,1,+14,Myles Turner,21,20,17,5,13694,2024-04-09 23:00:00,Toronto Raptors,Indiana Pacers
558,3476,Andrew,Nembhard,Indiana Pacers,13694,8,PG,27,3,7,42.9,0,1,0,2,4,50.0,0,2,2,8,3,0,1,1,+14,Andrew Nembhard,18,10,16,10,13694,2024-04-09 23:00:00,Toronto Raptors,Indiana Pacers
559,2595,Tyrese,Haliburton,Indiana Pacers,13694,30,PG,31,10,16,62.5,7,10,70.0,3,8,37.5,0,5,5,5,1,2,2,1,+15,Tyrese Haliburton,40,35,35,10,13694,2024-04-09 23:00:00,Toronto Raptors,Indiana Pacers
560,2658,Obi,Toppin,Indiana Pacers,13694,23,PF,22,10,14,71.4,0,0,0,3,7,42.9,1,5,6,2,3,1,0,1,+5,Obi Toppin,31,29,25,8,13694,2024-04-09 23:00:00,Toronto Raptors,Indiana Pacers
561,2644,Jalen,Smith,Indiana Pacers,13694,2,PF,4,1,2,50.0,0,0,0,0,1,0,1,0,1,0,0,0,0,0,-1,Jalen Smith,3,3,2,1,13694,2024-04-09 23:00:00,Toronto Raptors,Indiana Pacers
562,3981,Jarace,Walker,Indiana Pacers,13694,0,F,2,0,0,0,0,0,0,0,0,0,0,0,0,0,0,0,0,0,0,Jarace Walker,0,0,0,0,13694,2024-04-09 23:00:00,Toronto Raptors,Indiana Pacers
563,351,Doug,McDermott,Indiana Pacers,13694,3,SF,10,1,4,25.0,0,0,0,1,4,25.0,0,0,0,1,1,2,0,0,+2,Doug McDermott,4,3,4,1,13694,2024-04-09 23:00:00,Toronto Raptors,Indiana Pacers
564,2817,Isaiah,Jackson,Indiana Pacers,13694,4,SF,18,2,3,66.7,0,0,0,0,0,0,5,2,7,2,0,0,0,2,+3,Isaiah Jackson,13,11,6,9,13694,2024-04-09 23:00:00,Toronto Raptors,Indiana Pacers
565,348,T.J.,McConnell,Indiana Pacers,13694,17,PG,21,8,13,61.5,0,0,0,1,1,100.0,0,2,2,7,2,0,3,0,+2,T.J. McConnell,26,19,24,9,13694,2024-04-09 23:00:00,Toronto Raptors,Indiana Pacers
566,3423,Kendall,Brown,Indiana Pacers,13694,0,SG,2,0,0,0,0,0,0,0,0,0,0,0,0,0,0,0,0,0,0,Kendall Brown,0,0,0,0,13694,2024-04-09 23:00:00,Toronto Raptors,Indiana Pacers
567,3979,Ben,Sheppard,Indiana Pacers,13694,11,G,27,4,12,33.3,0,0,0,3,9,33.3,1,1,2,2,2,2,0,0,+12,Ben Sheppard,15,13,13,4,13694,2024-04-09 23:00:00,Toronto Raptors,Indiana Pacers
568,3452,Quenton,Jackson,Indiana Pacers,13694,2,G,2,0,0,0,2,2,100.0,0,0,0,0,2,2,0,0,0,0,0,0,Quenton Jackson,4,4,2,2,13694,2024-04-09 23:00:00,Toronto Raptors,Indiana Pacers
569,1868,De'Andre,Hunter,Atlanta Hawks,13695,23,SF,47,10,23,43.5,1,2,50.0,2,8,25.0,1,10,11,3,4,2,0,1,0,De'Andre Hunter,37,34,26,14,13695,2024-04-09 23:30:00,Atlanta Hawks,Miami Heat
570,2819,Jalen,Johnson,Atlanta Hawks,13695,13,SF,24,6,7,85.7,0,0,0,1,1,100.0,2,6,8,3,2,1,1,0,-14,Jalen Johnson,24,21,16,11,13695,2024-04-09 23:30:00,Atlanta Hawks,Miami Heat
571,92,Clint,Capela,Atlanta Hawks,13695,6,C,37,3,8,37.5,0,0,0,0,0,0,6,5,11,2,1,0,1,0,-11,Clint Capela,19,17,8,13,13695,2024-04-09 23:30:00,Atlanta Hawks,Miami Heat
572,743,Bogdan,Bogdanovic,Atlanta Hawks,13695,11,SG,45,4,17,23.5,2,2,100.0,1,11,9.1,0,1,1,2,3,1,5,1,-22,Bogdan Bogdanovic,14,12,13,3,13695,2024-04-09 23:30:00,Atlanta Hawks,Miami Heat
573,382,Dejounte,Murray,Atlanta Hawks,13695,29,SG,49,12,31,38.7,2,2,100.0,3,12,25.0,4,9,13,13,4,4,4,0,+4,Dejounte Murray,55,42,42,26,13695,2024-04-09 23:30:00,Atlanta Hawks,Miami Heat
574,1858,Bruno,Fernando,Atlanta Hawks,13695,12,PF,21,4,5,80.0,4,4,100.0,0,0,0,0,4,4,0,2,0,0,0,+5,Bruno Fernando,16,16,12,4,13695,2024-04-09 23:30:00,Atlanta Hawks,Miami Heat
575,341,Wesley,Matthews,Atlanta Hawks,13695,2,SG,5,0,0,0,2,2,100.0,0,0,0,0,0,0,1,0,1,0,0,-1,Wesley Matthews,3,2,3,1,13695,2024-04-09 23:30:00,Atlanta Hawks,Miami Heat
576,2327,Garrison,Mathews,Atlanta Hawks,13695,11,SG,21,4,10,40.0,0,1,0,3,9,33.3,2,1,3,0,2,1,1,0,+10,Garrison Mathews,14,14,11,3,13695,2024-04-09 23:30:00,Atlanta Hawks,Miami Heat
577,2608,Vit,Krejci,Atlanta Hawks,13695,0,G,32,0,3,0,0,0,0,0,2,0,1,3,4,1,4,2,1,0,+7,Vit Krejci,5,4,1,5,13695,2024-04-09 23:30:00,Atlanta Hawks,Miami Heat
578,3938,Kobe,Bufkin,Atlanta Hawks,13695,4,G,11,2,9,22.2,0,1,0,0,3,0,1,3,4,3,1,1,2,0,-8,Kobe Bufkin,11,8,7,7,13695,2024-04-09 23:30:00,Atlanta Hawks,Miami Heat
579,3453,Nikola,Jovic,Miami Heat,13695,23,F,40,8,12,66.7,2,2,100.0,5,8,62.5,0,8,8,1,2,0,1,0,-1,Nikola Jovic,32,31,24,9,13695,2024-04-09 23:30:00,Atlanta Hawks,Miami Heat
580,86,Jimmy,Butler,Miami Heat,13695,25,SF,44,7,14,50.0,10,13,76.9,1,3,33.3,0,8,8,9,1,3,3,0,+2,Jimmy Butler,42,33,34,17,13695,2024-04-09 23:30:00,Atlanta Hawks,Miami Heat
581,2242,Caleb,Martin,Miami Heat,13695,0,SF,27,0,9,0,0,0,0,0,6,0,0,2,2,3,0,2,0,2,-4,Caleb Martin,5,2,3,5,13695,2024-04-09 23:30:00,Atlanta Hawks,Miami Heat
582,724,Bam,Adebayo,Miami Heat,13695,10,C,48,4,8,50.0,0,0,0,2,2,100.0,0,7,7,7,2,3,5,1,+12,Bam Adebayo,24,17,17,14,13695,2024-04-09 23:30:00,Atlanta Hawks,Miami Heat
583,1866,Tyler,Herro,Miami Heat,13695,33,PG,48,13,25,52.0,3,4,75.0,4,13,30.8,0,5,5,4,4,0,3,0,+15,Tyler Herro,42,38,37,9,13695,2024-04-09 23:30:00,Atlanta Hawks,Miami Heat
584,326,Kevin,Love,Miami Heat,13695,3,PF,6,1,4,25.0,0,0,0,1,3,33.3,1,2,3,0,1,0,2,0,-2,Kevin Love,6,6,3,3,13695,2024-04-09 23:30:00,Atlanta Hawks,Miami Heat
585,1815,Haywood,Highsmith,Miami Heat,13695,13,F,35,5,10,50.0,0,2,0,3,7,42.9,1,6,7,2,3,0,1,0,+7,Haywood Highsmith,22,20,15,9,13695,2024-04-09 23:30:00,Atlanta Hawks,Miami Heat
586,564,Delon,Wright,Miami Heat,13695,7,SG,21,3,4,75.0,0,0,0,1,2,50.0,1,1,2,2,1,0,1,0,+6,Delon Wright,11,9,9,4,13695,2024-04-09 23:30:00,Atlanta Hawks,Miami Heat
587,4085,Jamie Jr.,Jaquez,Miami Heat,13695,3,G,22,1,2,50.0,0,0,0,1,1,100.0,2,2,4,1,2,0,2,0,-5,Jamie Jr. Jaquez,8,7,4,5,13695,2024-04-09 23:30:00,Atlanta Hawks,Miami Heat
588,20,Giannis,Antetokounmpo,Milwaukee Bucks,13696,15,PF,29,7,11,63.6,1,2,50.0,0,0,0,3,5,8,7,1,1,4,2,+17,Giannis Antetokounmpo,30,23,22,15,13696,2024-04-09 23:30:00,Milwaukee Bucks,Boston Celtics
589,361,Khris,Middleton,Milwaukee Bucks,13696,12,SF,33,5,8,62.5,0,0,0,2,4,50.0,0,6,6,9,2,1,7,0,+12,Khris Middleton,27,18,21,15,13696,2024-04-09 23:30:00,Milwaukee Bucks,Boston Celtics
590,323,Brook,Lopez,Milwaukee Bucks,13696,15,C,28,5,9,55.6,0,0,0,5,8,62.5,1,5,6,0,0,0,0,2,+9,Brook Lopez,21,21,15,6,13696,2024-04-09 23:30:00,Milwaukee Bucks,Boston Celtics
591,53,Patrick,Beverley,Milwaukee Bucks,13696,20,PG,26,8,13,61.5,0,0,0,4,8,50.0,1,9,10,3,0,0,0,0,+12,Patrick Beverley,33,30,23,13,13696,2024-04-09 23:30:00,Milwaukee Bucks,Boston Celtics
592,319,Damian,Lillard,Milwaukee Bucks,13696,12,PG,36,5,11,45.5,0,0,0,2,5,40.0,1,2,3,5,0,1,3,1,+13,Damian Lillard,20,15,17,8,13696,2024-04-09 23:30:00,Milwaukee Bucks,Boston Celtics
593,431,Bobby,Portis,Milwaukee Bucks,13696,15,F,22,7,13,53.8,0,0,0,1,2,50.0,3,7,10,2,1,1,2,0,+2,Bobby Portis,27,25,17,12,13696,2024-04-09 23:30:00,Milwaukee Bucks,Boston Celtics
594,3997,Chris,Livingston,Milwaukee Bucks,13696,0,F,0,0,0,0,0,0,0,0,0,0,0,0,0,0,0,0,0,0,-2,Chris Livingston,0,0,0,0,13696,2024-04-09 23:30:00,Milwaukee Bucks,Boston Celtics
595,2408,Thanasis,Antetokounmpo,Milwaukee Bucks,13696,0,SF,0,0,0,0,0,0,0,0,0,0,0,0,0,0,0,0,0,0,-2,Thanasis Antetokounmpo,0,0,0,0,13696,2024-04-09 23:30:00,Milwaukee Bucks,Boston Celtics
596,115,Pat,Connaughton,Milwaukee Bucks,13696,4,SG,20,2,6,33.3,0,0,0,0,1,0,1,2,3,2,0,2,0,0,+1,Pat Connaughton,9,7,6,5,13696,2024-04-09 23:30:00,Milwaukee Bucks,Boston Celtics
597,46,Malik,Beasley,Milwaukee Bucks,13696,5,SG,25,2,7,28.6,0,0,0,1,5,20.0,0,2,2,1,0,0,0,0,+3,Malik Beasley,8,7,6,3,13696,2024-04-09 23:30:00,Milwaukee Bucks,Boston Celtics
598,3443,A.J.,Green,Milwaukee Bucks,13696,6,G,19,2,3,66.7,0,0,0,2,3,66.7,0,1,1,0,0,0,0,0,+6,A.J. Green,7,7,6,1,13696,2024-04-09 23:30:00,Milwaukee Bucks,Boston Celtics
599,4047,Andre Jr.,Jackson,Milwaukee Bucks,13696,0,G,1,0,0,0,0,0,0,0,0,0,0,0,0,0,0,0,0,0,-4,Andre Jr. Jackson,0,0,0,0,13696,2024-04-09 23:30:00,Milwaukee Bucks,Boston Celtics
600,3497,TyTy,Washington Jr.,Milwaukee Bucks,13696,0,G,0,0,0,0,0,0,0,0,0,0,0,0,0,0,0,0,0,0,-2,TyTy Washington Jr.,0,0,0,0,13696,2024-04-09 23:30:00,Milwaukee Bucks,Boston Celtics
601,2656,Xavier,Tillman,Boston Celtics,13696,6,F,18,2,7,28.6,0,0,0,2,5,40.0,0,0,0,2,1,1,0,2,-15,Xavier Tillman,8,6,8,2,13696,2024-04-09 23:30:00,Milwaukee Bucks,Boston Celtics
602,882,Jayson,Tatum,Boston Celtics,13696,22,SF,37,9,19,47.4,0,0,0,4,9,44.4,0,5,5,6,1,0,2,1,-11,Jayson Tatum,33,27,28,11,13696,2024-04-09 23:30:00,Milwaukee Bucks,Boston Celtics
603,242,Jrue,Holiday,Boston Celtics,13696,12,PG,32,5,13,38.5,0,0,0,2,6,33.3,3,4,7,5,0,1,2,1,-10,Jrue Holiday,24,19,17,12,13696,2024-04-09 23:30:00,Milwaukee Bucks,Boston Celtics
604,897,Derrick,White,Boston Celtics,13696,9,PG,31,3,10,30.0,0,0,0,3,9,33.3,1,3,4,3,1,2,1,0,-11,Derrick White,16,13,12,7,13696,2024-04-09 23:30:00,Milwaukee Bucks,Boston Celtics
605,75,Jaylen,Brown,Boston Celtics,13696,14,SG,36,7,19,36.8,0,0,0,0,6,0,4,6,10,3,3,4,5,0,-13,Jaylen Brown,27,24,17,13,13696,2024-04-09 23:30:00,Milwaukee Bucks,Boston Celtics
606,2812,Sam,Hauser,Boston Celtics,13696,8,SF,28,3,8,37.5,0,0,0,2,6,33.3,2,3,5,2,0,2,1,0,0,Sam Hauser,15,13,10,7,13696,2024-04-09 23:30:00,Milwaukee Bucks,Boston Celtics
607,2110,Oshae,Brissett,Boston Celtics,13696,2,SF,7,1,3,33.3,0,0,0,0,1,0,1,1,2,1,1,0,0,0,+1,Oshae Brissett,5,4,3,3,13696,2024-04-09 23:30:00,Milwaukee Bucks,Boston Celtics
608,819,Luke,Kornet,Boston Celtics,13696,7,C,21,3,3,100.0,0,0,0,1,1,100.0,1,1,2,1,1,0,0,0,-8,Luke Kornet,10,9,8,3,13696,2024-04-09 23:30:00,Milwaukee Bucks,Boston Celtics
609,2635,Payton,Pritchard,Boston Celtics,13696,6,PG,24,2,9,22.2,0,0,0,2,8,25.0,0,2,2,3,0,1,1,0,+1,Payton Pritchard,11,8,9,5,13696,2024-04-09 23:30:00,Milwaukee Bucks,Boston Celtics
610,1006,Svi,Mykhailiuk,Boston Celtics,13696,5,SG,7,2,2,100.0,0,0,0,1,1,100.0,0,1,1,1,0,0,0,0,+1,Svi Mykhailiuk,7,6,6,2,13696,2024-04-09 23:30:00,Milwaukee Bucks,Boston Celtics
611,204,Draymond,Green,Golden State Warriors,13690,3,PF,21,1,4,25.0,0,0,0,1,2,50.0,1,2,3,3,1,2,2,1,+6,Draymond Green,9,6,6,6,13690,2024-04-08 00:30:00,Golden State Warriors,Utah Jazz
612,3973,Trayce,JacksonDavis,Golden State Warriors,13690,16,F,23,8,10,80.0,0,0,0,0,0,0,2,5,7,0,2,0,2,4,-2,Trayce JacksonDavis,23,23,16,7,13690,2024-04-08 00:30:00,Golden State Warriors,Utah Jazz
613,415,Chris,Paul,Golden State Warriors,13690,12,PG,36,5,10,50.0,0,0,0,2,6,33.3,0,1,1,9,2,4,4,1,+15,Chris Paul,22,13,21,10,13690,2024-04-08 00:30:00,Golden State Warriors,Utah Jazz
614,514,Klay,Thompson,Golden State Warriors,13690,32,SG,28,12,23,52.2,2,2,100.0,6,13,46.2,0,5,5,4,1,1,1,0,+11,Klay Thompson,41,37,36,9,13690,2024-04-08 00:30:00,Golden State Warriors,Utah Jazz
615,3975,Brandin,Podziemski,Golden State Warriors,13690,16,G,31,6,10,60.0,2,2,100.0,2,4,50.0,2,5,7,6,0,0,1,0,+17,Brandin Podziemski,29,23,22,13,13690,2024-04-08 00:30:00,Golden State Warriors,Utah Jazz
616,2827,Jonathan,Kuminga,Golden State Warriors,13690,21,PF,27,9,11,81.8,2,2,100.0,1,2,50.0,2,8,10,4,2,0,2,1,-4,Jonathan Kuminga,35,31,25,14,13690,2024-04-08 00:30:00,Golden State Warriors,Utah Jazz
617,2806,Usman,Garuba,Golden State Warriors,13690,2,PF,3,1,4,25.0,0,0,0,0,1,0,2,0,2,0,0,0,1,0,-11,Usman Garuba,4,4,2,2,13690,2024-04-08 00:30:00,Golden State Warriors,Utah Jazz
618,322,Kevon,Looney,Golden State Warriors,13690,4,F,13,2,3,66.7,0,0,0,0,0,0,1,2,3,1,2,1,0,0,+23,Kevon Looney,8,7,5,4,13690,2024-04-08 00:30:00,Golden State Warriors,Utah Jazz
619,3485,Gui,Santos,Golden State Warriors,13690,0,F,8,0,0,0,0,0,0,0,0,0,0,0,0,1,1,0,0,0,-13,Gui Santos,1,0,1,1,13690,2024-04-08 00:30:00,Golden State Warriors,Utah Jazz
620,593,Gary,Payton II,Golden State Warriors,13690,4,SG,16,2,2,100.0,0,0,0,0,0,0,0,3,3,2,3,0,0,0,+15,Gary Payton II,9,7,6,5,13690,2024-04-08 00:30:00,Golden State Warriors,Utah Jazz
621,1019,Jerome,Robinson,Golden State Warriors,13690,0,SG,3,0,0,0,0,0,0,0,0,0,0,0,0,0,0,0,0,0,-11,Jerome Robinson,0,0,0,0,13690,2024-04-08 00:30:00,Golden State Warriors,Utah Jazz
622,2836,Moses,Moody,Golden State Warriors,13690,8,SG,26,3,12,25.0,0,0,0,2,6,33.3,1,5,6,2,5,1,0,1,+16,Moses Moody,16,14,10,8,13690,2024-04-08 00:30:00,Golden State Warriors,Utah Jazz
623,3480,Lester,Quinones,Golden State Warriors,13690,0,G,3,0,3,0,0,0,0,0,1,0,0,0,0,0,0,0,0,0,-11,Lester Quinones,0,0,0,0,13690,2024-04-08 00:30:00,Golden State Warriors,Utah Jazz
624,3492,Pat,Spencer,Golden State Warriors,13690,0,G,3,0,0,0,0,0,0,0,0,0,0,0,0,0,0,0,0,0,-11,Pat Spencer,0,0,0,0,13690,2024-04-08 00:30:00,Golden State Warriors,Utah Jazz
625,4031,Taylor,Hendricks,Utah Jazz,13690,10,F,26,3,7,42.9,1,2,50.0,3,6,50.0,0,3,3,2,0,0,3,1,+2,Taylor Hendricks,15,13,12,5,13690,2024-04-08 00:30:00,Golden State Warriors,Utah Jazz
626,4034,Brice,Sensabaugh,Utah Jazz,13690,9,F,27,4,7,57.1,0,0,0,1,2,50.0,0,3,3,3,2,0,1,1,+1,Brice Sensabaugh,15,12,12,6,13690,2024-04-08 00:30:00,Golden State Warriors,Utah Jazz
627,2785,Omer,Yurtseven,Utah Jazz,13690,8,C,19,4,7,57.1,0,0,0,0,0,0,1,6,7,0,0,0,0,0,-6,Omer Yurtseven,15,15,8,7,13690,2024-04-08 00:30:00,Golden State Warriors,Utah Jazz
628,1021,Collin,Sexton,Utah Jazz,13690,15,PG,27,5,15,33.3,5,6,83.3,0,2,0,0,2,2,7,0,1,3,1,-12,Collin Sexton,24,17,22,9,13690,2024-04-08 00:30:00,Golden State Warriors,Utah Jazz
629,4029,Keyonte,George,Utah Jazz,13690,25,G,34,8,16,50.0,5,5,100.0,4,11,36.4,0,2,2,1,1,0,1,0,-1,Keyonte George,28,27,26,3,13690,2024-04-08 00:30:00,Golden State Warriors,Utah Jazz
630,1891,Luka,Samanic,Utah Jazz,13690,0,F,5,0,4,0,0,0,0,0,2,0,0,0,0,0,0,0,0,0,-4,Luka Samanic,0,0,0,0,13690,2024-04-08 00:30:00,Golden State Warriors,Utah Jazz
631,1847,Darius,Bazley,Utah Jazz,13690,6,F,30,2,3,66.7,2,2,100.0,0,0,0,2,2,4,2,1,0,1,2,-6,Darius Bazley,12,10,8,6,13690,2024-04-08 00:30:00,Golden State Warriors,Utah Jazz
632,3358,Micah,Potter,Utah Jazz,13690,5,C,21,2,8,25.0,1,1,100.0,0,3,0,3,2,5,3,1,1,0,1,-9,Micah Potter,13,10,8,8,13690,2024-04-08 00:30:00,Golden State Warriors,Utah Jazz
633,2611,Kira,Lewis Jr.,Utah Jazz,13690,5,PG,16,2,4,50.0,1,2,50.0,0,1,0,0,1,1,2,0,1,0,0,-6,Kira Lewis Jr.,8,6,7,3,13690,2024-04-08 00:30:00,Golden State Warriors,Utah Jazz
634,3454,Johnny,Juzang,Utah Jazz,13690,27,G,33,9,12,75.0,2,3,66.7,7,8,87.5,0,2,2,1,4,1,2,0,+1,Johnny Juzang,30,29,28,3,13690,2024-04-08 00:30:00,Golden State Warriors,Utah Jazz
635,126,Anthony,Davis,Los Angeles Lakers,13691,4,PF,12,2,6,33.3,0,0,0,0,0,0,3,1,4,3,2,2,1,0,+4,Anthony Davis,11,8,7,7,13691,2024-04-08 02:00:00,Los Angeles Lakers,Minnesota Timberwolves
636,1862,Rui,Hachimura,Los Angeles Lakers,13691,30,PF,36,11,17,64.7,4,4,100.0,4,5,80.0,2,4,6,1,3,0,0,0,+1,Rui Hachimura,37,36,31,7,13691,2024-04-08 02:00:00,Los Angeles Lakers,Minnesota Timberwolves
637,142,Spencer,Dinwiddie,Los Angeles Lakers,13691,18,PG,36,4,7,57.1,7,7,100.0,3,5,60.0,1,4,5,7,2,0,2,0,-2,Spencer Dinwiddie,30,23,25,12,13691,2024-04-08 02:00:00,Los Angeles Lakers,Minnesota Timberwolves
638,462,D'Angelo,Russell,Los Angeles Lakers,13691,15,PG,39,5,19,26.3,4,4,100.0,1,7,14.3,0,7,7,11,0,1,1,0,-3,D'Angelo Russell,33,22,26,18,13691,2024-04-08 02:00:00,Los Angeles Lakers,Minnesota Timberwolves
639,2845,Austin,Reaves,Los Angeles Lakers,13691,14,SG,35,4,14,28.6,4,6,66.7,2,8,25.0,0,3,3,2,3,1,4,0,-17,Austin Reaves,19,17,16,5,13691,2024-04-08 02:00:00,Los Angeles Lakers,Minnesota Timberwolves
640,437,Taurean,Prince,Los Angeles Lakers,13691,6,PF,25,2,5,40.0,2,2,100.0,0,2,0,1,2,3,2,0,0,4,1,-22,Taurean Prince,11,9,8,5,13691,2024-04-08 02:00:00,Los Angeles Lakers,Minnesota Timberwolves
641,3991,Maxwell,Lewis,Los Angeles Lakers,13691,0,F,2,0,1,0,0,0,0,0,1,0,0,0,0,0,0,0,0,0,+6,Maxwell Lewis,0,0,0,0,13691,2024-04-08 02:00:00,Los Angeles Lakers,Minnesota Timberwolves
642,1889,Cam,Reddish,Los Angeles Lakers,13691,5,SF,14,2,4,50.0,0,0,0,1,2,50.0,1,1,2,0,1,0,0,0,-14,Cam Reddish,7,7,5,2,13691,2024-04-08 02:00:00,Los Angeles Lakers,Minnesota Timberwolves
643,1864,Jaxson,Hayes,Los Angeles Lakers,13691,19,C,33,8,9,88.9,3,5,60.0,0,0,0,2,8,10,0,3,5,3,1,-14,Jaxson Hayes,29,29,19,10,13691,2024-04-08 02:00:00,Los Angeles Lakers,Minnesota Timberwolves
644,3987,Colin,Castleton,Los Angeles Lakers,13691,4,C,2,1,1,100.0,2,2,100.0,0,0,0,0,0,0,0,0,0,0,0,+6,Colin Castleton,4,4,4,0,13691,2024-04-08 02:00:00,Los Angeles Lakers,Minnesota Timberwolves
645,2620,Skylar,Mays,Los Angeles Lakers,13691,0,SG,2,0,0,0,0,0,0,0,0,0,0,0,0,0,0,1,0,0,+6,Skylar Mays,0,0,0,0,13691,2024-04-08 02:00:00,Los Angeles Lakers,Minnesota Timberwolves
646,3427,Max,Christie,Los Angeles Lakers,13691,2,G,5,0,1,0,2,2,100.0,0,1,0,0,1,1,1,0,0,0,0,-1,Max Christie,4,3,3,2,13691,2024-04-08 02:00:00,Los Angeles Lakers,Minnesota Timberwolves
647,2621,Jaden,McDaniels,Minnesota Timberwolves,13691,11,PF,29,5,9,55.6,1,1,100.0,0,2,0,0,3,3,2,2,0,0,0,+4,Jaden McDaniels,16,14,13,5,13691,2024-04-08 02:00:00,Los Angeles Lakers,Minnesota Timberwolves
648,192,Rudy,Gobert,Minnesota Timberwolves,13691,18,C,37,9,13,69.2,0,0,0,0,0,0,8,8,16,3,2,2,3,1,+8,Rudy Gobert,37,34,21,19,13691,2024-04-08 02:00:00,Los Angeles Lakers,Minnesota Timberwolves
649,2146,Naz,Reid,Minnesota Timberwolves,13691,31,C,35,12,16,75.0,1,3,33.3,6,8,75.0,1,10,11,1,5,2,1,1,+11,Naz Reid,43,42,32,12,13691,2024-04-08 02:00:00,Los Angeles Lakers,Minnesota Timberwolves
650,114,Mike,Conley,Minnesota Timberwolves,13691,7,PG,26,2,8,25.0,2,2,100.0,1,5,20.0,1,3,4,6,3,2,4,0,+14,Mike Conley,17,11,13,10,13691,2024-04-08 02:00:00,Los Angeles Lakers,Minnesota Timberwolves
651,2584,Anthony,Edwards,Minnesota Timberwolves,13691,26,SG,35,9,20,45.0,5,5,100.0,3,8,37.5,0,1,1,8,1,1,1,0,+2,Anthony Edwards,35,27,34,9,13691,2024-04-08 02:00:00,Los Angeles Lakers,Minnesota Timberwolves
652,3470,Josh,Minott,Minnesota Timberwolves,13691,0,F,2,0,1,0,0,0,0,0,0,0,0,0,0,0,0,0,0,0,-6,Josh Minott,0,0,0,0,13691,2024-04-08 02:00:00,Los Angeles Lakers,Minnesota Timberwolves
653,4001,Leonard,Miller,Minnesota Timberwolves,13691,0,F,2,0,1,0,0,0,0,0,0,0,1,0,1,0,0,0,0,0,-6,Leonard Miller,1,1,0,1,13691,2024-04-08 02:00:00,Los Angeles Lakers,Minnesota Timberwolves
654,18,Kyle,Anderson,Minnesota Timberwolves,13691,8,SF,18,4,11,36.4,0,0,0,0,3,0,1,2,3,2,0,3,1,1,+11,Kyle Anderson,13,11,10,5,13691,2024-04-08 02:00:00,Los Angeles Lakers,Minnesota Timberwolves
655,2807,Luka,Garza,Minnesota Timberwolves,13691,0,C,2,0,1,0,0,0,0,0,1,0,1,0,1,0,2,0,1,0,-6,Luka Garza,1,1,0,1,13691,2024-04-08 02:00:00,Los Angeles Lakers,Minnesota Timberwolves
656,845,Monte,Morris,Minnesota Timberwolves,13691,5,PG,14,2,4,50.0,0,0,0,1,2,50.0,0,2,2,1,1,1,1,0,+5,Monte Morris,8,7,6,3,13691,2024-04-08 02:00:00,Los Angeles Lakers,Minnesota Timberwolves
657,997,Jordan,McLaughlin,Minnesota Timberwolves,13691,6,PG,13,2,3,66.7,0,0,0,2,3,66.7,0,2,2,2,3,1,1,0,+8,Jordan McLaughlin,10,8,8,4,13691,2024-04-08 02:00:00,Los Angeles Lakers,Minnesota Timberwolves
658,1845,Nickeil,Alexander-Walker,Minnesota Timberwolves,13691,15,SG,25,5,9,55.6,3,3,100.0,2,6,33.3,0,2,2,4,1,0,1,0,+11,Nickeil Alexander-Walker,21,17,19,6,13691,2024-04-08 02:00:00,Los Angeles Lakers,Minnesota Timberwolves
659,3474,Wendell,Moore Jr.,Minnesota Timberwolves,13691,0,G,2,0,1,0,0,0,0,0,1,0,0,0,0,0,0,0,0,0,-6,Wendell Moore Jr.,0,0,0,0,13691,2024-04-08 02:00:00,Los Angeles Lakers,Minnesota Timberwolves
