,player_id,firstname,lastname,team,game_id,points,position,minutes,fgm,fga,fgp,ftm,fta,ftp,tpm,tpa,tpp,offReb,defReb,totReb,assists,pFouls,steals,turnovers,blocks,plusMinus,First Last Name,Points_Rebounds_Assist,Points_Rebounds,Points_Assist,Rebounds_Assist,id,date,home_team,away_team
0,222,Tobias,Harris,Philadelphia 76ers,13457,21,PF,39,9,19,47.4,3,3,100,0,5,0,3,7,10,3,1,3,0,1,10,Tobias Harris,34,31,24,13,13457,3/9/2024 0:00,Philadelphia 76ers,New Orleans Pelicans
1,932,Mo,Bamba,Philadelphia 76ers,13457,2,C,18,1,2,50,0,0,0,0,1,0,1,5,6,0,2,0,1,2,-4,Mo Bamba,8,8,2,6,13457,3/9/2024 0:00,Philadelphia 76ers,New Orleans Pelicans
2,327,Kyle,Lowry,Philadelphia 76ers,13457,6,PG,31,1,5,20,3,4,75,1,4,25,1,2,3,7,1,1,1,0,-11,Kyle Lowry,16,9,13,10,13457,3/9/2024 0:00,Philadelphia 76ers,New Orleans Pelicans
3,236,Buddy,Hield,Philadelphia 76ers,13457,8,SG,25,2,10,20,2,2,100,2,9,22.2,0,2,2,2,3,2,2,1,-15,Buddy Hield,12,10,10,4,13457,3/9/2024 0:00,Philadelphia 76ers,New Orleans Pelicans
4,407,Kelly,Oubre Jr.,Philadelphia 76ers,13457,20,SG,34,7,18,38.9,4,7,57.1,2,6,33.3,1,6,7,2,4,0,1,0,-12,Kelly Oubre Jr.,29,27,22,9,13457,3/9/2024 0:00,Philadelphia 76ers,New Orleans Pelicans
5,2617,Kenyon,Martin Jr.,Philadelphia 76ers,13457,0,F,17,0,3,0,0,0,0,0,1,0,1,1,2,0,3,0,1,0,-17,Kenyon Martin Jr.,2,2,0,2,13457,3/9/2024 0:00,Philadelphia 76ers,New Orleans Pelicans
6,2638,Paul,Reed,Philadelphia 76ers,13457,17,SF,27,7,16,43.8,1,1,100,2,4,50,6,5,11,2,2,1,0,3,1,Paul Reed,30,28,19,13,13457,3/9/2024 0:00,Philadelphia 76ers,New Orleans Pelicans
7,417,Cameron,Payne,Philadelphia 76ers,13457,13,PG,23,5,9,55.6,3,3,100,0,3,0,0,1,1,4,1,1,2,0,4,Cameron Payne,18,14,17,5,13457,3/9/2024 0:00,Philadelphia 76ers,New Orleans Pelicans
8,2878,Jeff,Dowtin,Philadelphia 76ers,13457,6,G,19,2,3,66.7,0,0,0,2,3,66.7,0,0,0,1,0,0,2,0,3,Jeff Dowtin,7,6,7,1,13457,3/9/2024 0:00,Philadelphia 76ers,New Orleans Pelicans
9,4049,Ricky IV,Council,Philadelphia 76ers,13457,2,G,6,1,3,33.3,0,0,0,0,1,0,0,0,0,0,2,0,0,0,1,Ricky IV Council,2,2,2,0,13457,3/9/2024 0:00,Philadelphia 76ers,New Orleans Pelicans
10,1902,Zion,Williamson,New Orleans Pelicans,13457,23,PF,35,7,14,50,9,9,100,0,1,0,2,10,12,4,2,2,1,3,13,Zion Williamson,39,35,27,16,13457,3/9/2024 0:00,Philadelphia 76ers,New Orleans Pelicans
11,260,Brandon,Ingram,New Orleans Pelicans,13457,17,SF,35,6,10,60,3,4,75,2,2,100,0,7,7,5,3,0,4,2,-13,Brandon Ingram,29,24,22,12,13457,3/9/2024 0:00,Philadelphia 76ers,New Orleans Pelicans
12,2822,Herbert,Jones,New Orleans Pelicans,13457,4,SF,31,1,4,25,1,1,100,1,3,33.3,0,3,3,3,2,0,1,1,-15,Herbert Jones,10,7,7,6,13457,3/9/2024 0:00,Philadelphia 76ers,New Orleans Pelicans
13,525,Jonas,Valanciunas,New Orleans Pelicans,13457,6,C,19,2,7,28.6,2,2,100,0,3,0,3,7,10,2,3,1,1,1,0,Jonas Valanciunas,18,16,8,12,13457,3/9/2024 0:00,Philadelphia 76ers,New Orleans Pelicans
14,347,CJ,McCollum,New Orleans Pelicans,13457,10,SG,27,5,14,35.7,0,0,0,0,7,0,0,4,4,1,2,0,3,0,-4,CJ McCollum,15,14,11,5,13457,3/9/2024 0:00,Philadelphia 76ers,New Orleans Pelicans
15,385,Larry,Nance Jr.,New Orleans Pelicans,13457,7,PF,27,2,7,28.6,2,2,100,1,1,100,2,2,4,1,2,1,0,1,15,Larry Nance Jr.,12,11,8,5,13457,3/9/2024 0:00,Philadelphia 76ers,New Orleans Pelicans
16,2668,Naji,Marshall,New Orleans Pelicans,13457,19,SF,18,7,8,87.5,1,1,100,4,4,100,1,3,4,1,1,1,2,1,23,Naji Marshall,24,23,20,5,13457,3/9/2024 0:00,Philadelphia 76ers,New Orleans Pelicans
17,2941,Jose,Alvarado,New Orleans Pelicans,13457,7,PG,21,2,7,28.6,2,2,100,1,3,33.3,0,1,1,2,2,1,0,0,12,Jose Alvarado,10,8,9,3,13457,3/9/2024 0:00,Philadelphia 76ers,New Orleans Pelicans
18,2837,Trey,Murphy III,New Orleans Pelicans,13457,10,SG,28,3,8,37.5,2,2,100,2,7,28.6,1,2,3,3,1,1,0,1,9,Trey Murphy III,16,13,13,6,13457,3/9/2024 0:00,Philadelphia 76ers,New Orleans Pelicans
19,246,Richaun,Holmes,Washington Wizards,13458,14,F,36,5,5,100,4,4,100,0,0,0,3,8,11,1,5,1,0,1,23,Richaun Holmes,26,25,15,12,13458,3/9/2024 0:00,Washington Wizards,Charlotte Hornets
20,820,Kyle,Kuzma,Washington Wizards,13458,28,SF,40,11,23,47.8,6,6,100,0,7,0,0,8,8,9,3,1,2,2,21,Kyle Kuzma,45,36,37,17,13458,3/9/2024 0:00,Washington Wizards,Charlotte Hornets
21,2564,Deni,Avdija,Washington Wizards,13458,18,SF,35,8,14,57.1,1,3,33.3,1,2,50,3,11,14,2,2,0,1,2,9,Deni Avdija,34,32,20,16,13458,3/9/2024 0:00,Washington Wizards,Charlotte Hornets
22,285,Tyus,Jones,Washington Wizards,13458,7,PG,22,3,7,42.9,0,0,0,1,4,25,0,4,4,4,1,0,1,1,-4,Tyus Jones,15,11,11,8,13458,3/9/2024 0:00,Washington Wizards,Charlotte Hornets
23,4036,Bilal,Coulibaly,Washington Wizards,13458,11,SG,27,4,7,57.1,2,2,100,1,4,25,1,3,4,0,3,1,2,1,0,Bilal Coulibaly,15,15,11,4,13458,3/9/2024 0:00,Washington Wizards,Charlotte Hornets
24,2590,Anthony,Gill,Washington Wizards,13458,2,PF,2,1,1,100,0,0,0,0,0,0,0,0,0,0,0,0,0,0,-3,Anthony Gill,2,2,2,0,13458,3/9/2024 0:00,Washington Wizards,Charlotte Hornets
25,2838,Eugene,Omoruyi,Washington Wizards,13458,4,F,6,2,5,40,0,0,0,0,1,0,1,1,2,0,2,0,0,0,-6,Eugene Omoruyi,6,6,4,2,13458,3/9/2024 0:00,Washington Wizards,Charlotte Hornets
26,2825,Corey,Kispert,Washington Wizards,13458,13,SF,30,3,7,42.9,6,6,100,1,5,20,0,4,4,2,0,0,0,0,19,Corey Kispert,19,17,15,6,13458,3/9/2024 0:00,Washington Wizards,Charlotte Hornets
27,1887,Jordan,Poole,Washington Wizards,13458,15,SG,34,6,17,35.3,1,2,50,2,10,20,1,4,5,7,2,2,4,3,8,Jordan Poole,27,20,22,12,13458,3/9/2024 0:00,Washington Wizards,Charlotte Hornets
28,3428,Johnny,Davis,Washington Wizards,13458,0,G,8,0,1,0,0,0,0,0,0,0,1,1,2,0,2,0,1,1,-7,Johnny Davis,2,2,0,2,13458,3/9/2024 0:00,Washington Wizards,Charlotte Hornets
29,1901,Grant,Williams,Charlotte Hornets,13458,5,PF,38,2,10,20,0,3,0,1,5,20,3,1,4,5,3,1,0,1,-2,Grant Williams,14,9,10,9,13458,3/9/2024 0:00,Washington Wizards,Charlotte Hornets
30,3950,Brandon,Miller,Charlotte Hornets,13458,21,F,30,8,19,42.1,3,3,100,2,7,28.6,1,5,6,0,4,0,1,1,-16,Brandon Miller,27,27,21,6,13458,3/9/2024 0:00,Washington Wizards,Charlotte Hornets
31,941,Miles,Bridges,Charlotte Hornets,13458,32,SF,41,13,27,48.1,5,5,100,1,10,10,1,11,12,4,2,0,0,1,-10,Miles Bridges,48,44,36,16,13458,3/9/2024 0:00,Washington Wizards,Charlotte Hornets
32,2639,Nick,Richards,Charlotte Hornets,13458,10,C,30,5,6,83.3,0,0,0,0,0,0,5,8,13,0,3,2,2,1,-15,Nick Richards,23,23,10,13,13458,3/9/2024 0:00,Washington Wizards,Charlotte Hornets
33,2739,Vasilije,Micic,Charlotte Hornets,13458,14,G,32,6,14,42.9,2,2,100,0,5,0,0,3,3,3,1,0,3,0,-13,Vasilije Micic,20,17,17,6,13458,3/9/2024 0:00,Washington Wizards,Charlotte Hornets
34,2856,JT,Thor,Charlotte Hornets,13458,6,F,11,2,2,100,0,0,0,2,2,100,0,2,2,1,1,0,1,1,6,JT Thor,9,8,7,3,13458,3/9/2024 0:00,Washington Wizards,Charlotte Hornets
35,52,Davis,Bertans,Charlotte Hornets,13458,11,SF,32,4,14,28.6,0,0,0,3,10,30,3,3,6,3,2,2,0,0,-7,Davis Bertans,20,17,14,9,13458,3/9/2024 0:00,Washington Wizards,Charlotte Hornets
36,3469,Bryce,McGowens,Charlotte Hornets,13458,1,G,10,0,2,0,1,2,50,0,1,0,0,1,1,0,1,1,0,0,-4,Bryce McGowens,2,2,1,1,13458,3/9/2024 0:00,Washington Wizards,Charlotte Hornets
37,4042,Nick Jr.,Smith,Charlotte Hornets,13458,0,G,16,0,6,0,0,0,0,0,2,0,0,1,1,2,2,0,0,0,1,Nick Jr. Smith,3,1,2,3,13458,3/9/2024 0:00,Washington Wizards,Charlotte Hornets
38,2392,Dean,Wade,Cleveland Cavaliers,13459,0,PF,33,0,2,0,0,0,0,0,2,0,1,3,4,2,2,0,0,1,-25,Dean Wade,6,4,2,6,13459,3/9/2024 0:30,Cleveland Cavaliers,Minnesota Timberwolves
39,391,Georges,Niang,Cleveland Cavaliers,13459,16,SF,36,6,10,60,0,0,0,4,7,57.1,0,6,6,4,2,1,1,2,26,Georges Niang,26,22,20,10,13459,3/9/2024 0:30,Cleveland Cavaliers,Minnesota Timberwolves
40,2630,Isaac,Okoro,Cleveland Cavaliers,13459,9,SF,43,3,5,60,2,3,66.7,1,1,100,1,5,6,2,4,1,0,2,13,Isaac Okoro,17,15,11,8,13459,3/9/2024 0:30,Cleveland Cavaliers,Minnesota Timberwolves
41,727,Jarrett,Allen,Cleveland Cavaliers,13459,33,C,46,9,19,47.4,15,21,71.4,0,0,0,5,13,18,3,1,2,1,2,21,Jarrett Allen,54,51,36,21,13459,3/9/2024 0:30,Cleveland Cavaliers,Minnesota Timberwolves
42,1860,Darius,Garland,Cleveland Cavaliers,13459,34,PG,44,13,26,50,6,7,85.7,2,10,20,2,2,4,8,5,0,6,0,19,Darius Garland,46,38,42,12,13459,3/9/2024 0:30,Cleveland Cavaliers,Minnesota Timberwolves
43,281,Damian,Jones,Cleveland Cavaliers,13459,0,C,7,0,2,0,0,0,0,0,0,0,0,2,2,0,1,0,1,0,-12,Damian Jones,2,2,0,2,13459,3/9/2024 0:30,Cleveland Cavaliers,Minnesota Timberwolves
44,317,Caris,LeVert,Cleveland Cavaliers,13459,15,SG,34,5,15,33.3,3,5,60,2,6,33.3,0,5,5,8,1,3,2,1,18,Caris LeVert,28,20,23,13,13459,3/9/2024 0:30,Cleveland Cavaliers,Minnesota Timberwolves
45,2623,Sam,Merrill,Cleveland Cavaliers,13459,6,SG,19,2,9,22.2,0,0,0,2,8,25,1,0,1,0,3,0,0,0,-6,Sam Merrill,7,7,6,1,13459,3/9/2024 0:30,Cleveland Cavaliers,Minnesota Timberwolves
46,4043,Craig Jr.,Porter,Cleveland Cavaliers,13459,0,G,3,0,0,0,0,0,0,0,0,0,0,0,0,0,1,0,1,0,-9,Craig Jr. Porter,0,0,0,0,13459,3/9/2024 0:30,Cleveland Cavaliers,Minnesota Timberwolves
47,2621,Jaden,McDaniels,Minnesota Timberwolves,13459,13,PF,40,5,11,45.5,2,3,66.7,1,4,25,0,5,5,2,5,0,1,0,-15,Jaden McDaniels,20,18,15,7,13459,3/9/2024 0:30,Cleveland Cavaliers,Minnesota Timberwolves
48,18,Kyle,Anderson,Minnesota Timberwolves,13459,10,SF,35,5,9,55.6,0,1,0,0,0,0,0,3,3,5,1,1,1,0,-15,Kyle Anderson,18,13,15,8,13459,3/9/2024 0:30,Cleveland Cavaliers,Minnesota Timberwolves
49,192,Rudy,Gobert,Minnesota Timberwolves,13459,7,C,37,3,7,42.9,1,2,50,0,0,0,4,13,17,2,6,1,2,2,7,Rudy Gobert,26,24,9,19,13459,3/9/2024 0:30,Cleveland Cavaliers,Minnesota Timberwolves
50,114,Mike,Conley,Minnesota Timberwolves,13459,9,PG,32,4,11,36.4,1,1,100,0,5,0,1,2,3,5,1,0,1,0,-10,Mike Conley,17,12,14,8,13459,3/9/2024 0:30,Cleveland Cavaliers,Minnesota Timberwolves
51,2584,Anthony,Edwards,Minnesota Timberwolves,13459,19,SG,42,7,27,25.9,5,5,100,0,7,0,1,4,5,3,3,1,5,1,-20,Anthony Edwards,27,24,22,8,13459,3/9/2024 0:30,Cleveland Cavaliers,Minnesota Timberwolves
52,540,T.J.,Warren,Minnesota Timberwolves,13459,6,SF,11,3,3,100,0,0,0,0,0,0,1,3,4,0,3,0,1,0,15,T.J. Warren,10,10,6,4,13459,3/9/2024 0:30,Cleveland Cavaliers,Minnesota Timberwolves
53,2146,Naz,Reid,Minnesota Timberwolves,13459,34,C,32,10,18,55.6,7,8,87.5,7,11,63.6,0,5,5,2,4,1,1,2,-9,Naz Reid,41,39,36,7,13459,3/9/2024 0:30,Cleveland Cavaliers,Minnesota Timberwolves
54,997,Jordan,McLaughlin,Minnesota Timberwolves,13459,2,PG,11,0,0,0,2,2,100,0,0,0,0,1,1,4,1,1,0,0,4,Jordan McLaughlin,7,3,6,5,13459,3/9/2024 0:30,Cleveland Cavaliers,Minnesota Timberwolves
55,1845,Nickeil,Alexander-Walker,Minnesota Timberwolves,13459,4,SG,25,2,8,25,0,0,0,0,3,0,0,2,2,2,1,0,0,0,-2,Nickeil Alexander-Walker,8,6,6,4,13459,3/9/2024 0:30,Cleveland Cavaliers,Minnesota Timberwolves
56,2561,Precious,Achiuwa,New York Knicks,13460,15,PF,39,6,16,37.5,1,2,50,2,4,50,3,11,14,4,2,2,3,5,25,Precious Achiuwa,33,29,19,18,13460,3/9/2024 0:30,New York Knicks,Orlando Magic
57,978,Isaiah,Hartenstein,New York Knicks,13460,5,C,20,2,3,66.7,1,1,100,0,0,0,2,4,6,2,3,1,2,3,14,Isaiah Hartenstein,13,11,7,8,13460,3/9/2024 0:30,New York Knicks,Orlando Magic
58,946,Jalen,Brunson,New York Knicks,13460,26,PG,29,11,19,57.9,0,0,0,4,7,57.1,0,3,3,2,2,0,1,0,23,Jalen Brunson,31,29,28,5,13460,3/9/2024 0:30,New York Knicks,Orlando Magic
59,791,Josh,Hart,New York Knicks,13460,19,SG,42,8,12,66.7,0,0,0,3,5,60,2,5,7,4,2,0,2,0,23,Josh Hart,30,26,23,11,13460,3/9/2024 0:30,New York Knicks,Orlando Magic
60,962,Donte,DiVincenzo,New York Knicks,13460,11,SG,42,3,13,23.1,2,2,100,3,10,30,0,4,4,6,1,2,5,1,24,Donte DiVincenzo,21,15,17,10,13460,3/9/2024 0:30,New York Knicks,Orlando Magic
61,4007,Jacob,Toppin,New York Knicks,13460,0,F,1,0,0,0,0,0,0,0,0,0,0,0,0,0,0,0,0,0,2,Jacob Toppin,0,0,0,0,13460,3/9/2024 0:30,New York Knicks,Orlando Magic
62,60,Bojan,Bogdanovic,New York Knicks,13460,6,SF,12,2,6,33.3,1,2,50,1,3,33.3,0,0,0,0,0,0,1,0,-4,Bojan Bogdanovic,6,6,6,0,13460,3/9/2024 0:30,New York Knicks,Orlando Magic
63,2849,Jericho,Sims,New York Knicks,13460,2,C,28,1,1,100,0,0,0,0,0,0,3,3,6,1,2,0,0,1,10,Jericho Sims,9,8,3,7,13460,3/9/2024 0:30,New York Knicks,Orlando Magic
64,2832,Miles,McBride,New York Knicks,13460,14,PG,19,5,7,71.4,1,1,100,3,3,100,1,2,3,1,2,2,1,0,1,Miles McBride,18,17,15,4,13460,3/9/2024 0:30,New York Knicks,Orlando Magic
65,84,Alec,Burks,New York Knicks,13460,0,SG,5,0,2,0,0,0,0,0,1,0,0,0,0,0,0,0,0,0,-2,Alec Burks,0,0,0,0,13460,3/9/2024 0:30,New York Knicks,Orlando Magic
66,1001,Shake,Milton,New York Knicks,13460,0,SG,1,0,0,0,0,0,0,0,0,0,0,0,0,0,0,0,0,0,2,Shake Milton,0,0,0,0,13460,3/9/2024 0:30,New York Knicks,Orlando Magic
67,2111,Charlie,Brown Jr.,New York Knicks,13460,0,G,1,0,0,0,0,0,0,0,0,0,0,0,0,0,0,0,0,0,2,Charlie Brown Jr.,0,0,0,0,13460,3/9/2024 0:30,New York Knicks,Orlando Magic
68,3414,Paolo,Banchero,Orlando Magic,13460,23,PF,36,9,20,45,3,5,60,2,3,66.7,2,7,9,2,3,2,4,4,-23,Paolo Banchero,34,32,25,11,13460,3/9/2024 0:30,New York Knicks,Orlando Magic
69,2858,Franz,Wagner,Orlando Magic,13460,13,SF,34,6,20,30,1,1,100,0,5,0,0,4,4,0,0,1,0,0,-25,Franz Wagner,17,17,13,4,13460,3/9/2024 0:30,New York Knicks,Orlando Magic
70,950,Wendell,Carter Jr.,Orlando Magic,13460,7,C,25,2,8,25,1,2,50,2,4,50,7,2,9,2,2,0,3,2,-22,Wendell Carter Jr.,18,16,9,11,13460,3/9/2024 0:30,New York Knicks,Orlando Magic
71,220,Gary,Harris,Orlando Magic,13460,5,SG,24,2,5,40,0,0,0,1,3,33.3,0,1,1,1,0,0,1,0,-20,Gary Harris,7,6,6,2,13460,3/9/2024 0:30,New York Knicks,Orlando Magic
72,4010,Anthony,Black,Orlando Magic,13460,0,G,23,0,5,0,0,0,0,0,2,0,0,2,2,0,2,0,1,0,-18,Anthony Black,2,2,0,2,13460,3/9/2024 0:30,New York Knicks,Orlando Magic
73,801,Jonathan,Isaac,Orlando Magic,13460,11,PF,16,4,6,66.7,2,2,100,1,2,50,2,4,6,0,0,1,0,2,2,Jonathan Isaac,17,17,11,6,13460,3/9/2024 0:30,New York Knicks,Orlando Magic
74,1883,Chuma,Okeke,Orlando Magic,13460,2,PF,3,1,3,33.3,0,0,0,0,2,0,0,1,1,0,0,0,0,0,-1,Chuma Okeke,3,3,2,1,13460,3/9/2024 0:30,New York Knicks,Orlando Magic
75,1892,Admiral,Schofield,Orlando Magic,13460,0,SF,3,0,1,0,0,0,0,0,1,0,0,1,1,0,0,0,0,0,-1,Admiral Schofield,1,1,0,1,13460,3/9/2024 0:30,New York Knicks,Orlando Magic
76,1037,Moritz,Wagner,Orlando Magic,13460,4,C,12,1,2,50,2,2,100,0,0,0,0,1,1,1,1,0,1,0,4,Moritz Wagner,6,5,5,2,13460,3/9/2024 0:30,New York Knicks,Orlando Magic
77,1848,Goga,Bitadze,Orlando Magic,13460,0,C,7,0,0,0,0,0,0,0,0,0,0,0,0,0,1,0,1,0,-8,Goga Bitadze,0,0,0,0,13460,3/9/2024 0:30,New York Knicks,Orlando Magic
78,779,Markelle,Fultz,Orlando Magic,13460,2,PG,9,1,4,25,0,0,0,0,1,0,0,1,1,0,1,0,1,0,0,Markelle Fultz,3,3,2,1,13460,3/9/2024 0:30,New York Knicks,Orlando Magic
79,2563,Cole,Anthony,Orlando Magic,13460,4,PG,25,1,4,25,2,4,50,0,2,0,1,0,1,5,2,1,1,2,-6,Cole Anthony,10,5,9,6,13460,3/9/2024 0:30,New York Knicks,Orlando Magic
80,258,Joe,Ingles,Orlando Magic,13460,1,SG,17,0,0,0,1,2,50,0,0,0,0,1,1,1,0,2,0,0,2,Joe Ingles,3,2,2,2,13460,3/9/2024 0:30,New York Knicks,Orlando Magic
81,3449,Caleb,Houstan,Orlando Magic,13460,2,G,5,0,1,0,2,2,100,0,1,0,0,0,0,0,0,0,0,0,-4,Caleb Houstan,2,2,2,0,13460,3/9/2024 0:30,New York Knicks,Orlando Magic
82,982,Jaren,Jackson Jr.,Memphis Grizzlies,13461,21,PF,35,8,19,42.1,5,8,62.5,0,2,0,2,7,9,3,4,3,2,2,-13,Jaren Jackson Jr.,33,30,24,12,13461,3/9/2024 0:30,Memphis Grizzlies,Atlanta Hawks
83,2786,Santi,Aldama,Memphis Grizzlies,13461,13,PF,32,5,7,71.4,1,2,50,2,3,66.7,1,4,5,0,0,1,1,3,-14,Santi Aldama,18,18,13,5,13461,3/9/2024 0:30,Memphis Grizzlies,Atlanta Hawks
84,2177,John,Konchar,Memphis Grizzlies,13461,5,SG,29,2,4,50,0,0,0,1,2,50,2,3,5,3,1,0,2,1,-9,John Konchar,13,10,8,8,13461,3/9/2024 0:30,Memphis Grizzlies,Atlanta Hawks
85,3341,Jordan,Goodwin,Memphis Grizzlies,13461,5,G,24,2,8,25,0,0,0,1,3,33.3,0,0,0,4,2,0,0,1,-10,Jordan Goodwin,9,5,9,4,13461,3/9/2024 0:30,Memphis Grizzlies,Atlanta Hawks
86,3508,Vince,Williams Jr.,Memphis Grizzlies,13461,14,G,37,4,8,50,3,4,75,3,5,60,0,5,5,6,4,0,6,1,-7,Vince Williams Jr.,25,19,20,11,13461,3/9/2024 0:30,Memphis Grizzlies,Atlanta Hawks
87,2647,Lamar,Stevens,Memphis Grizzlies,13461,13,PF,29,3,12,25,6,6,100,1,4,25,1,4,5,0,2,1,0,2,3,Lamar Stevens,18,18,13,5,13461,3/9/2024 0:30,Memphis Grizzlies,Atlanta Hawks
88,970,Wenyen,Gabriel,Memphis Grizzlies,13461,2,F,13,1,3,33.3,0,2,0,0,0,0,2,2,4,2,2,1,1,0,6,Wenyen Gabriel,8,6,4,6,13461,3/9/2024 0:30,Memphis Grizzlies,Atlanta Hawks
89,3993,Matthew,Hurt,Memphis Grizzlies,13461,0,F,0,0,0,0,0,0,0,0,0,0,0,0,0,0,0,0,0,0,0,Matthew Hurt,0,0,0,0,13461,3/9/2024 0:30,Memphis Grizzlies,Atlanta Hawks
90,3460,Jake,LaRavia,Memphis Grizzlies,13461,14,F,26,3,10,30,6,6,100,2,7,28.6,2,1,3,3,2,3,0,1,2,Jake LaRavia,20,17,17,6,13461,3/9/2024 0:30,Memphis Grizzlies,Atlanta Hawks
91,4003,Trey,Jemison,Memphis Grizzlies,13461,5,C,16,2,3,66.7,1,2,50,0,0,0,0,2,2,0,2,1,1,0,7,Trey Jemison,7,7,5,2,13461,3/9/2024 0:30,Memphis Grizzlies,Atlanta Hawks
92,2569,Saddiq,Bey,Atlanta Hawks,13461,3,SF,37,1,12,8.3,1,2,50,0,6,0,4,5,9,2,1,1,3,1,7,Saddiq Bey,14,12,5,11,13461,3/9/2024 0:30,Memphis Grizzlies,Atlanta Hawks
93,92,Clint,Capela,Atlanta Hawks,13461,15,C,27,5,13,38.5,5,5,100,0,0,0,5,6,11,3,2,0,1,1,13,Clint Capela,29,26,18,14,13461,3/9/2024 0:30,Memphis Grizzlies,Atlanta Hawks
94,743,Bogdan,Bogdanovic,Atlanta Hawks,13461,16,SG,35,6,14,42.9,1,2,50,3,6,50,2,4,6,3,4,1,4,2,15,Bogdan Bogdanovic,25,22,19,9,13461,3/9/2024 0:30,Memphis Grizzlies,Atlanta Hawks
95,382,Dejounte,Murray,Atlanta Hawks,13461,41,SG,40,17,25,68,1,1,100,6,10,60,0,7,7,6,1,2,2,0,15,Dejounte Murray,54,48,47,13,13461,3/9/2024 0:30,Memphis Grizzlies,Atlanta Hawks
96,2608,Vit,Krejci,Atlanta Hawks,13461,3,G,22,1,5,20,0,0,0,1,4,25,1,0,1,5,1,2,0,1,7,Vit Krejci,9,4,8,6,13461,3/9/2024 0:30,Memphis Grizzlies,Atlanta Hawks
97,1858,Bruno,Fernando,Atlanta Hawks,13461,1,PF,21,0,1,0,1,2,50,0,0,0,1,6,7,0,3,2,1,0,-6,Bruno Fernando,8,8,1,7,13461,3/9/2024 0:30,Memphis Grizzlies,Atlanta Hawks
98,1868,De'Andre,Hunter,Atlanta Hawks,13461,12,SF,29,4,11,36.4,1,3,33.3,3,6,50,0,2,2,2,5,1,3,0,6,De'Andre Hunter,16,14,14,4,13461,3/9/2024 0:30,Memphis Grizzlies,Atlanta Hawks
99,341,Wesley,Matthews,Atlanta Hawks,13461,0,SG,5,0,0,0,0,0,0,0,0,0,0,0,0,0,0,0,0,0,-7,Wesley Matthews,0,0,0,0,13461,3/9/2024 0:30,Memphis Grizzlies,Atlanta Hawks
100,2327,Garrison,Mathews,Atlanta Hawks,13461,6,SG,16,2,4,50,0,0,0,2,3,66.7,2,1,3,0,3,0,0,0,-7,Garrison Mathews,9,9,6,3,13461,3/9/2024 0:30,Memphis Grizzlies,Atlanta Hawks
101,2589,Trent,Forrest,Atlanta Hawks,13461,2,G,8,1,2,50,0,0,0,0,0,0,0,1,1,0,0,0,0,0,-8,Trent Forrest,3,3,2,1,13461,3/9/2024 0:30,Memphis Grizzlies,Atlanta Hawks
102,3448,Chet,Holmgren,Oklahoma City Thunder,13462,7,PF,29,3,9,33.3,0,0,0,1,4,25,0,3,3,3,1,0,0,0,-1,Chet Holmgren,13,10,10,6,13462,3/9/2024 1:00,Oklahoma City Thunder,Miami Heat
103,3504,Jalen,Williams,Oklahoma City Thunder,13462,15,F,30,6,12,50,2,2,100,1,3,33.3,1,4,5,4,4,1,3,1,-2,Jalen Williams,24,20,19,9,13462,3/9/2024 1:00,Oklahoma City Thunder,Miami Heat
104,972,Shai,Gilgeous-Alexander,Oklahoma City Thunder,13462,37,PG,36,13,25,52,9,11,81.8,2,7,28.6,0,5,5,6,2,1,1,2,17,Shai Gilgeous-Alexander,48,42,43,11,13462,3/9/2024 1:00,Oklahoma City Thunder,Miami Heat
105,2808,Josh,Giddey,Oklahoma City Thunder,13462,11,SG,23,5,9,55.6,0,0,0,1,3,33.3,1,8,9,6,0,0,1,0,-7,Josh Giddey,26,20,17,15,13462,3/9/2024 1:00,Oklahoma City Thunder,Miami Heat
106,2040,Luguentz,Dort,Oklahoma City Thunder,13462,9,G,33,4,9,44.4,0,0,0,1,6,16.7,1,6,7,2,2,1,1,1,19,Luguentz Dort,18,16,11,9,13462,3/9/2024 1:00,Oklahoma City Thunder,Miami Heat
107,3505,Jaylin,Williams,Oklahoma City Thunder,13462,5,F,17,2,3,66.7,0,0,0,1,1,100,2,5,7,0,3,1,0,1,3,Jaylin Williams,12,12,5,7,13462,3/9/2024 1:00,Oklahoma City Thunder,Miami Heat
108,227,Gordon,Hayward,Oklahoma City Thunder,13462,3,SF,18,1,3,33.3,0,0,0,1,2,50,0,2,2,4,2,1,0,0,11,Gordon Hayward,9,5,7,6,13462,3/9/2024 1:00,Oklahoma City Thunder,Miami Heat
109,2604,Isaiah,Joe,Oklahoma City Thunder,13462,10,SG,19,4,10,40,0,0,0,2,6,33.3,2,2,4,1,0,0,1,0,14,Isaiah Joe,15,14,11,5,13462,3/9/2024 1:00,Oklahoma City Thunder,Miami Heat
110,2863,Aaron,Wiggins,Oklahoma City Thunder,13462,7,SG,19,3,5,60,0,0,0,1,3,33.3,2,1,3,1,1,0,0,2,-5,Aaron Wiggins,11,10,8,4,13462,3/9/2024 1:00,Oklahoma City Thunder,Miami Heat
111,4009,Cason,Wallace,Oklahoma City Thunder,13462,3,G,14,1,4,25,0,0,0,1,3,33.3,0,0,0,1,1,0,2,1,-14,Cason Wallace,4,3,4,1,13462,3/9/2024 1:00,Oklahoma City Thunder,Miami Heat
112,1018,Duncan,Robinson,Miami Heat,13462,9,F,28,3,8,37.5,0,0,0,3,8,37.5,0,2,2,1,1,1,1,0,-8,Duncan Robinson,12,11,10,3,13462,3/9/2024 1:00,Oklahoma City Thunder,Miami Heat
113,3453,Nikola,Jovic,Miami Heat,13462,7,F,30,2,5,40,2,2,100,1,3,33.3,0,8,8,3,1,0,1,2,4,Nikola Jovic,18,15,10,11,13462,3/9/2024 1:00,Oklahoma City Thunder,Miami Heat
114,86,Jimmy,Butler,Miami Heat,13462,20,SF,37,8,16,50,4,6,66.7,0,3,0,2,8,10,8,1,0,1,0,3,Jimmy Butler,38,30,28,18,13462,3/9/2024 1:00,Oklahoma City Thunder,Miami Heat
115,724,Bam,Adebayo,Miami Heat,13462,5,C,31,1,9,11.1,3,4,75,0,0,0,4,6,10,4,1,1,4,2,-18,Bam Adebayo,19,15,9,14,13462,3/9/2024 1:00,Oklahoma City Thunder,Miami Heat
116,458,Terry,Rozier,Miami Heat,13462,14,SG,32,6,14,42.9,0,0,0,2,4,50,1,4,5,4,4,1,1,0,-20,Terry Rozier,23,19,18,9,13462,3/9/2024 1:00,Oklahoma City Thunder,Miami Heat
117,1815,Haywood,Highsmith,Miami Heat,13462,0,F,5,0,0,0,0,0,0,0,0,0,0,0,0,1,1,0,0,0,-4,Haywood Highsmith,1,0,1,1,13462,3/9/2024 1:00,Oklahoma City Thunder,Miami Heat
118,2242,Caleb,Martin,Miami Heat,13462,7,SF,30,3,10,30,0,0,0,1,4,25,0,3,3,0,4,0,1,1,4,Caleb Martin,10,10,7,3,13462,3/9/2024 1:00,Oklahoma City Thunder,Miami Heat
119,365,Patty,Mills,Miami Heat,13462,13,PG,16,5,7,71.4,0,0,0,3,4,75,0,2,2,0,1,0,1,0,13,Patty Mills,15,15,13,2,13462,3/9/2024 1:00,Oklahoma City Thunder,Miami Heat
120,4046,Jaime Jr.,Jaquez,Miami Heat,13462,25,G,31,10,13,76.9,4,6,66.7,1,3,33.3,0,3,3,3,2,3,0,0,-9,Jaime Jr. Jaquez,31,28,28,6,13462,3/9/2024 1:00,Oklahoma City Thunder,Miami Heat
121,126,Anthony,Davis,Los Angeles Lakers,13463,22,PF,41,10,21,47.6,2,2,100,0,1,0,1,12,13,5,3,0,0,3,-3,Anthony Davis,40,35,27,18,13463,3/9/2024 3:00,Los Angeles Lakers,Milwaukee Bucks
122,1862,Rui,Hachimura,Los Angeles Lakers,13463,12,PF,38,5,16,31.3,1,2,50,1,6,16.7,0,5,5,2,1,0,0,0,-2,Rui Hachimura,19,17,14,7,13463,3/9/2024 3:00,Los Angeles Lakers,Milwaukee Bucks
123,142,Spencer,Dinwiddie,Los Angeles Lakers,13463,5,PG,34,1,3,33.3,2,2,100,1,2,50,0,2,2,3,3,1,0,2,-5,Spencer Dinwiddie,10,7,8,5,13463,3/9/2024 3:00,Los Angeles Lakers,Milwaukee Bucks
124,462,D'Angelo,Russell,Los Angeles Lakers,13463,44,PG,38,17,25,68,1,1,100,9,12,75,2,4,6,9,5,0,2,1,1,D'Angelo Russell,59,50,53,15,13463,3/9/2024 3:00,Los Angeles Lakers,Milwaukee Bucks
125,2845,Austin,Reaves,Los Angeles Lakers,13463,18,SG,37,7,12,58.3,2,4,50,2,5,40,0,5,5,7,1,1,2,0,-1,Austin Reaves,30,23,25,12,13463,3/9/2024 3:00,Los Angeles Lakers,Milwaukee Bucks
126,437,Taurean,Prince,Los Angeles Lakers,13463,8,PF,16,3,7,42.9,0,0,0,2,5,40,1,5,6,1,0,0,0,0,2,Taurean Prince,15,14,9,7,13463,3/9/2024 3:00,Los Angeles Lakers,Milwaukee Bucks
127,1889,Cam,Reddish,Los Angeles Lakers,13463,6,SF,15,2,4,50,1,2,50,1,3,33.3,0,0,0,0,0,0,0,1,0,Cam Reddish,6,6,6,0,13463,3/9/2024 3:00,Los Angeles Lakers,Milwaukee Bucks
128,1864,Jaxson,Hayes,Los Angeles Lakers,13463,8,C,17,2,2,100,4,6,66.7,0,0,0,0,1,1,0,3,0,1,0,7,Jaxson Hayes,9,9,8,1,13463,3/9/2024 3:00,Los Angeles Lakers,Milwaukee Bucks
129,3427,Max,Christie,Los Angeles Lakers,13463,0,G,3,0,0,0,0,0,0,0,0,0,0,0,0,0,0,0,0,0,6,Max Christie,0,0,0,0,13463,3/9/2024 3:00,Los Angeles Lakers,Milwaukee Bucks
130,121,Jae,Crowder,Milwaukee Bucks,13463,4,PF,21,1,5,20,2,2,100,0,2,0,1,2,3,0,2,1,0,0,-3,Jae Crowder,7,7,4,3,13463,3/9/2024 3:00,Los Angeles Lakers,Milwaukee Bucks
131,20,Giannis,Antetokounmpo,Milwaukee Bucks,13463,34,PF,39,14,23,60.9,5,7,71.4,1,3,33.3,2,12,14,12,2,1,4,1,-4,Giannis Antetokounmpo,60,48,46,26,13463,3/9/2024 3:00,Los Angeles Lakers,Milwaukee Bucks
132,323,Brook,Lopez,Milwaukee Bucks,13463,11,C,32,4,6,66.7,0,0,0,3,3,100,0,3,3,1,2,0,0,1,13,Brook Lopez,15,14,12,4,13463,3/9/2024 3:00,Los Angeles Lakers,Milwaukee Bucks
133,319,Damian,Lillard,Milwaukee Bucks,13463,28,PG,38,10,23,43.5,4,4,100,4,12,33.3,0,5,5,12,2,0,1,0,13,Damian Lillard,45,33,40,17,13463,3/9/2024 3:00,Los Angeles Lakers,Milwaukee Bucks
134,46,Malik,Beasley,Milwaukee Bucks,13463,14,SG,34,5,12,41.7,0,0,0,4,9,44.4,1,3,4,2,3,1,1,0,11,Malik Beasley,20,18,16,6,13463,3/9/2024 3:00,Los Angeles Lakers,Milwaukee Bucks
135,181,Danilo,Gallinari,Milwaukee Bucks,13463,0,PF,3,0,1,0,0,0,0,0,1,0,0,0,0,0,1,0,0,0,-6,Danilo Gallinari,0,0,0,0,13463,3/9/2024 3:00,Los Angeles Lakers,Milwaukee Bucks
136,431,Bobby,Portis,Milwaukee Bucks,13463,14,F,26,6,13,46.2,2,2,100,0,4,0,1,7,8,0,2,0,0,0,-11,Bobby Portis,22,22,14,8,13463,3/9/2024 3:00,Los Angeles Lakers,Milwaukee Bucks
137,53,Patrick,Beverley,Milwaukee Bucks,13463,0,PG,16,0,3,0,0,0,0,0,2,0,0,0,0,0,2,0,0,0,-16,Patrick Beverley,0,0,0,0,13463,3/9/2024 3:00,Los Angeles Lakers,Milwaukee Bucks
138,115,Pat,Connaughton,Milwaukee Bucks,13463,17,SG,31,6,7,85.7,1,2,50,4,5,80,1,5,6,1,1,0,0,0,-2,Pat Connaughton,24,23,18,7,13463,3/9/2024 3:00,Los Angeles Lakers,Milwaukee Bucks
139,4015,Toumani,Camara,Portland Trail Blazers,13464,9,F,30,2,4,50,4,4,100,1,2,50,3,4,7,0,1,1,1,0,-3,Toumani Camara,16,16,9,7,13464,3/9/2024 3:00,Portland Trail Blazers,Houston Rockets
140,4017,Kris,Murray,Portland Trail Blazers,13464,12,F,33,5,12,41.7,1,2,50,1,6,16.7,4,7,11,7,0,0,2,1,-3,Kris Murray,30,23,19,18,13464,3/9/2024 3:00,Portland Trail Blazers,Houston Rockets
141,4018,Duop,Reath,Portland Trail Blazers,13464,16,C,32,6,13,46.2,0,0,0,4,6,66.7,3,3,6,3,5,0,1,1,-3,Duop Reath,25,22,19,9,13464,3/9/2024 3:00,Portland Trail Blazers,Houston Rockets
142,1023,Anfernee,Simons,Portland Trail Blazers,13464,23,SG,34,7,14,50,5,7,71.4,4,7,57.1,0,3,3,3,2,3,6,0,-14,Anfernee Simons,29,26,26,6,13464,3/9/2024 3:00,Portland Trail Blazers,Houston Rockets
143,2788,Dalano,Banton,Portland Trail Blazers,13464,30,G,38,10,27,37,6,8,75,4,10,40,1,7,8,5,2,1,2,1,-9,Dalano Banton,43,38,35,13,13464,3/9/2024 3:00,Portland Trail Blazers,Houston Rockets
144,3714,Justin,Minaya,Portland Trail Blazers,13464,0,F,1,0,1,0,0,0,0,0,0,0,0,0,0,0,0,0,0,0,0,Justin Minaya,0,0,0,0,13464,3/9/2024 3:00,Portland Trail Blazers,Houston Rockets
145,2160,Moses,Brown,Portland Trail Blazers,13464,4,C,10,2,6,33.3,0,0,0,0,0,0,3,2,5,0,0,0,0,0,-7,Moses Brown,9,9,4,5,13464,3/9/2024 3:00,Portland Trail Blazers,Houston Rockets
146,1896,Matisse,Thybulle,Portland Trail Blazers,13464,5,SG,19,2,5,40,0,2,0,1,2,50,3,0,3,0,2,0,1,1,-22,Matisse Thybulle,8,8,5,3,13464,3/9/2024 3:00,Portland Trail Blazers,Houston Rockets
147,2594,Ashton,Hagans,Portland Trail Blazers,13464,6,G,18,2,6,33.3,1,2,50,1,2,50,1,3,4,2,2,0,1,1,-11,Ashton Hagans,12,10,8,6,13464,3/9/2024 3:00,Portland Trail Blazers,Houston Rockets
148,4069,R.,Rupert,Portland Trail Blazers,13464,2,G,22,1,1,100,0,0,0,0,0,0,1,1,2,2,2,0,3,0,-8,R. Rupert,6,4,4,4,13464,3/9/2024 3:00,Portland Trail Blazers,Houston Rockets
149,3489,Jabari,Smith Jr.,Houston Rockets,13464,15,PF,39,5,11,45.5,2,2,100,3,7,42.9,1,8,9,4,2,2,2,2,11,Jabari Smith Jr.,28,24,19,13,13464,3/9/2024 3:00,Portland Trail Blazers,Houston Rockets
150,749,Dillon,Brooks,Houston Rockets,13464,4,SF,21,1,5,20,1,2,50,1,3,33.3,0,3,3,1,1,1,0,0,-6,Dillon Brooks,8,7,5,4,13464,3/9/2024 3:00,Portland Trail Blazers,Houston Rockets
151,2847,Alperen,Sengun,Houston Rockets,13464,19,C,32,7,15,46.7,5,8,62.5,0,0,0,5,4,9,6,2,1,1,1,2,Alperen Sengun,34,28,25,15,13464,3/9/2024 3:00,Portland Trail Blazers,Houston Rockets
152,527,Fred,VanVleet,Houston Rockets,13464,18,PG,34,5,13,38.5,4,4,100,4,8,50,0,1,1,10,1,1,0,0,12,Fred VanVleet,29,19,28,11,13464,3/9/2024 3:00,Portland Trail Blazers,Houston Rockets
153,2810,Jalen,Green,Houston Rockets,13464,27,SG,34,11,19,57.9,1,2,50,4,9,44.4,0,3,3,5,1,2,2,0,2,Jalen Green,35,30,32,8,13464,3/9/2024 3:00,Portland Trail Blazers,Houston Rockets
154,3977,Amen,Thompson,Houston Rockets,13464,16,F,26,7,10,70,2,2,100,0,1,0,1,7,8,3,3,2,1,5,24,Amen Thompson,27,24,19,11,13464,3/9/2024 3:00,Portland Trail Blazers,Houston Rockets
155,3978,Cam,Whitmore,Houston Rockets,13464,13,F,24,4,10,40,4,6,66.7,1,5,20,4,4,8,0,2,1,1,1,19,Cam Whitmore,21,21,13,8,13464,3/9/2024 3:00,Portland Trail Blazers,Houston Rockets
156,1485,Jock,Landale,Houston Rockets,13464,5,C,13,2,4,50,0,0,0,1,1,100,2,1,3,3,1,0,0,1,10,Jock Landale,11,8,8,6,13464,3/9/2024 3:00,Portland Trail Blazers,Houston Rockets
157,979,Aaron,Holiday,Houston Rockets,13464,6,G,15,3,7,42.9,0,0,0,0,3,0,0,1,1,1,2,2,0,0,6,Aaron Holiday,8,7,7,2,13464,3/9/2024 3:00,Portland Trail Blazers,Houston Rockets
158,3931,Jeenathan,Williams,Houston Rockets,13464,0,G,1,0,0,0,0,0,0,0,0,0,1,1,2,0,0,0,0,0,0,Jeenathan Williams,2,2,0,2,13464,3/9/2024 3:00,Portland Trail Blazers,Houston Rockets
159,189,Paul,George,LA Clippers,13465,22,F,40,8,16,50,4,5,80,2,6,33.3,0,5,5,9,5,2,3,3,13,Paul George,36,27,31,14,13465,3/9/2024 21:00,LA Clippers,Chicago Bulls
160,314,Kawhi,Leonard,LA Clippers,13465,19,SF,38,8,15,53.3,3,3,100,0,1,0,2,7,9,4,1,0,2,1,4,Kawhi Leonard,32,28,23,13,13465,3/9/2024 21:00,LA Clippers,Chicago Bulls
161,575,Ivica,Zubac,LA Clippers,13465,16,C,25,7,9,77.8,2,2,100,0,0,0,2,7,9,2,3,0,1,1,18,Ivica Zubac,27,25,18,11,13465,3/9/2024 21:00,LA Clippers,Chicago Bulls
162,216,James,Harden,LA Clippers,13465,14,SG,34,4,10,40,2,2,100,4,10,40,0,11,11,10,2,1,1,0,4,James Harden,35,25,24,21,13465,3/9/2024 21:00,LA Clippers,Chicago Bulls
163,1877,Terance,Mann,LA Clippers,13465,7,SG,25,3,7,42.9,0,0,0,1,3,33.3,0,1,1,1,2,0,1,0,0,Terance Mann,9,8,8,2,13465,3/9/2024 21:00,LA Clippers,Chicago Bulls
164,886,Daniel,Theis,LA Clippers,13465,6,C,21,3,8,37.5,0,0,0,0,1,0,3,0,3,2,4,0,2,1,-7,Daniel Theis,11,9,8,5,13465,3/9/2024 21:00,LA Clippers,Chicago Bulls
165,2816,Bones,Hyland,LA Clippers,13465,10,PG,13,3,3,100,1,2,50,3,3,100,0,2,2,1,1,3,1,0,6,Bones Hyland,13,12,11,3,13465,3/9/2024 21:00,LA Clippers,Chicago Bulls
166,2115,Amir,Coffey,LA Clippers,13465,0,SG,15,0,2,0,0,0,0,0,2,0,0,1,1,0,0,0,0,0,7,Amir Coffey,1,1,0,1,13465,3/9/2024 21:00,LA Clippers,Chicago Bulls
167,434,Norman,Powell,LA Clippers,13465,18,G,27,6,14,42.9,4,4,100,2,9,22.2,2,2,4,0,2,1,2,0,5,Norman Powell,22,22,18,4,13465,3/9/2024 21:00,LA Clippers,Chicago Bulls
168,3984,Jordan,Miller,LA Clippers,13465,0,G,1,0,0,0,0,0,0,0,0,0,0,0,0,0,0,0,0,0,0,Jordan Miller,0,0,0,0,13465,3/9/2024 21:00,LA Clippers,Chicago Bulls
169,3983,Kobe,Brown,LA Clippers,13465,0,G,0,0,0,0,0,0,0,0,0,0,0,0,0,0,0,0,0,0,0,Kobe Brown,0,0,0,0,13465,3/9/2024 21:00,LA Clippers,Chicago Bulls
170,136,DeMar,DeRozan,Chicago Bulls,13465,24,SF,42,8,19,42.1,8,9,88.9,0,3,0,1,7,8,10,2,0,2,0,-10,DeMar DeRozan,42,32,34,18,13465,3/9/2024 21:00,LA Clippers,Chicago Bulls
171,534,Nikola,Vucevic,Chicago Bulls,13465,22,C,35,9,22,40.9,2,2,100,2,4,50,4,7,11,2,1,0,1,0,-11,Nikola Vucevic,35,33,24,13,13465,3/9/2024 21:00,LA Clippers,Chicago Bulls
172,1900,Coby,White,Chicago Bulls,13465,19,PG,41,7,16,43.8,2,2,100,3,9,33.3,1,4,5,4,4,0,5,0,-2,Coby White,28,24,23,9,13465,3/9/2024 21:00,LA Clippers,Chicago Bulls
173,631,Alex,Caruso,Chicago Bulls,13465,9,SG,36,4,7,57.1,0,0,0,1,3,33.3,0,1,1,6,3,4,0,2,-11,Alex Caruso,16,10,15,7,13465,3/9/2024 21:00,LA Clippers,Chicago Bulls
174,2802,Ayo,Dosunmu,Chicago Bulls,13465,13,SG,36,5,11,45.5,0,0,0,3,7,42.9,0,2,2,4,4,2,1,1,-7,Ayo Dosunmu,19,15,17,6,13465,3/9/2024 21:00,LA Clippers,Chicago Bulls
175,2853,Terry,Taylor,Chicago Bulls,13465,0,F,1,0,0,0,0,0,0,0,0,0,0,0,0,0,0,0,0,0,0,Terry Taylor,0,0,0,0,13465,3/9/2024 21:00,LA Clippers,Chicago Bulls
176,3494,Dalen,Terry,Chicago Bulls,13465,0,F,1,0,0,0,0,2,0,0,0,0,0,0,0,0,0,0,0,0,0,Dalen Terry,0,0,0,0,13465,3/9/2024 21:00,LA Clippers,Chicago Bulls
177,3954,Julian,Phillips,Chicago Bulls,13465,0,F,5,0,1,0,0,0,0,0,1,0,0,0,0,0,2,0,0,0,-2,Julian Phillips,0,0,0,0,13465,3/9/2024 21:00,LA Clippers,Chicago Bulls
178,765,Torrey,Craig,Chicago Bulls,13465,6,SF,13,2,6,33.3,0,0,0,2,5,40,2,1,3,0,2,1,2,0,-6,Torrey Craig,9,9,6,3,13465,3/9/2024 21:00,LA Clippers,Chicago Bulls
179,3951,Onuralp,Bitim,Chicago Bulls,13465,6,SF,10,2,3,66.7,0,0,0,2,3,66.7,1,0,1,0,0,0,0,0,-5,Onuralp Bitim,7,7,6,1,13465,3/9/2024 21:00,LA Clippers,Chicago Bulls
180,147,Andre,Drummond,Chicago Bulls,13465,3,C,12,0,1,0,3,4,75,0,0,0,3,4,7,0,1,0,1,0,1,Andre Drummond,10,10,3,7,13465,3/9/2024 21:00,LA Clippers,Chicago Bulls
181,949,Jevon,Carter,Chicago Bulls,13465,0,PG,7,0,0,0,0,0,0,0,0,0,0,0,0,1,0,0,0,0,3,Jevon Carter,1,0,1,1,13465,3/9/2024 21:00,LA Clippers,Chicago Bulls
182,3971,Ausar,Thompson,Detroit Pistons,13450,14,F,43,6,12,50,0,0,0,2,7,28.6,2,5,7,3,4,1,3,1,4,Ausar Thompson,24,21,17,10,13450,3/8/2024 0:00,Detroit Pistons,Brooklyn Nets
183,2648,Isaiah,Stewart,Detroit Pistons,13450,8,C,32,3,4,75,2,2,100,0,1,0,2,8,10,0,1,0,4,0,8,Isaiah Stewart,18,18,8,10,13450,3/8/2024 0:00,Detroit Pistons,Brooklyn Nets
184,3433,Jalen,Duren,Detroit Pistons,13450,12,C,30,6,8,75,0,0,0,0,0,0,3,11,14,4,3,2,3,0,9,Jalen Duren,30,26,16,18,13450,3/8/2024 0:00,Detroit Pistons,Brooklyn Nets
185,2801,Cade,Cunningham,Detroit Pistons,13450,32,PG,38,10,22,45.5,8,9,88.9,4,8,50,1,4,5,11,0,0,5,1,19,Cade Cunningham,48,37,43,16,13450,3/8/2024 0:00,Detroit Pistons,Brooklyn Nets
186,3451,Jaden,Ivey,Detroit Pistons,13450,34,PG,39,10,17,58.8,8,8,100,6,9,66.7,2,1,3,2,4,2,4,0,9,Jaden Ivey,39,37,36,5,13450,3/8/2024 0:00,Detroit Pistons,Brooklyn Nets
187,3438,Simone,Fontecchio,Detroit Pistons,13450,4,F,23,2,7,28.6,0,0,0,0,2,0,2,4,6,1,0,0,1,1,-1,Simone Fontecchio,11,10,5,7,13450,3/8/2024 0:00,Detroit Pistons,Brooklyn Nets
188,2666,James,Wiseman,Detroit Pistons,13450,10,C,12,4,6,66.7,2,2,100,0,0,0,1,2,3,0,2,1,1,1,-6,James Wiseman,13,13,10,3,13450,3/8/2024 0:00,Detroit Pistons,Brooklyn Nets
189,2587,Malachi,Flynn,Detroit Pistons,13450,0,PG,4,0,0,0,0,0,0,0,0,0,0,0,0,0,0,0,0,0,-2,Malachi Flynn,0,0,0,0,13450,3/8/2024 0:00,Detroit Pistons,Brooklyn Nets
190,177,Evan,Fournier,Detroit Pistons,13450,2,SG,13,1,2,50,0,0,0,0,1,0,0,2,2,1,2,1,1,0,1,Evan Fournier,5,4,3,3,13450,3/8/2024 0:00,Detroit Pistons,Brooklyn Nets
191,3970,Marcus,Sasser,Detroit Pistons,13450,2,G,6,1,4,25,0,0,0,0,2,0,0,0,0,2,2,0,0,0,-11,Marcus Sasser,4,2,4,2,13450,3/8/2024 0:00,Detroit Pistons,Brooklyn Nets
192,175,Dorian,Finney-Smith,Brooklyn Nets,13450,13,PF,37,5,9,55.6,0,0,0,3,7,42.9,0,3,3,0,2,3,1,1,7,Dorian Finney-Smith,16,16,13,3,13450,3/8/2024 0:00,Detroit Pistons,Brooklyn Nets
193,940,Mikal,Bridges,Brooklyn Nets,13450,13,SF,43,4,11,36.4,2,4,50,3,7,42.9,1,0,1,7,1,1,3,0,-6,Mikal Bridges,21,14,20,8,13450,3/8/2024 0:00,Detroit Pistons,Brooklyn Nets
194,1854,Nic,Claxton,Brooklyn Nets,13450,15,C,34,5,8,62.5,5,7,71.4,0,0,0,1,9,10,2,2,1,1,3,3,Nic Claxton,27,25,17,12,13450,3/8/2024 0:00,Detroit Pistons,Brooklyn Nets
195,472,Dennis,Schroder,Brooklyn Nets,13450,31,PG,39,12,17,70.6,2,3,66.7,5,7,71.4,0,1,1,8,1,0,3,0,-2,Dennis Schroder,40,32,39,9,13450,3/8/2024 0:00,Detroit Pistons,Brooklyn Nets
196,876,Dennis,Smith Jr.,Brooklyn Nets,13450,9,PG,24,3,10,30,2,2,100,1,4,25,0,2,2,3,6,4,1,0,-2,Dennis Smith Jr.,14,11,12,5,13450,3/8/2024 0:00,Detroit Pistons,Brooklyn Nets
197,2861,Trendon,Watford,Brooklyn Nets,13450,6,PF,11,2,4,50,2,2,100,0,0,0,0,2,2,0,0,0,2,0,-2,Trendon Watford,8,8,6,2,13450,3/8/2024 0:00,Detroit Pistons,Brooklyn Nets
198,3946,Jalen,Wilson,Brooklyn Nets,13450,2,F,9,1,4,25,0,0,0,0,2,0,1,0,1,0,1,0,1,0,-17,Jalen Wilson,3,3,2,1,13450,3/8/2024 0:00,Detroit Pistons,Brooklyn Nets
199,3944,Noah,Clowney,Brooklyn Nets,13450,0,F,10,0,0,0,0,0,0,0,0,0,0,2,2,2,1,2,0,0,-3,Noah Clowney,4,2,2,4,13450,3/8/2024 0:00,Detroit Pistons,Brooklyn Nets
200,934,Keita,Bates-Diop,Brooklyn Nets,13450,2,SF,4,1,3,33.3,0,0,0,0,0,0,1,1,2,1,0,1,0,0,-6,Keita Bates-Diop,5,4,3,3,13450,3/8/2024 0:00,Detroit Pistons,Brooklyn Nets
201,1038,Lonnie,Walker IV,Brooklyn Nets,13450,21,G,29,8,18,44.4,0,0,0,5,14,35.7,0,4,4,1,3,0,2,0,-2,Lonnie Walker IV,26,25,22,5,13450,3/8/2024 0:00,Detroit Pistons,Brooklyn Nets
202,479,Pascal,Siakam,Indiana Pacers,13451,24,PF,34,10,20,50,3,3,100,1,3,33.3,2,2,4,2,1,0,2,0,8,Pascal Siakam,30,28,26,6,13451,3/8/2024 0:00,Indiana Pacers,Minnesota Timberwolves
203,2626,Aaron,Nesmith,Indiana Pacers,13451,8,SF,30,2,10,20,3,3,100,1,4,25,0,4,4,1,3,0,0,2,2,Aaron Nesmith,13,12,9,5,13451,3/8/2024 0:00,Indiana Pacers,Minnesota Timberwolves
204,522,Myles,Turner,Indiana Pacers,13451,12,C,21,4,8,50,3,5,60,1,3,33.3,1,6,7,1,5,0,2,4,1,Myles Turner,20,19,13,8,13451,3/8/2024 0:00,Indiana Pacers,Minnesota Timberwolves
205,3476,Andrew,Nembhard,Indiana Pacers,13451,7,PG,31,3,5,60,0,0,0,1,2,50,2,4,6,3,4,1,3,0,8,Andrew Nembhard,16,13,10,9,13451,3/8/2024 0:00,Indiana Pacers,Minnesota Timberwolves
206,2595,Tyrese,Haliburton,Indiana Pacers,13451,23,PG,37,9,15,60,3,4,75,2,7,28.6,0,3,3,13,1,1,5,0,-1,Tyrese Haliburton,39,26,36,16,13451,3/8/2024 0:00,Indiana Pacers,Minnesota Timberwolves
207,2658,Obi,Toppin,Indiana Pacers,13451,2,PF,14,1,3,33.3,0,0,0,0,1,0,0,3,3,0,2,0,1,2,-10,Obi Toppin,5,5,2,3,13451,3/8/2024 0:00,Indiana Pacers,Minnesota Timberwolves
208,2644,Jalen,Smith,Indiana Pacers,13451,14,PF,20,5,5,100,3,6,50,1,1,100,1,1,2,4,1,0,0,1,-3,Jalen Smith,20,16,18,6,13451,3/8/2024 0:00,Indiana Pacers,Minnesota Timberwolves
209,3981,Jarace,Walker,Indiana Pacers,13451,5,F,16,2,4,50,0,0,0,1,2,50,1,4,5,1,2,1,0,0,-2,Jarace Walker,11,10,6,6,13451,3/8/2024 0:00,Indiana Pacers,Minnesota Timberwolves
210,2817,Isaiah,Jackson,Indiana Pacers,13451,4,SF,7,1,1,100,2,2,100,0,0,0,0,0,0,0,1,0,0,1,0,Isaiah Jackson,4,4,4,0,13451,3/8/2024 0:00,Indiana Pacers,Minnesota Timberwolves
211,348,T.J.,McConnell,Indiana Pacers,13451,6,PG,12,3,7,42.9,0,0,0,0,1,0,0,1,1,1,0,2,2,0,-6,T.J. McConnell,8,7,7,2,13451,3/8/2024 0:00,Indiana Pacers,Minnesota Timberwolves
212,3979,Ben,Sheppard,Indiana Pacers,13451,6,G,19,2,4,50,0,0,0,2,2,100,0,4,4,0,4,0,0,0,-7,Ben Sheppard,10,10,6,4,13451,3/8/2024 0:00,Indiana Pacers,Minnesota Timberwolves
213,2621,Jaden,McDaniels,Minnesota Timberwolves,13451,11,PF,28,4,7,57.1,2,2,100,1,1,100,1,7,8,6,4,0,0,0,7,Jaden McDaniels,25,19,17,14,13451,3/8/2024 0:00,Indiana Pacers,Minnesota Timberwolves
214,18,Kyle,Anderson,Minnesota Timberwolves,13451,3,SF,28,1,5,20,1,2,50,0,0,0,0,3,3,4,6,0,1,0,8,Kyle Anderson,10,6,7,7,13451,3/8/2024 0:00,Indiana Pacers,Minnesota Timberwolves
215,192,Rudy,Gobert,Minnesota Timberwolves,13451,18,C,40,7,11,63.6,4,5,80,0,0,0,6,8,14,0,2,2,2,3,6,Rudy Gobert,32,32,18,14,13451,3/8/2024 0:00,Indiana Pacers,Minnesota Timberwolves
216,114,Mike,Conley,Minnesota Timberwolves,13451,5,PG,30,2,9,22.2,0,0,0,1,6,16.7,1,4,5,4,1,2,2,0,0,Mike Conley,14,10,9,9,13451,3/8/2024 0:00,Indiana Pacers,Minnesota Timberwolves
217,2584,Anthony,Edwards,Minnesota Timberwolves,13451,44,SG,39,18,35,51.4,5,8,62.5,3,7,42.9,2,4,6,3,1,2,0,2,2,Anthony Edwards,53,50,47,9,13451,3/8/2024 0:00,Indiana Pacers,Minnesota Timberwolves
218,540,T.J.,Warren,Minnesota Timberwolves,13451,7,SF,16,3,5,60,0,0,0,1,3,33.3,0,1,1,0,1,0,0,0,3,T.J. Warren,8,8,7,1,13451,3/8/2024 0:00,Indiana Pacers,Minnesota Timberwolves
219,2146,Naz,Reid,Minnesota Timberwolves,13451,13,C,26,6,15,40,0,0,0,1,4,25,2,6,8,2,2,1,2,1,-12,Naz Reid,23,21,15,10,13451,3/8/2024 0:00,Indiana Pacers,Minnesota Timberwolves
220,845,Monte,Morris,Minnesota Timberwolves,13451,2,PG,6,1,1,100,0,0,0,0,0,0,0,1,1,2,0,0,0,0,0,Monte Morris,5,3,4,3,13451,3/8/2024 0:00,Indiana Pacers,Minnesota Timberwolves
221,1845,Nickeil,Alexander-Walker,Minnesota Timberwolves,13451,10,SG,28,4,10,40,2,2,100,0,4,0,1,1,2,2,3,2,2,0,-4,Nickeil Alexander-Walker,14,12,12,4,13451,3/8/2024 0:00,Indiana Pacers,Minnesota Timberwolves
222,1897,P.J.,Washington,Dallas Mavericks,13452,10,PF,29,4,12,33.3,1,2,50,1,6,16.7,4,4,8,1,1,1,1,1,-6,P.J. Washington,19,18,11,9,13452,3/8/2024 0:30,Dallas Mavericks,Miami Heat
223,283,Derrick,Jones Jr.,Dallas Mavericks,13452,1,SF,12,0,2,0,1,2,50,0,1,0,1,1,2,1,1,0,1,0,-6,Derrick Jones Jr.,4,3,2,3,13452,3/8/2024 0:30,Dallas Mavericks,Miami Heat
224,1859,Daniel,Gafford,Dallas Mavericks,13452,12,C,21,5,5,100,2,4,50,0,0,0,2,5,7,0,3,1,0,1,-15,Daniel Gafford,19,19,12,7,13452,3/8/2024 0:30,Dallas Mavericks,Miami Heat
225,261,Kyrie,Irving,Dallas Mavericks,13452,23,PG,36,9,19,47.4,2,2,100,3,9,33.3,0,4,4,4,1,1,2,1,-7,Kyrie Irving,31,27,27,8,13452,3/8/2024 0:30,Dallas Mavericks,Miami Heat
226,963,Luka,Doncic,Dallas Mavericks,13452,35,PG,40,12,24,50,4,4,100,7,13,53.8,0,11,11,11,2,1,4,0,11,Luka Doncic,57,46,46,22,13452,3/8/2024 0:30,Dallas Mavericks,Miami Heat
227,817,Maxi,Kleber,Dallas Mavericks,13452,3,PF,22,1,3,33.3,0,0,0,1,2,50,0,4,4,1,1,0,0,2,16,Maxi Kleber,8,7,4,5,13452,3/8/2024 0:30,Dallas Mavericks,Miami Heat
228,215,Tim,Hardaway Jr.,Dallas Mavericks,13452,11,SF,21,3,11,27.3,3,4,75,2,6,33.3,0,1,1,1,1,0,0,0,7,Tim Hardaway Jr.,13,12,12,2,13452,3/8/2024 0:30,Dallas Mavericks,Miami Heat
229,4044,Dereck II,Lively,Dallas Mavericks,13452,4,C,23,2,3,66.7,0,0,0,0,0,0,2,0,2,1,4,0,0,0,17,Dereck II Lively,7,6,5,3,13452,3/8/2024 0:30,Dallas Mavericks,Miami Heat
230,2593,Josh,Green,Dallas Mavericks,13452,2,SG,19,1,3,33.3,0,0,0,0,2,0,1,1,2,2,0,1,0,1,-3,Josh Green,6,4,4,4,13452,3/8/2024 0:30,Dallas Mavericks,Miami Heat
231,164,Dante,Exum,Dallas Mavericks,13452,13,G,17,3,5,60,5,5,100,2,2,100,0,4,4,5,2,0,1,0,16,Dante Exum,22,17,18,9,13452,3/8/2024 0:30,Dallas Mavericks,Miami Heat
232,1018,Duncan,Robinson,Miami Heat,13452,19,F,30,7,10,70,0,0,0,5,8,62.5,0,4,4,2,4,0,1,0,-11,Duncan Robinson,25,23,21,6,13452,3/8/2024 0:30,Dallas Mavericks,Miami Heat
233,3453,Nikola,Jovic,Miami Heat,13452,4,F,16,2,6,33.3,0,0,0,0,3,0,0,2,2,1,1,0,2,0,0,Nikola Jovic,7,6,5,3,13452,3/8/2024 0:30,Dallas Mavericks,Miami Heat
234,86,Jimmy,Butler,Miami Heat,13452,14,SF,38,6,12,50,1,2,50,1,2,50,0,4,4,5,2,2,6,0,1,Jimmy Butler,23,18,19,9,13452,3/8/2024 0:30,Dallas Mavericks,Miami Heat
235,724,Bam,Adebayo,Miami Heat,13452,14,C,37,5,14,35.7,4,8,50,0,2,0,1,8,9,5,1,3,1,0,-5,Bam Adebayo,28,23,19,14,13452,3/8/2024 0:30,Dallas Mavericks,Miami Heat
236,458,Terry,Rozier,Miami Heat,13452,27,SG,40,10,17,58.8,2,2,100,5,8,62.5,0,6,6,11,2,1,0,0,-1,Terry Rozier,44,33,38,17,13452,3/8/2024 0:30,Dallas Mavericks,Miami Heat
237,1815,Haywood,Highsmith,Miami Heat,13452,2,F,8,1,4,25,0,0,0,0,2,0,0,2,2,1,0,0,0,0,-4,Haywood Highsmith,5,4,3,3,13452,3/8/2024 0:30,Dallas Mavericks,Miami Heat
238,2242,Caleb,Martin,Miami Heat,13452,13,SF,33,4,9,44.4,2,3,66.7,3,7,42.9,1,2,3,2,6,0,0,1,-11,Caleb Martin,18,16,15,5,13452,3/8/2024 0:30,Dallas Mavericks,Miami Heat
239,753,Thomas,Bryant,Miami Heat,13452,2,C,11,1,3,33.3,0,0,0,0,2,0,0,1,1,1,2,0,0,1,-1,Thomas Bryant,4,3,3,2,13452,3/8/2024 0:30,Dallas Mavericks,Miami Heat
240,4046,Jaime Jr.,Jaquez,Miami Heat,13452,13,G,28,4,7,57.1,2,2,100,3,4,75,0,6,6,2,2,1,0,0,2,Jaime Jr. Jaquez,21,19,15,8,13452,3/8/2024 0:30,Dallas Mavericks,Miami Heat
241,153,Kevin,Durant,Phoenix Suns,13453,35,PF,35,11,19,57.9,11,12,91.7,2,5,40,0,3,3,1,1,1,4,0,8,Kevin Durant,39,38,36,4,13453,3/8/2024 2:00,Phoenix Suns,Toronto Raptors
242,851,Royce,O'Neale,Phoenix Suns,13453,10,PF,32,4,8,50,0,0,0,2,6,33.3,1,7,8,6,2,1,0,1,9,Royce O'Neale,24,18,16,14,13453,3/8/2024 2:00,Phoenix Suns,Toronto Raptors
243,398,Jusuf,Nurkic,Phoenix Suns,13453,7,C,26,3,5,60,1,2,50,0,0,0,3,11,14,5,5,0,7,2,3,Jusuf Nurkic,26,21,12,19,13453,3/8/2024 2:00,Phoenix Suns,Toronto Raptors
244,45,Bradley,Beal,Phoenix Suns,13453,20,SG,33,8,16,50,3,4,75,1,4,25,1,1,2,8,2,1,2,1,0,Bradley Beal,30,22,28,10,13453,3/8/2024 2:00,Phoenix Suns,Toronto Raptors
245,926,Grayson,Allen,Phoenix Suns,13453,26,SG,39,8,14,57.1,2,2,100,8,14,57.1,0,3,3,3,3,0,0,1,9,Grayson Allen,32,29,29,6,13453,3/8/2024 2:00,Phoenix Suns,Toronto Raptors
246,966,Drew,Eubanks,Phoenix Suns,13453,6,PF,21,3,5,60,0,0,0,0,0,0,4,4,8,1,0,1,1,1,8,Drew Eubanks,15,14,7,9,13453,3/8/2024 2:00,Phoenix Suns,Toronto Raptors
247,1849,Bol,Bol,Phoenix Suns,13453,11,C,16,5,7,71.4,0,0,0,1,1,100,1,7,8,0,0,1,0,0,-2,Bol Bol,19,19,11,8,13453,3/8/2024 2:00,Phoenix Suns,Toronto Raptors
248,196,Eric,Gordon,Phoenix Suns,13453,5,SG,23,2,7,28.6,0,0,0,1,4,25,0,2,2,1,1,1,0,0,-3,Eric Gordon,8,7,6,3,13453,3/8/2024 2:00,Phoenix Suns,Toronto Raptors
249,2610,Saben,Lee,Phoenix Suns,13453,0,G,15,0,5,0,0,0,0,0,1,0,0,1,1,4,2,0,0,0,3,Saben Lee,5,1,4,5,13453,3/8/2024 2:00,Phoenix Suns,Toronto Raptors
250,404,Kelly,Olynyk,Toronto Raptors,13453,8,PF,28,3,9,33.3,1,2,50,1,6,16.7,1,3,4,2,6,2,1,0,-1,Kelly Olynyk,14,12,10,6,13453,3/8/2024 2:00,Phoenix Suns,Toronto Raptors
251,1058,Gary,Trent Jr.,Toronto Raptors,13453,30,SG,36,11,22,50,3,3,100,5,13,38.5,1,2,3,0,1,0,0,0,-7,Gary Trent Jr.,33,33,30,3,13453,3/8/2024 2:00,Phoenix Suns,Toronto Raptors
252,1846,RJ,Barrett,Toronto Raptors,13453,23,SG,37,9,16,56.3,2,3,66.7,3,4,75,1,1,2,4,4,1,1,1,-7,RJ Barrett,29,25,27,6,13453,3/8/2024 2:00,Phoenix Suns,Toronto Raptors
253,2636,Immanuel,Quickley,Toronto Raptors,13453,21,SG,40,9,17,52.9,1,2,50,2,7,28.6,0,9,9,18,0,1,2,0,2,Immanuel Quickley,48,30,39,27,13453,3/8/2024 2:00,Phoenix Suns,Toronto Raptors
254,3411,Ochai,Agbaji,Toronto Raptors,13453,3,G,24,1,6,16.7,1,2,50,0,1,0,1,3,4,1,4,1,2,0,-8,Ochai Agbaji,8,7,4,5,13453,3/8/2024 2:00,Phoenix Suns,Toronto Raptors
255,745,Chris,Boucher,Toronto Raptors,13453,11,PF,24,5,6,83.3,1,1,100,0,0,0,5,4,9,2,2,0,2,0,0,Chris Boucher,22,20,13,11,13453,3/8/2024 2:00,Phoenix Suns,Toronto Raptors
256,2628,Jordan,Nwora,Toronto Raptors,13453,0,SF,3,0,2,0,0,0,0,0,1,0,0,0,0,1,0,0,0,0,-5,Jordan Nwora,1,0,1,1,13453,3/8/2024 2:00,Phoenix Suns,Toronto Raptors
257,3440,Javon,Freeman-Liberty,Toronto Raptors,13453,5,G,18,1,4,25,2,2,100,1,2,50,0,3,3,2,1,0,0,1,2,Javon Freeman-Liberty,10,8,7,5,13453,3/8/2024 2:00,Phoenix Suns,Toronto Raptors
258,4027,Gradey,Dick,Toronto Raptors,13453,12,G,31,4,12,33.3,0,0,0,4,10,40,0,2,2,0,2,0,1,0,-11,Gradey Dick,14,14,12,2,13453,3/8/2024 2:00,Phoenix Suns,Toronto Raptors
259,195,Aaron,Gordon,Denver Nuggets,13454,16,PF,34,8,15,53.3,0,0,0,0,2,0,3,6,9,1,2,1,0,0,-6,Aaron Gordon,26,25,17,10,13454,3/8/2024 3:00,Denver Nuggets,Boston Celtics
260,1014,Michael,Porter Jr.,Denver Nuggets,13454,9,SF,30,4,9,44.4,0,0,0,1,4,25,0,2,2,1,4,0,0,0,-4,Michael Porter Jr.,12,11,10,3,13454,3/8/2024 3:00,Denver Nuggets,Boston Celtics
261,279,Nikola,Jokic,Denver Nuggets,13454,32,C,39,11,19,57.9,10,10,100,0,0,0,4,8,12,11,1,2,0,0,9,Nikola Jokic,55,44,43,23,13454,3/8/2024 3:00,Denver Nuggets,Boston Celtics
262,383,Jamal,Murray,Denver Nuggets,13454,19,PG,37,7,18,38.9,4,4,100,1,4,25,0,6,6,8,2,2,5,0,4,Jamal Murray,33,25,27,14,13454,3/8/2024 3:00,Denver Nuggets,Boston Celtics
263,89,Kentavious,Caldwell-Pope,Denver Nuggets,13454,11,SG,34,4,7,57.1,2,2,100,1,4,25,0,3,3,1,3,3,2,0,-3,Kentavious Caldwell-Pope,15,14,12,4,13454,3/8/2024 3:00,Denver Nuggets,Boston Celtics
264,2627,Zeke,Nnaji,Denver Nuggets,13454,4,PF,8,1,1,100,2,2,100,0,0,0,0,2,2,0,1,1,0,0,2,Zeke Nnaji,6,6,4,2,13454,3/8/2024 3:00,Denver Nuggets,Boston Celtics
265,3498,Peyton,Watson,Denver Nuggets,13454,11,F,17,5,9,55.6,0,0,0,1,4,25,0,4,4,1,1,1,0,2,11,Peyton Watson,16,15,12,5,13454,3/8/2024 3:00,Denver Nuggets,Boston Celtics
266,243,Justin,Holiday,Denver Nuggets,13454,2,SF,13,1,2,50,0,0,0,0,1,0,0,0,0,1,1,0,0,1,6,Justin Holiday,3,2,3,1,13454,3/8/2024 3:00,Denver Nuggets,Boston Celtics
267,264,Reggie,Jackson,Denver Nuggets,13454,4,PG,11,2,7,28.6,0,0,0,0,1,0,0,1,1,2,0,0,0,1,2,Reggie Jackson,7,5,6,3,13454,3/8/2024 3:00,Denver Nuggets,Boston Celtics
268,3420,Christian,Braun,Denver Nuggets,13454,7,G,17,2,3,66.7,3,4,75,0,1,0,1,5,6,1,4,0,0,0,9,Christian Braun,14,13,8,7,13454,3/8/2024 3:00,Denver Nuggets,Boston Celtics
269,882,Jayson,Tatum,Boston Celtics,13454,15,SF,39,5,13,38.5,3,4,75,2,5,40,1,3,4,8,4,2,5,0,-2,Jayson Tatum,27,19,23,12,13454,3/8/2024 3:00,Denver Nuggets,Boston Celtics
270,432,Kristaps,Porzingis,Boston Celtics,13454,24,C,35,9,23,39.1,3,4,75,3,10,30,2,10,12,2,2,1,3,1,6,Kristaps Porzingis,38,36,26,14,13454,3/8/2024 3:00,Denver Nuggets,Boston Celtics
271,242,Jrue,Holiday,Boston Celtics,13454,12,PG,35,5,10,50,0,0,0,2,6,33.3,1,3,4,2,2,0,1,0,-6,Jrue Holiday,18,16,14,6,13454,3/8/2024 3:00,Denver Nuggets,Boston Celtics
272,897,Derrick,White,Boston Celtics,13454,7,PG,37,3,8,37.5,1,1,100,0,4,0,1,4,5,6,4,1,1,1,-2,Derrick White,18,12,13,11,13454,3/8/2024 3:00,Denver Nuggets,Boston Celtics
273,75,Jaylen,Brown,Boston Celtics,13454,41,SG,41,16,29,55.2,7,14,50,2,7,28.6,6,8,14,4,4,2,2,0,5,Jaylen Brown,59,55,45,18,13454,3/8/2024 3:00,Denver Nuggets,Boston Celtics
274,2656,Xavier,Tillman,Boston Celtics,13454,2,F,13,1,2,50,0,0,0,0,1,0,1,3,4,1,0,0,0,0,-12,Xavier Tillman,7,6,3,5,13454,3/8/2024 3:00,Denver Nuggets,Boston Celtics
275,2812,Sam,Hauser,Boston Celtics,13454,6,SF,10,2,3,66.7,0,0,0,2,3,66.7,0,0,0,1,0,0,0,1,-8,Sam Hauser,7,6,7,1,13454,3/8/2024 3:00,Denver Nuggets,Boston Celtics
276,248,Al,Horford,Boston Celtics,13454,2,C,19,0,2,0,2,2,100,0,1,0,1,3,4,0,1,0,0,0,-10,Al Horford,6,6,2,4,13454,3/8/2024 3:00,Denver Nuggets,Boston Celtics
277,2635,Payton,Pritchard,Boston Celtics,13454,0,PG,11,0,1,0,0,0,0,0,1,0,0,0,0,0,1,0,0,0,-1,Payton Pritchard,0,0,0,0,13454,3/8/2024 3:00,Denver Nuggets,Boston Celtics
278,204,Draymond,Green,Golden State Warriors,13455,11,PF,33,5,12,41.7,0,0,0,1,5,20,2,8,10,12,6,1,4,2,0,Draymond Green,33,21,23,22,13455,3/8/2024 3:00,Golden State Warriors,Chicago Bulls
279,2827,Jonathan,Kuminga,Golden State Warriors,13455,19,PF,33,5,11,45.5,9,10,90,0,1,0,3,7,10,2,4,1,1,0,3,Jonathan Kuminga,31,29,21,12,13455,3/8/2024 3:00,Golden State Warriors,Chicago Bulls
280,548,Andrew,Wiggins,Golden State Warriors,13455,8,SF,15,3,6,50,2,2,100,0,2,0,0,1,1,2,2,1,0,0,7,Andrew Wiggins,11,9,10,3,13455,3/8/2024 3:00,Golden State Warriors,Chicago Bulls
281,124,Stephen,Curry,Golden State Warriors,13455,15,PG,29,5,18,27.8,2,2,100,3,12,25,0,3,3,1,1,0,2,0,9,Stephen Curry,19,18,16,4,13455,3/8/2024 3:00,Golden State Warriors,Chicago Bulls
282,3975,Brandin,Podziemski,Golden State Warriors,13455,11,G,27,4,7,57.1,2,4,50,1,2,50,1,3,4,4,1,1,0,0,7,Brandin Podziemski,19,15,15,8,13455,3/8/2024 3:00,Golden State Warriors,Chicago Bulls
283,3973,Trayce,JacksonDavis,Golden State Warriors,13455,8,F,18,3,3,100,2,3,66.7,0,0,0,0,4,4,2,4,1,0,0,-15,Trayce JacksonDavis,14,12,10,6,13455,3/8/2024 3:00,Golden State Warriors,Chicago Bulls
284,415,Chris,Paul,Golden State Warriors,13455,15,PG,24,6,8,75,2,2,100,1,3,33.3,1,3,4,5,0,0,1,0,-15,Chris Paul,24,19,20,9,13455,3/8/2024 3:00,Golden State Warriors,Chicago Bulls
285,514,Klay,Thompson,Golden State Warriors,13455,25,SG,28,9,21,42.9,2,3,66.7,5,12,41.7,0,1,1,2,1,2,0,0,-11,Klay Thompson,28,26,27,3,13455,3/8/2024 3:00,Golden State Warriors,Chicago Bulls
286,593,Gary,Payton II,Golden State Warriors,13455,0,SG,11,0,1,0,0,0,0,0,0,0,1,1,2,1,1,0,1,0,2,Gary Payton II,3,2,1,3,13455,3/8/2024 3:00,Golden State Warriors,Chicago Bulls
287,2836,Moses,Moody,Golden State Warriors,13455,10,SG,23,4,9,44.4,2,2,100,0,4,0,5,4,9,0,2,1,2,0,-2,Moses Moody,19,19,10,9,13455,3/8/2024 3:00,Golden State Warriors,Chicago Bulls
288,3480,Lester,Quinones,Golden State Warriors,13455,0,G,0,0,1,0,0,0,0,0,1,0,0,0,0,0,0,0,0,0,0,Lester Quinones,0,0,0,0,13455,3/8/2024 3:00,Golden State Warriors,Chicago Bulls
289,136,DeMar,DeRozan,Chicago Bulls,13455,33,SF,39,10,17,58.8,10,11,90.9,3,6,50,0,8,8,4,2,0,1,1,4,DeMar DeRozan,45,41,37,12,13455,3/8/2024 3:00,Golden State Warriors,Chicago Bulls
290,534,Nikola,Vucevic,Chicago Bulls,13455,33,C,35,14,23,60.9,2,2,100,3,6,50,2,9,11,5,2,0,4,0,-7,Nikola Vucevic,49,44,38,16,13455,3/8/2024 3:00,Golden State Warriors,Chicago Bulls
291,1900,Coby,White,Chicago Bulls,13455,20,PG,37,7,16,43.8,4,4,100,2,6,33.3,0,4,4,7,4,3,2,0,2,Coby White,31,24,27,11,13455,3/8/2024 3:00,Golden State Warriors,Chicago Bulls
292,631,Alex,Caruso,Chicago Bulls,13455,5,SG,22,2,4,50,0,0,0,1,3,33.3,1,4,5,2,4,0,2,1,-6,Alex Caruso,12,10,7,7,13455,3/8/2024 3:00,Golden State Warriors,Chicago Bulls
293,2802,Ayo,Dosunmu,Chicago Bulls,13455,14,SG,38,6,12,50,0,0,0,2,5,40,1,2,3,6,3,0,2,2,-9,Ayo Dosunmu,23,17,20,9,13455,3/8/2024 3:00,Golden State Warriors,Chicago Bulls
294,3954,Julian,Phillips,Chicago Bulls,13455,3,F,4,1,2,50,0,0,0,1,2,50,0,0,0,0,0,1,0,0,6,Julian Phillips,3,3,3,0,13455,3/8/2024 3:00,Golden State Warriors,Chicago Bulls
295,765,Torrey,Craig,Chicago Bulls,13455,0,SF,14,0,1,0,0,0,0,0,1,0,0,1,1,2,1,0,1,1,-1,Torrey Craig,3,1,2,3,13455,3/8/2024 3:00,Golden State Warriors,Chicago Bulls
296,3951,Onuralp,Bitim,Chicago Bulls,13455,6,SF,17,2,4,50,0,0,0,2,4,50,0,0,0,1,1,1,0,0,11,Onuralp Bitim,7,6,7,1,13455,3/8/2024 3:00,Golden State Warriors,Chicago Bulls
297,147,Andre,Drummond,Chicago Bulls,13455,1,C,13,0,1,0,1,6,16.7,0,0,0,3,4,7,0,1,0,2,0,10,Andre Drummond,8,8,1,7,13455,3/8/2024 3:00,Golden State Warriors,Chicago Bulls
298,949,Jevon,Carter,Chicago Bulls,13455,10,PG,21,4,7,57.1,0,0,0,2,3,66.7,0,1,1,2,4,1,0,0,5,Jevon Carter,13,11,12,3,13455,3/8/2024 3:00,Golden State Warriors,Chicago Bulls
299,463,Domantas,Sabonis,Sacramento Kings,13456,31,PF,38,14,19,73.7,2,3,66.7,1,1,100,5,12,17,9,2,1,4,1,-5,Domantas Sabonis,57,48,40,26,13456,3/8/2024 3:00,Sacramento Kings,San Antonio Spurs
300,36,Harrison,Barnes,Sacramento Kings,13456,17,SF,30,6,9,66.7,5,5,100,0,2,0,1,0,1,2,1,0,0,0,-2,Harrison Barnes,20,18,19,3,13456,3/8/2024 3:00,Sacramento Kings,San Antonio Spurs
301,3475,Keegan,Murray,Sacramento Kings,13456,3,SF,31,1,4,25,0,0,0,1,3,33.3,0,3,3,0,2,0,0,0,-10,Keegan Murray,6,6,3,3,13456,3/8/2024 3:00,Sacramento Kings,San Antonio Spurs
302,776,De'Aaron,Fox,Sacramento Kings,13456,33,PG,35,14,32,43.8,4,4,100,1,7,14.3,2,3,5,5,6,3,1,0,0,De'Aaron Fox,43,38,38,10,13456,3/8/2024 3:00,Sacramento Kings,San Antonio Spurs
303,980,Kevin,Huerter,Sacramento Kings,13456,0,SG,16,0,5,0,0,0,0,0,3,0,1,1,2,2,1,1,1,1,-10,Kevin Huerter,4,2,2,4,13456,3/8/2024 3:00,Sacramento Kings,San Antonio Spurs
304,331,Trey,Lyles,Sacramento Kings,13456,9,PF,18,3,5,60,2,2,100,1,2,50,2,3,5,2,1,0,0,0,4,Trey Lyles,16,14,11,7,13456,3/8/2024 3:00,Sacramento Kings,San Antonio Spurs
305,313,Alex,Len,Sacramento Kings,13456,0,C,9,0,0,0,0,0,0,0,0,0,1,2,3,2,0,0,1,0,7,Alex Len,5,3,2,5,13456,3/8/2024 3:00,Sacramento Kings,San Antonio Spurs
306,2834,Davion,Mitchell,Sacramento Kings,13456,9,PG,14,4,5,80,0,0,0,1,2,50,0,0,0,0,1,0,0,0,-2,Davion Mitchell,9,9,9,0,13456,3/8/2024 3:00,Sacramento Kings,San Antonio Spurs
307,842,Malik,Monk,Sacramento Kings,13456,18,SG,30,6,17,35.3,4,4,100,2,7,28.6,0,7,7,9,1,1,6,1,13,Malik Monk,34,25,27,16,13456,3/8/2024 3:00,Sacramento Kings,San Antonio Spurs
308,3436,Keon,Ellis,Sacramento Kings,13456,11,G,17,4,6,66.7,0,0,0,3,5,60,2,1,3,0,0,2,0,0,15,Keon Ellis,14,14,11,3,13456,3/8/2024 3:00,Sacramento Kings,San Antonio Spurs
309,762,Zach,Collins,San Antonio Spurs,13456,22,PF,30,8,17,47.1,4,4,100,2,3,66.7,4,3,7,4,4,0,1,0,4,Zach Collins,33,29,26,11,13456,3/8/2024 3:00,Sacramento Kings,San Antonio Spurs
310,3425,Julian,Champagnie,San Antonio Spurs,13456,4,F,17,0,5,0,4,4,100,0,2,0,1,0,1,1,0,0,0,0,2,Julian Champagnie,6,5,5,2,13456,3/8/2024 3:00,Sacramento Kings,San Antonio Spurs
311,3490,Jeremy,Sochan,San Antonio Spurs,13456,9,F,36,3,10,30,3,3,100,0,3,0,2,6,8,2,5,1,2,2,10,Jeremy Sochan,19,17,11,10,13456,3/8/2024 3:00,Sacramento Kings,San Antonio Spurs
312,2606,Tre,Jones,San Antonio Spurs,13456,2,PG,24,1,1,100,0,0,0,0,0,0,0,5,5,12,0,0,2,0,9,Tre Jones,19,7,14,17,13456,3/8/2024 3:00,Sacramento Kings,San Antonio Spurs
313,2661,Devin,Vassell,San Antonio Spurs,13456,30,SG,39,11,18,61.1,4,4,100,4,7,57.1,0,5,5,9,0,2,2,1,8,Devin Vassell,44,35,39,14,13456,3/8/2024 3:00,Sacramento Kings,San Antonio Spurs
314,2830,Sandro,Mamukelashvili,San Antonio Spurs,13456,0,PF,4,0,1,0,0,0,0,0,1,0,1,2,3,0,0,0,0,0,-10,Sandro Mamukelashvili,3,3,0,3,13456,3/8/2024 3:00,Sacramento Kings,San Antonio Spurs
315,3415,Dominick,Barlow,San Antonio Spurs,13456,4,F,13,2,3,66.7,0,0,0,0,0,0,0,1,1,0,3,1,0,0,3,Dominick Barlow,5,5,4,1,13456,3/8/2024 3:00,Sacramento Kings,San Antonio Spurs
316,854,Cedi,Osman,San Antonio Spurs,13456,2,SF,6,1,2,50,0,0,0,0,1,0,0,2,2,0,2,0,0,0,-7,Cedi Osman,4,4,2,2,13456,3/8/2024 3:00,Sacramento Kings,San Antonio Spurs
317,1872,Keldon,Johnson,San Antonio Spurs,13456,22,SF,28,9,17,52.9,0,0,0,4,11,36.4,1,2,3,4,0,1,1,0,-14,Keldon Johnson,29,25,26,7,13456,3/8/2024 3:00,Sacramento Kings,San Antonio Spurs
318,3419,Malaki,Branham,San Antonio Spurs,13456,23,G,26,6,11,54.5,6,6,100,5,5,100,0,1,1,4,3,2,3,0,-16,Malaki Branham,28,24,27,5,13456,3/8/2024 3:00,Sacramento Kings,San Antonio Spurs
319,3499,Blake,Wesley,San Antonio Spurs,13456,11,G,17,5,6,83.3,0,0,0,1,1,100,0,1,1,3,3,1,1,1,1,Blake Wesley,15,12,14,4,13456,3/8/2024 3:00,Sacramento Kings,San Antonio Spurs
