,First Last Name,team,position,points,minutes,fgm,fga,fgp,ftm,fta,ftp,tpm,tpa,tpp,offReb,defReb,totReb,assists,pFouls,steals,turnovers,blocks,plusMinus,Points_Rebounds_Assist,Points_Rebounds,Points_Assist,Rebounds_Assist,points_deviation,totReb_deviation,assists_deviation,tpm_deviation,Points_Rebounds_Assist_deviation,Points_Rebounds_deviation,Points_Assist_deviation,Rebounds_Assist_deviation,count
0,A. Flagler,Oklahoma City Thunder,F,0,6,0,3,0.0,0,0,0.0,0,3,0.0,0,0,0,1,0,0,0,0,0,1,0,1,1,0.0,0.0,0.0,0.0,0.0,0.0,0.0,0.0,1
1,A.J. Green,Milwaukee Bucks,G,60,142,19,43,431.5,7,8,266.7,15,35,389.3,2,14,16,6,8,2,4,0,3,82,76,66,22,251.8148788927336,16.458477508650518,9.01038062283737,23.05363321799308,359.598615916955,365.2179930795848,245.7733564013841,25.891003460207614,10
2,A.J. Lawson,Dallas Mavericks,G,20,42,8,21,223.3,2,6,100.0,2,8,100.0,2,6,8,3,5,1,0,1,-5,31,28,23,11,33.85185185185185,7.5,1.962962962962963,1.6296296296296295,54.01851851851852,46.462962962962955,38.629629629629626,12.24074074074074,6
3,Aaron Gordon,Denver Nuggets,PF,125,313,53,93,639.4,15,24,521.7,4,17,133.3,22,37,59,42,22,5,12,1,40,226,184,167,101,199.4972299168975,106.21883656509696,58.112188365650965,2.433518005540167,318.44875346260386,453.0096952908587,126.18005540166205,103.08725761772853,10
4,Aaron Holiday,Houston Rockets,G,44,113,16,41,296.5,6,6,300.0,6,21,161.7,1,8,9,16,16,6,3,1,14,69,53,60,25,257.77777777777777,7.21301775147929,33.051939513477976,11.80144641683103,402.869822485207,326.6318211702827,338.4023668639053,35.878369493754114,10
5,Aaron Nesmith,Indiana Pacers,SF,109,303,35,90,385.09999999999997,23,24,775.0,16,46,347.9,6,25,31,15,35,6,6,10,70,155,140,124,46,226.49387755102038,29.522448979591836,7.987755102040817,12.604081632653061,381.07346938775504,366.4,233.00408163265305,45.67346938775511,10
6,Aaron Wiggins,Oklahoma City Thunder,SG,52,150,21,40,536.3,5,8,250.0,5,14,200.0,7,11,18,11,5,10,8,6,3,81,70,63,29,108.24720578566733,8.231426692965153,8.905325443786982,8.289940828402369,119.59171597633134,129.36094674556213,108.19395134779751,7.42077580539119,10
7,Admiral Schofield,Orlando Magic,SF,5,11,2,4,66.7,0,0,0.0,1,2,100.0,0,2,2,0,1,1,0,0,-11,7,7,5,2,13.955017301038062,0.02768166089965399,0.006920415224913495,0.5432525951557092,14.162629757785467,14.384083044982699,13.761245674740483,0.006920415224913498,2
8,Al Horford,Boston Celtics,C,102,265,39,69,588.5,6,6,300.0,18,40,439.3,12,41,53,24,17,9,7,8,96,179,155,126,77,308.33673469387753,66.125,22.69387755102041,27.604591836734695,419.125,331.5331632653061,390.5,94.24744897959184,10
9,Alec Burks,New York Knicks,SG,71,129,23,72,280.0,14,19,446.4,11,40,257.5,3,15,18,9,2,3,4,0,-8,98,89,80,27,286.1360946745562,19.68310322156476,3.310322156476003,8.822485207100591,485.20578566732416,436.86061801446414,325.03221564760025,32.442472057856676,10
10,Aleksej Pokusevski,Charlotte Hornets,F,30,111,12,32,275.8,3,3,200.0,3,11,183.3,5,16,21,11,6,6,7,5,-8,62,51,41,32,35.815,15.56,7.035,1.5150000000000001,81.74000000000001,62.714999999999996,46.06,31.375,6
11,Aleksej Pokusevski,Oklahoma City Thunder,F,6,18,2,5,100.0,1,2,50.0,1,3,100.0,0,2,2,0,0,1,0,0,-12,8,8,6,2,26.007500000000004,26.480000000000004,8.167499999999999,0.7075,161.07,99.60750000000002,58.42999999999999,63.6875,3
12,Alex Caruso,Chicago Bulls,SG,104,320,37,90,391.5,9,15,275.0,21,56,367.0,6,32,38,48,29,24,13,8,-27,190,142,152,86,408.59751643535424,28.0,28.406135865595328,27.061358655953253,616.3579254930606,504.7596785975164,527.1146822498174,49.48721694667641,10
13,Alex Len,Sacramento Kings,C,31,97,11,17,516.7,9,10,375.0,0,0,0.0,5,18,23,9,16,2,4,8,34,63,54,40,32,54.17551020408163,18.2,14.90204081632653,0.0,108.68979591836735,67.06122448979592,91.17551020408163,37.73061224489796,10
14,Alondes Williams,Miami Heat,G,0,6,0,1,0.0,0,0,0.0,0,1,0.0,0,1,1,0,0,0,1,0,-2,1,1,0,1,0.0,0.25,0.0,0.0,0.25,0.25,0.0,0.25,1
15,Alperen Sengun,Houston Rockets,C,209,324,81,157,512.7,43,68,622.9,4,12,200.0,39,68,107,45,36,16,26,7,2,361,316,254,152,847.1723356009071,197.81632653061226,123.77551020408163,4.408163265306122,1935.0226757369614,1622.4580498866212,993.7777777777778,487.5510204081633,10
16,Amari Bailey,Charlotte Hornets,G,2,6,1,3,33.3,0,0,0.0,0,2,0.0,0,0,0,1,0,1,0,0,7,3,2,3,1,0.7901234567901234,0.0,0.11111111111111113,0.0,1.4938271604938274,0.7901234567901234,1.4938271604938274,0.11111111111111113,1
17,Amen Thompson,Houston Rockets,F,130,239,53,80,633.3,23,29,671.4,1,5,100.0,20,48,68,20,24,14,10,8,91,218,198,150,88,470.225,73.7,17.6,0.9000000000000001,927.8249999999999,842.225,525.025,122.10000000000002,10
18,Amir Coffey,LA Clippers,SG,68,226,25,58,368.7,5,5,300.0,13,35,316.7,2,25,27,16,13,4,9,1,-55,111,95,84,43,221.88101676581937,76.65170362358032,16.650081124932395,18.100054083288263,578.7555435370471,434.56949702541914,331.724175229854,127.64467279610601,10
19,Andre Drummond,Chicago Bulls,C,71,153,24,49,402.9,23,38,579.2,0,0,0.0,28,47,75,3,18,2,7,2,4,149,146,74,78,299.31821170282706,73.0578566732413,2.171597633136095,0.0,575.7955292570678,536.8231426692967,328.1446416831032,85.37541091387241,10
20,Andre Jr. Jackson,Milwaukee Bucks,G,10,69,4,9,333.3,0,0,0.0,2,5,200.0,3,9,12,10,6,3,3,0,-10,32,22,20,22,11.420118343195266,8.272189349112427,8.0,1.5266272189349113,40.35502958579881,32.04733727810651,16.804733727810646,19.19526627218935,6
21,Andrew Nembhard,Indiana Pacers,PG,86,282,35,67,516.9,6,7,200.0,10,28,398.3,6,22,28,33,23,8,14,1,36,147,114,119,61,202.57462195923733,38.46416831032215,23.0,4.026298487836949,412.3399079552926,285.69888231426694,329.77975016436557,60.900065746219596,10
22,Andrew Wiggins,Golden State Warriors,SF,122,249,47,104,442.5,14,18,400.0,14,36,358.3,20,31,51,17,14,5,5,4,-10,190,173,139,68,325.03616042077584,67.04207758053911,12.134779750164366,12.980933596318211,603.5016436554898,562.2071005917161,376.4898093359632,69.01775147928994,10
23,Anfernee Simons,Portland Trail Blazers,SG,234,361,80,177,436.7,36,39,757.1,38,94,405.4,4,33,37,64,19,7,30,1,-38,335,271,298,101,895.025,28.200000000000003,124.45625000000001,18.106250000000003,1705.00625,1159.125,1408.65625,184.90625,10
24,Anthony Black,Orlando Magic,G,50,193,17,48,368.8,7,12,250.0,9,21,308.3,6,23,29,9,11,6,9,3,25,88,79,59,38,136.98439125910508,64.95421436004162,5.0582726326742975,10.9105098855359,335.10509885535896,290.70655567117586,176.01977107180022,75.37565036420396,10
25,Anthony Davis,Los Angeles Lakers,PF,219,348,82,152,537.5,52,64,794.9,3,8,150.0,33,102,135,38,22,13,15,23,41,392,354,257,173,640.9753086419753,301.54475308641975,15.777777777777779,2.308641975308642,1669.4891975308642,1459.4151234567903,759.5679012345679,408.80401234567904,10
26,Anthony Edwards,Minnesota Timberwolves,SG,274,376,107,230,459.3,38,49,767.3,22,68,387.3,11,62,73,51,17,16,28,10,27,398,347,325,124,844.3321995464852,66.74489795918367,43.8469387755102,21.03061224489796,924.3866213151928,893.4444444444443,859.4580498866214,126.40816326530613,10
27,Anthony Gill,Washington Wizards,PF,38,91,14,31,284.4,6,6,200.0,4,11,191.7,8,11,19,10,9,5,8,0,-12,67,57,48,29,186.58769513314968,42.14692378328741,14.824609733700642,3.8099173553719003,472.64830119375574,373.3223140495868,262.41322314049586,80.47199265381084,7
28,Ashton Hagans,Portland Trail Blazers,G,47,181,17,39,452.7,8,11,350.0,5,11,166.7,8,21,29,32,25,7,19,7,8,108,76,79,61,130.2265625,18.90625,51.625,6.8515625,392.9140625,216.4765625,286.0390625,91.15625,10
29,Ausar Thompson,Detroit Pistons,F,103,314,42,87,508.0,11,25,325.0,8,29,195.3,15,44,59,21,26,17,14,11,-6,183,162,124,80,121.7,31.399999999999995,24.125,8.5,347.72499999999997,237.7,200.02499999999998,87.225,10
30,Austin Reaves,Los Angeles Lakers,SG,167,346,60,118,511.4,20,25,675.0,27,60,397.6,5,45,50,56,16,5,23,3,19,273,217,223,106,227.3808864265928,23.98891966759003,95.36426592797783,39.78531855955679,373.0,263.89058171745154,380.5678670360111,75.27562326869807,10
31,Ayo Dosunmu,Chicago Bulls,SG,183,375,71,142,469.7,19,21,558.3,22,56,378.3,8,23,31,58,24,10,17,6,-48,272,214,241,89,936.7343852728469,35.12886259040105,67.6094674556213,18.92570677186062,869.8698224852071,831.3609467455622,992.7501643655489,85.23142669296516,10
32,Bam Adebayo,Miami Heat,C,167,335,69,128,535.0,23,40,608.3,6,9,450.0,28,83,111,30,16,11,13,10,-47,308,278,197,141,274.265306122449,111.35918367346939,26.089795918367347,4.473469387755102,445.3469387755101,399.67346938775506,301.97959183673464,155.40816326530614,10
33,Ben Sheppard,Indiana Pacers,G,65,197,24,56,412.5,4,4,200.0,13,40,312.9,3,19,22,9,18,6,2,1,30,96,87,74,31,141.0,40.15586419753086,9.23611111111111,16.84104938271605,257.16049382716045,240.21141975308643,171.40277777777777,35.93827160493827,10
34,Ben Simmons,Brooklyn Nets,PG,53,168,24,38,521.1,5,11,150.0,0,0,0.0,15,39,54,46,20,9,12,4,-5,153,107,99,100,134.88888888888889,64.0,78.88888888888889,0.0,382.0,162.8888888888889,300.0,196.88888888888889,9
35,Bennedict Mathurin,Indiana Pacers,SG,139,275,44,115,340.3,35,45,614.5,16,44,245.0,10,33,43,23,24,7,17,4,-18,205,182,162,66,753.4765625,123.6015625,38.125,30.4140625,1418.90625,1097.65625,970.9140625,265.5390625,10
36,Bilal Coulibaly,Washington Wizards,SG,90,289,30,76,451.5,19,27,633.3,11,39,238.3,9,30,39,18,22,12,8,7,-98,147,129,108,57,127.37777777777777,38.5,16.0,13.177777777777775,337.8777777777778,291.7444444444444,166.31111111111107,61.699999999999996,10
37,Bismack Biyombo,Oklahoma City Thunder,C,4,31,1,4,33.3,2,2,100.0,0,0,0.0,3,2,5,2,6,0,2,1,4,11,9,6,7,4.16,2.7600000000000002,1.04,0.0,21.240000000000002,13.0,9.36,6.84,4
38,Blake Wesley,San Antonio Spurs,G,46,145,17,38,390.4,11,14,400.0,1,8,100.0,3,15,18,27,15,4,6,4,-33,91,64,73,45,154.62590401051938,23.609467455621303,68.93951347797501,0.9079552925706772,315.1775147928994,182.9257067718606,255.89940828402365,123.52728468113085,10
39,Boban Marjanovic,Houston Rockets,C,3,7,1,1,100.0,1,2,50.0,0,0,0.0,0,3,3,0,0,0,1,0,-3,6,6,3,3,0.027777777777777728,5.840277777777777,0.0,0.0,6.673611111111112,6.673611111111112,0.027777777777777728,5.840277777777777,1
40,Bobby Portis,Milwaukee Bucks,F,162,259,68,131,510.3,13,17,525.0,13,29,353.4,18,71,89,10,22,7,13,3,-5,261,251,172,99,635.60625,139.4,5.2250000000000005,23.0,1117.05625,1119.15625,633.00625,145.125,10
41,Bogdan Bogdanovic,Atlanta Hawks,SG,145,328,50,133,362.2,15,17,550.0,30,80,375.0,10,26,36,39,20,11,21,4,-12,220,181,184,75,358.32409972299166,44.7590027700831,60.01246537396122,26.110803324099724,395.5581717451524,315.97506925207756,444.8213296398892,97.8573407202216,10
42,Bojan Bogdanovic,New York Knicks,SF,79,189,29,79,326.29999999999995,10,11,350.0,11,38,256.4,3,14,17,10,13,0,19,0,-15,106,96,89,27,474.3235938641344,19.051132213294377,11.869978086194303,14.39371804236669,669.7048940832725,605.7019722425127,525.628195763331,43.619430241051866,10
43,Bol Bol,Phoenix Suns,C,58,109,24,38,573.8,3,3,200.0,7,15,350.0,6,27,33,3,7,1,5,5,-21,94,91,61,36,201.625,36.2890625,4.119140625,6.1015625,342.384765625,348.3515625,195.337890625,40.728515625,10
44,Bones Hyland,LA Clippers,PG,65,161,24,62,368.1,4,6,200.0,13,36,313.8,1,16,17,31,15,10,14,1,0,113,82,96,48,284.1,16.144444444444446,87.6111111111111,19.0,788.4999999999999,417.1111111111111,589.2444444444444,170.0,10
45,Bradley Beal,Phoenix Suns,SG,185,352,71,137,514.3,26,30,738.3,17,42,371.9,11,30,41,63,25,12,30,7,19,289,226,248,104,557.7110726643599,27.8719723183391,24.141868512110726,8.22491349480969,373.4896193771626,451.9809688581315,474.2231833910035,57.01038062283737,10
46,Brandin Podziemski,Golden State Warriors,G,74,289,27,69,357.8,7,12,275.0,13,32,400.0,19,36,55,39,12,11,12,4,45,168,129,113,94,221.11111111111111,50.50566893424036,23.48979591836735,12.86281179138322,477.9591836734694,429.48979591836735,274.69614512471657,68.87981859410431,10
47,Brandon Boston Jr.,LA Clippers,SG,58,133,23,56,432.1,7,14,350.0,5,16,250.0,7,12,19,3,15,3,4,7,-37,80,77,61,22,146.38287752675384,30.193816884661118,2.3626634958382873,5.16884661117717,276.884661117717,236.86444708680148,171.4447086801427,47.51486325802617,10
48,Brandon Ingram,New Orleans Pelicans,SF,180,306,68,138,496.2,36,43,724.5,8,27,260.0,6,50,56,54,24,6,19,7,49,290,236,234,110,669.5581717451523,25.364265927977836,44.5,6.699445983379501,720.3393351800554,826.4709141274238,558.8476454293628,74.4432132963989,10
49,Brandon Miller,Charlotte Hornets,F,179,328,69,168,406.0,16,22,471.7,25,75,309.9,10,46,56,25,24,9,16,6,-86,260,235,204,81,342.5,59.36980609418283,42.67313019390582,14.506925207756233,688.9307479224376,653.4487534626038,383.22576177285316,96.79916897506924,10
50,Brandon Williams,Dallas Mavericks,G,7,24,2,9,83.3,3,4,100.0,0,2,0.0,1,1,2,4,1,0,1,0,-12,13,9,11,6,18.22448979591837,3.183673469387756,4.081632653061224,0.0,30.46938775510204,15.448979591836734,29.0,11.510204081632653,4
51,Braxton Key,Denver Nuggets,F,2,6,1,1,100.0,0,1,0.0,0,0,0.0,1,1,2,0,1,0,0,0,2,4,4,2,2,2.25,1.0,0.0,0.0,6.25,6.25,2.25,1.0,1
52,Brice Sensabaugh,Utah Jazz,F,78,229,31,79,374.8,10,12,316.7,6,36,170.0,8,38,46,23,11,5,19,2,-40,147,124,101,69,281.95847750865056,126.36159169550174,20.548442906574394,6.652249134948097,496.8477508650519,505.1574394463667,264.58304498269894,155.9757785467128,10
53,Brook Lopez,Milwaukee Bucks,C,106,281,37,74,482.79999999999995,9,12,350.0,23,47,500.0,14,33,47,18,21,3,10,11,-5,171,153,124,65,187.08984660336012,30.23593864134405,31.56464572680789,18.35427319211103,357.1811541271001,262.8670562454346,258.5069393718042,84.69758948137326,10
54,Bruce Brown,Toronto Raptors,SF,96,270,36,79,423.0,19,21,600.0,5,17,200.0,6,34,40,36,16,4,15,2,-92,172,136,132,76,194.70343392299688,84.66597294484912,26.401664932362124,4.502601456815817,459.6503642039542,324.4703433922997,315.9500520291363,125.00104058272633,10
55,Bruno Fernando,Atlanta Hawks,PF,49,196,20,39,499.9,9,12,375.0,0,0,0.0,17,50,67,11,29,13,17,11,-37,127,116,60,78,69.4,63.26122448979592,6.90204081632653,0.0,172.0612244897959,148.48979591836735,84.64489795918368,78.48979591836736,10
56,Bryce McGowens,Charlotte Hornets,G,54,155,18,37,330.8,13,18,441.7,5,15,180.0,3,21,24,8,15,7,4,3,-10,86,78,62,32,234.40625,28.0,5.65625,6.8515625,395.625,383.40625,249.625,30.65625,10
57,Buddy Hield,Philadelphia 76ers,SG,108,227,39,98,402.5,9,9,300.0,21,57,403.0,6,21,27,22,15,9,9,6,-37,157,135,130,49,124.0,42.71315192743764,19.03061224489796,9.162131519274375,362.9954648526077,270.52267573696145,190.17346938775512,88.04308390022676,10
58,CJ McCollum,New Orleans Pelicans,SG,168,303,65,138,453.2,7,9,241.7,31,80,361.8,2,34,36,37,13,6,17,4,66,241,204,205,73,565.60625,18.425,55.0,43.05625,889.5562500000001,555.20625,910.05625,63.325,10
59,Cade Cunningham,Detroit Pistons,PG,204,308,77,188,402.8,32,35,722.2,18,58,269.6,9,42,51,84,18,7,32,2,-62,339,255,288,135,572.259765625,35.275390625,26.431640625,20.5,975.541015625,764.40625,753.9765625,91.125,10
60,Caleb Houstan,Orlando Magic,G,41,161,13,35,289.4,2,2,100.0,13,33,322.7,4,11,15,3,14,2,3,2,-5,59,56,44,18,150.36028537455408,32.868014268727705,2.3436385255648036,17.646848989298455,289.2009512485137,270.0701545778835,156.41854934601662,48.284185493460164,9
61,Caleb Martin,Miami Heat,SF,100,294,37,96,364.9,11,13,566.7,15,51,321.2,12,37,49,17,22,9,13,5,-32,166,149,117,66,254.02629848783695,40.905325443786985,30.31360946745562,12.975016436554897,564.5391190006575,384.9079552925707,394.190006574622,110.68639053254438,10
62,Cam Reddish,Los Angeles Lakers,SF,23,102,8,19,193.3,2,6,75.0,5,13,183.3,4,5,9,1,7,3,2,4,9,33,32,24,10,68.34375,7.59375,0.84375,3.09375,59.09375,50.375,80.0,5.5,6
63,Cam Thomas,Brooklyn Nets,SG,231,339,83,184,445.4,44,51,827.4,21,62,309.7,7,43,50,36,20,5,20,0,-13,317,281,267,86,300.8612244897959,55.951020408163274,19.216326530612243,30.951020408163266,286.32244897959185,275.2448979591837,304.34693877551024,82.75918367346938,10
64,Cam Whitmore,Houston Rockets,F,126,203,48,111,415.2,17,26,385.0,13,50,239.8,14,31,45,5,11,5,15,5,3,176,171,131,50,215.05817174515238,60.56232686980609,2.673130193905817,12.290858725761774,347.16343490304706,345.24376731301936,225.77008310249312,54.44321329639889,10
65,Cameron Johnson,Brooklyn Nets,SF,155,273,49,102,478.1,27,32,791.7,30,67,441.3,7,31,38,21,14,10,13,1,2,214,193,176,59,451.0863177226814,44.776859504132226,14.904499540863178,31.31496786042241,614.5821854912764,485.0477502295684,563.9816345270891,76.32047750229569,10
66,Cameron Payne,Philadelphia 76ers,PG,103,198,39,95,429.9,10,11,375.0,15,43,349.5,4,11,15,29,17,6,11,2,-58,147,118,132,44,183.70000000000005,20.65625,16.925,10.525,283.60625,265.35625000000005,200.825,38.706250000000004,10
67,Caris LeVert,Cleveland Cavaliers,SG,139,337,49,124,382.2,26,35,500.2,15,53,271.6,7,41,48,83,17,18,23,6,31,270,187,222,131,376.4082840236686,19.63182117028271,55.89940828402367,7.882314266929652,661.8882314266929,470.3083497698882,525.9289940828402,117.59040105193951,10
68,Cason Wallace,Oklahoma City Thunder,G,74,209,29,60,463.9,2,4,100.0,14,31,410.0,9,16,25,17,14,12,9,6,-7,116,99,91,42,346.27087442472055,14.501643655489811,20.245233399079556,18.886259040105195,454.0828402366864,392.5450361604208,412.7777777777777,29.777777777777775,10
69,Cedi Osman,San Antonio Spurs,SF,41,140,17,37,407.1,0,0,0.0,7,22,216.6,3,17,20,11,12,4,8,2,-47,72,61,52,31,143.78251821019774,18.04162330905307,18.912591050988553,7.67429760665973,149.4276795005203,165.7887617065557,135.37565036420398,29.0,10
70,Charlie Brown Jr.,New York Knicks,G,3,27,1,5,20.0,0,0,0.0,1,3,33.3,1,1,2,0,4,0,0,1,-6,5,5,3,2,6.12,2.7200000000000006,0.0,0.6800000000000002,17.0,17.0,6.12,2.7200000000000006,2
71,Chet Holmgren,Oklahoma City Thunder,PF,166,301,62,118,526.8,28,33,543.3,14,41,320.0,20,75,95,21,12,7,8,14,59,282,261,187,116,626.6929651545037,119.69822485207101,14.900065746219592,9.95923734385273,1194.8402366863904,1182.0361604207758,620.4792899408283,153.61604207758054,10
72,Chimezie Metu,Detroit Pistons,PF,10,41,4,11,70.8,2,2,100.0,0,5,0.0,1,6,7,3,6,2,4,0,-4,20,17,13,10,22.5,1.8888888888888893,1.3888888888888884,0.0,26.0,23.388888888888886,21.888888888888893,6.5,2
73,Chimezie Metu,Phoenix Suns,PF,6,29,3,5,150.0,0,0,0.0,0,0,0.0,2,9,11,2,2,2,3,0,-7,19,17,8,13,14.75,21.66666666666667,0.7500000000000001,0.0,46.0,35.41666666666667,21.0,26.75,3
74,Chris Boucher,Toronto Raptors,PF,69,120,25,35,573.3,15,18,500.0,4,12,216.7,13,27,40,5,11,1,9,5,7,114,109,74,45,142.20987654320987,47.580246913580254,5.913580246913581,4.0246913580246915,410.0,329.0246913580247,192.69135802469134,83.98765432098766,8
75,Chris Duarte,Sacramento Kings,SG,67,153,24,51,420.8,4,5,250.0,15,34,431.0,8,21,29,9,8,7,2,5,12,105,96,76,38,303.431640625,26.728515625,6.931640625,12.8515625,461.947265625,418.15625,334.7265625,46.15625,10
76,Chris Livingston,Milwaukee Bucks,F,0,6,0,2,0.0,0,0,0.0,0,2,0.0,0,1,1,1,4,0,1,0,-10,2,1,1,2,0.0,0.0625,0.5625,0.0,1.0,0.0625,0.5625,1.0,1
77,Chris Paul,Golden State Warriors,PG,107,246,46,93,493.1,2,2,100.0,13,32,396.7,6,40,46,68,20,9,10,0,-40,221,153,175,114,211.0,34.40816326530612,100.625,6.369897959183673,431.67602040816325,358.83673469387753,303.125,115.74744897959184,10
78,Christian Braun,Denver Nuggets,G,70,190,27,41,659.7,7,12,275.0,9,17,433.3,4,31,35,14,23,5,7,6,35,119,105,84,49,147.42936288088643,20.749307479224377,10.759002770083104,9.022160664819943,204.65512465373962,158.50554016620498,190.98060941828254,34.106648199445985,10
79,Christian Wood,Los Angeles Lakers,F,59,133,22,51,477.0,11,14,450.0,4,19,225.0,6,28,34,6,12,5,5,2,-14,99,93,65,40,153.90277777777777,54.402777777777786,4.625,2.4444444444444446,305.125,285.0,156.7777777777778,76.27777777777777,10
80,Chuma Okeke,Orlando Magic,PF,0,33,0,4,0.0,0,0,0.0,0,4,0.0,0,4,4,2,2,2,2,0,-14,6,4,2,6,0.4253472222222223,2.8888888888888893,1.3125,0.008680555555555556,4.800347222222222,2.9253472222222223,1.300347222222222,5.20138888888889,5
81,Clint Capela,Atlanta Hawks,C,126,255,54,98,557.3000000000001,18,29,430.0,0,0,0.0,50,64,114,21,21,5,10,10,46,261,240,147,135,85.16049382716048,50.489197530864196,19.026234567901234,0.0,197.88271604938274,190.4027777777778,90.56944444444446,71.58641975308643,10
82,Coby White,Chicago Bulls,PG,187,385,66,158,413.0,30,35,771.7,25,72,331.2,8,38,46,51,24,7,22,3,-9,284,233,238,97,595.2361111111111,24.944444444444446,93.44444444444444,38.93402777777777,918.625,654.2361111111111,773.7361111111111,204.27777777777777,10
83,Cody Martin,Charlotte Hornets,SF,69,285,28,76,367.2,6,7,250.0,7,30,228.2,6,44,50,42,15,11,20,7,-28,161,119,111,92,111.0,28.18685121107267,64.68512110726644,2.6816608996539792,183.02076124567472,112.9515570934256,173.33217993079583,100.60899653979239,10
84,Cody Zeller,New Orleans Pelicans,C,7,31,3,6,200.0,1,2,50.0,0,0,0.0,5,10,15,3,5,2,3,0,14,25,22,10,18,3.214876033057851,4.661157024793389,3.305785123966942,0.0,17.03305785123967,11.677685950413224,6.041322314049586,10.49586776859504,5
85,Colby Jones,Sacramento Kings,G,4,20,2,7,83.3,0,0,0.0,0,2,0.0,1,4,5,3,3,0,1,0,4,12,9,7,8,4.528925619834711,4.3884297520661155,0.39669421487603307,0.0,18.933884297520663,15.165289256198347,6.644628099173553,6.43801652892562,3
86,Cole Anthony,Orlando Magic,PG,102,215,37,85,412.9,18,24,587.5,10,36,218.4,7,32,39,20,17,5,12,6,30,161,141,122,59,311.3776479181885,43.1373265157049,23.051862673484294,12.182615047479914,393.0,390.21402483564646,347.16435354273193,33.188458728999265,10
87,Cole Swider,Miami Heat,F,16,37,5,13,71.4,2,2,100.0,4,11,66.7,0,4,4,1,1,0,3,0,-20,21,20,17,5,152.0,2.16,0.7600000000000002,13.440000000000001,181.24,185.36,147.96,2.84,4
88,Collin Gillespie,Denver Nuggets,G,30,64,11,20,197.8,1,3,50.0,7,11,200.0,0,7,7,7,6,5,5,0,8,44,37,37,14,157.84,3.24,7.24,9.24,242.96,167.15999999999997,231.16,12.96,4
89,Collin Sexton,Utah Jazz,PG,220,330,88,164,537.5,24,27,813.3,20,48,306.7,12,20,32,58,17,8,23,1,-39,310,252,278,90,121.97107438016529,37.05785123966942,41.83884297520661,38.046487603305785,286.0,186.92975206611567,205.42148760330576,94.51652892561982,10
90,Corey Kispert,Washington Wizards,SF,132,289,46,95,454.0,15,27,458.3,25,60,386.4,3,24,27,18,21,7,12,3,-38,177,159,150,45,360.1456611570248,16.100206611570247,23.607438016528928,26.520661157024794,514.4214876033058,409.4917355371901,442.2778925619835,62.5051652892562,10
91,Cory Joseph,Golden State Warriors,PG,27,71,10,16,316.7,0,0,0.0,7,11,316.7,2,9,11,6,6,0,1,0,9,44,38,33,17,31.2,10.8,2.8000000000000003,3.2,28.8,47.2,21.2,5.2,5
92,Craig Jr. Porter,Cleveland Cavaliers,G,53,105,22,44,391.9,5,5,300.0,4,10,125.0,5,16,21,16,7,3,7,0,-17,90,74,69,37,323.8686224489795,38.75510204081633,15.0,9.040816326530612,625.4604591836734,529.9604591836734,409.3686224489795,63.75510204081633,9
93,D'Angelo Russell,Los Angeles Lakers,PG,202,356,72,155,434.7,20,24,760.0,38,86,413.8,6,33,39,61,21,10,21,4,40,302,241,263,100,1067.6683710737764,30.609934258582907,135.72753834915997,51.601168736303876,1798.0,1339.4032140248357,1539.0964207450695,153.5062089116143,10
94,D.J. Carton,Toronto Raptors,G,8,31,2,7,83.3,3,4,150.0,1,4,50.0,2,1,3,3,1,1,1,0,-30,14,11,11,6,8.666666666666668,2.0,2.0,0.6666666666666667,8.666666666666666,2.6666666666666665,18.666666666666668,0.0,3
95,Daishen Nix,Minnesota Timberwolves,SG,5,5,2,3,66.7,0,0,0.0,1,2,50.0,0,0,0,0,1,1,0,0,6,5,5,5,0,9.0,0.0,0.08163265306122448,0.32653061224489793,7.367346938775511,9.0,7.367346938775511,0.08163265306122448,1
96,Dalano Banton,Portland Trail Blazers,G,172,319,61,145,429.3,24,28,891.7,26,63,436.6,10,36,46,36,17,10,24,6,-99,254,218,208,82,674.5,41.20625,44.05625,22.05625,1218.0,968.3562500000002,898.9062499999999,110.5,10
97,Dalen Terry,Chicago Bulls,F,34,128,14,32,403.6,3,6,150.0,3,12,175.0,8,18,26,19,10,9,5,1,28,79,60,53,45,40.7890625,44.625,22.90625,2.384765625,249.1015625,134.6015625,102.1640625,120.65625,10
98,Damian Jones,Cleveland Cavaliers,C,52,118,21,35,527.9,10,12,550.0,0,5,0.0,14,23,37,6,10,4,6,7,-25,95,89,58,43,149.80555555555554,47.583333333333336,4.027777777777778,0.0,262.25,264.0,149.66666666666666,50.0,9
99,Damian Lillard,Milwaukee Bucks,PG,257,359,84,185,441.09999999999997,49,51,969.0,40,94,412.3,3,36,39,87,16,7,24,4,19,383,296,344,126,854.4570637119114,23.70775623268698,102.73822714681441,33.054016620498615,1173.6592797783933,962.2950138504156,1039.8573407202216,152.40997229916897,10
100,Daniel Gafford,Dallas Mavericks,C,139,229,60,70,792.1,19,29,473.4,0,0,0.0,23,54,77,15,33,9,7,20,45,231,216,154,92,437.925,85.00000000000001,20.50625,0.0,845.9562500000001,703.625,570.90625,114.85625000000002,10
101,Daniel Theis,LA Clippers,C,51,144,22,42,477.5,3,3,200.0,4,10,250.0,11,24,35,11,18,1,7,9,23,97,86,62,46,117.3213296398892,31.060941828254848,9.486149584487535,4.404432132963989,222.84903047091413,190.40997229916897,147.6135734072022,42.69390581717452,10
102,Danilo Gallinari,Milwaukee Bucks,PF,28,105,9,23,350.0,9,10,275.0,1,11,100.0,3,6,9,9,7,2,3,1,-43,46,37,37,18,85.45557655954632,5.431001890359168,12.931947069943291,1.158790170132325,105.47069943289226,104.0132325141777,84.85255198487712,20.4234404536862,10
103,Dante Exum,Dallas Mavericks,G,62,186,20,41,439.1,14,16,516.7,8,13,350.0,2,18,20,27,14,2,12,0,30,109,82,89,47,278.40816326530614,18.816326530612244,34.369897959183675,17.033163265306122,405.390306122449,301.38775510204084,363.47193877551024,72.125,10
104,Danuel House Jr.,Philadelphia 76ers,SF,42,143,14,30,276.3,13,15,466.7,1,11,33.3,6,11,17,7,16,7,3,3,-26,66,59,49,24,42.0,11.714285714285715,8.0,0.8571428571428572,41.714285714285715,51.714285714285715,40.0,11.714285714285715,7
105,Dario Saric,Golden State Warriors,PF,28,107,12,33,298.3,2,3,100.0,2,17,83.3,6,15,21,18,5,0,13,0,-31,67,49,46,39,52.5679012345679,27.087791495198907,15.60493827160494,2.197530864197531,146.33058984910838,99.20301783264748,73.23456790123457,69.15363511659808,10
106,Darius Garland,Cleveland Cavaliers,PG,200,354,73,172,424.7,23,30,777.4,31,88,334.3,8,21,29,71,26,9,29,1,-13,300,229,271,100,610.9030470914128,40.90443213296399,63.86426592797784,48.03462603878116,867.5858725761773,688.6551246537396,781.764542936288,112.83795013850414,10
107,David Roddy,Phoenix Suns,F,68,169,27,69,480.3,9,15,301.7,5,25,143.3,5,24,29,13,7,2,14,0,-88,110,97,81,42,429.95243757431626,122.40071343638526,25.416171224732462,8.859690844233056,1037.5077288941734,809.7063020214032,606.8026159334125,198.7681331747919,10
108,Davion Mitchell,Sacramento Kings,PG,57,155,24,45,491.7,0,0,0.0,9,25,310.0,5,10,15,14,9,3,9,0,28,86,72,71,29,149.61157024793388,9.125,10.429752066115702,15.855371900826448,213.16219008264463,173.96384297520663,177.08264462809916,31.28202479338843,10
109,Davis Bertans,Charlotte Hornets,SF,92,245,31,89,316.3,7,8,250.0,23,71,284.1,5,23,28,15,18,11,7,4,-33,135,120,107,43,370.94444444444446,58.00000000000001,20.944444444444443,27.97777777777778,647.0,538.9444444444445,457.0,100.94444444444444,10
110,Day'Ron Sharpe,Brooklyn Nets,C,64,156,26,46,602.2,10,19,341.6,2,3,100.0,26,31,57,20,19,4,12,8,5,141,121,84,77,161.301775147929,197.53254437869825,16.236686390532544,3.671597633136095,521.6390532544378,438.6686390532544,208.98224852071007,249.05917159763314,10
111,De'Aaron Fox,Sacramento Kings,PG,253,358,99,218,459.09999999999997,29,35,751.7,26,75,360.3,9,43,52,63,28,23,30,4,57,368,305,316,115,598.046485260771,43.600907029478456,75.11791383219955,16.400226757369616,513.1938775510204,584.6723356009071,565.8287981859411,79.45804988662131,10
112,De'Andre Hunter,Atlanta Hawks,SF,166,294,60,132,450.2,22,29,598.3,24,60,392.7,1,25,26,15,22,8,13,3,0,207,192,181,41,328.5975164353543,20.47479912344777,6.516435354273192,19.596785975164355,322.44777209642075,374.1154127100073,279.0,24.921110299488678,10
113,De'Anthony Melton,Philadelphia 76ers,SG,23,43,7,20,75.0,4,4,200.0,5,14,75.0,0,5,5,5,3,2,1,1,-2,33,28,28,10,128.66666666666666,2.666666666666667,2.666666666666667,8.666666666666666,206.0,164.66666666666669,164.66666666666669,10.666666666666668,3
114,DeAndre Jordan,Denver Nuggets,C,25,80,12,20,650.0,1,3,100.0,0,0,0.0,14,18,32,2,11,0,1,3,-38,59,57,27,34,28.25,55.89583333333334,1.5833333333333335,0.0,112.72916666666669,97.56249999999999,35.00000000000001,65.89583333333333,9
115,DeJon Jarreau,Memphis Grizzlies,F,30,120,11,40,175.0,5,8,250.0,3,9,116.7,6,33,39,22,12,6,8,1,-26,91,69,52,61,61.46124763705104,63.35727788279773,38.54253308128545,3.844990548204159,293.6219281663516,138.9962192816635,145.90170132325142,172.08506616257088,7
116,DeMar DeRozan,Chicago Bulls,SF,256,358,80,157,504.59999999999997,85,97,883.0,11,33,263.4,4,45,49,48,14,9,18,5,3,353,305,304,97,1018.8994082840236,80.02827087442472,56.51545036160421,11.420775805391191,1507.9848783694938,1401.9769888231426,1071.3399079552926,190.11111111111111,10
117,Dean Wade,Cleveland Cavaliers,PF,46,178,15,35,260.2,5,7,216.7,11,31,233.4,4,27,31,7,8,3,1,9,-23,84,77,53,38,468.50000000000006,35.125,6.125,31.525000000000006,718.8,714.725,466.12499999999994,47.699999999999996,10
118,Deandre Ayton,Portland Trail Blazers,C,229,346,105,167,627.8,18,22,450.0,1,3,100.0,39,97,136,14,15,7,22,9,-35,379,365,243,150,619.0,213.0737764791819,6.410518626734843,0.9006574141709277,1370.1570489408327,1429.91161431702,582.9780861943025,195.75164353542732,10
119,Dejounte Murray,Atlanta Hawks,SG,259,379,95,216,433.9,32,41,720.3,37,100,356.7,8,43,51,85,17,21,31,2,-17,395,310,344,136,844.9750164365548,73.5706771860618,62.869822485207095,37.365548980933596,770.01775147929,1028.6390532544378,620.3497698882314,102.44444444444444,10
120,Delon Wright,Miami Heat,SG,42,164,15,39,414.7,9,12,283.3,3,11,150.0,5,12,17,24,5,11,1,2,-9,83,59,66,41,122.15933412604043,4.2294887039239,34.51367419738406,4.262782401902497,219.8822829964328,137.92746730083235,200.25445897740784,42.602853745541026,10
121,Deni Avdija,Washington Wizards,SF,155,341,61,129,476.6,22,32,633.7,11,33,310.0,17,71,88,31,25,8,22,3,-62,274,243,186,119,264.47193877551024,138.24489795918367,28.7984693877551,9.561224489795919,660.3367346938775,515.9005102040816,380.9897959183673,194.9617346938776,10
122,Dennis Schroder,Brooklyn Nets,PG,151,348,56,126,430.9,19,24,463.1,20,51,379.9,4,24,28,63,16,8,35,5,-90,242,179,214,91,498.8053911900066,37.6094674556213,45.195923734385275,14.164365548980934,567.2057856673241,431.98093359631827,656.4878369493754,60.347797501643655,10
123,Dennis Smith Jr.,Brooklyn Nets,PG,58,167,21,46,487.1,8,11,383.3,8,22,348.3,5,13,18,28,22,16,11,0,3,104,76,86,46,80.0,19.625,42.625,4.35625,180.8,137.625,111.025,74.39999999999999,10
124,Dereck II Lively,Dallas Mavericks,C,93,188,45,58,685.7,3,9,150.0,0,0,0.0,19,26,45,7,23,4,8,9,-24,145,138,100,52,412.860422405877,65.44444444444444,8.111111111111112,0.0,820.0725436179981,725.900826446281,496.5876951331497,84.0,10
125,Derrick Jones Jr.,Dallas Mavericks,SF,86,198,32,53,620.2,13,20,466.7,9,20,240.0,13,14,27,8,13,5,6,4,46,121,113,94,35,334.3836565096953,72.84903047091413,5.680055401662051,26.5,558.8434903047091,565.354570637119,333.56232686980616,72.8393351800554,10
126,Derrick Rose,Memphis Grizzlies,PG,49,95,20,37,377.7,5,6,266.7,4,8,233.3,0,15,15,21,3,1,9,0,-9,85,64,70,36,70.0,14.857142857142858,12.0,3.7142857142857144,188.85714285714286,116.85714285714286,128.0,40.857142857142854,7
127,Derrick White,Boston Celtics,PG,146,339,53,122,447.4,14,15,488.9,26,69,297.6,10,52,62,72,21,9,13,17,107,280,208,218,134,490.11245674740485,42.285467128027676,60.9204152249135,63.39273356401384,694.1384083044983,586.7750865051903,564.3477508650519,136.33391003460207,10
128,Desmond Bane,Memphis Grizzlies,SG,52,93,16,49,93.4,12,14,166.7,8,25,95.2,1,8,9,15,7,3,6,2,-24,76,61,67,24,198.98666666666668,8.213333333333333,6.0,2.6666666666666665,315.12,281.12,232.98666666666668,14.213333333333335,3
129,Devin Booker,Phoenix Suns,SG,247,363,89,197,457.0,50,52,925.0,19,62,268.0,14,38,52,63,32,7,20,5,-6,362,299,310,115,234.24394463667818,54.181660899653984,102.1280276816609,44.94982698961938,196.08304498269896,287.75432525951555,107.5173010380622,191.3650519031142,10
130,Devin Vassell,San Antonio Spurs,SG,208,384,82,166,479.9,22,26,841.7,22,57,365.8,4,41,45,50,14,12,21,5,-1,303,253,258,95,459.8171745152354,63.19252077562327,77.77285318559558,21.817174515235457,732.9819944598338,482.23407202216066,706.3490304709142,145.1814404432133,10
131,Devonte' Graham,San Antonio Spurs,PG,11,27,4,8,125.0,0,0,0.0,3,6,150.0,0,7,7,0,2,1,0,0,12,18,18,11,7,46.111111111111114,2.1111111111111107,0.0,3.0,58.0,58.0,46.111111111111114,2.1111111111111107,4
132,Dillon Brooks,Houston Rockets,SF,100,293,40,87,397.4,6,8,300.0,14,49,268.5,4,25,29,18,20,10,10,1,76,147,129,118,47,426.40625,29.656249999999996,13.625,9.15625,546.325,477.0,464.40625,74.60625,10
133,Domantas Sabonis,Sacramento Kings,PF,202,367,79,135,602.0,42,52,810.0,2,7,200.0,46,120,166,74,28,12,37,7,50,442,368,276,240,291.625,98.5,87.7892561983471,1.7985537190082646,409.4597107438017,345.625,326.4597107438017,215.2892561983471,10
134,Dominick Barlow,San Antonio Spurs,F,62,141,24,39,553.3,14,18,366.6,0,1,0.0,19,20,39,16,18,4,2,4,-20,117,101,78,55,231.23545706371192,75.49030470914128,40.23545706371191,0.0,531.0720221606648,487.54570637119116,303.9418282548476,86.54570637119113,9
135,Donovan Mitchell,Cleveland Cavaliers,SG,241,347,75,167,435.8,52,59,812.8,39,86,449.3,3,47,50,49,22,13,34,6,4,340,291,290,99,886.6487603305785,22.330578512396695,23.0495867768595,16.96694214876033,1278.185950413223,1120.5,1030.0206611570247,59.69421487603306,10
136,Donte DiVincenzo,New York Knicks,SG,175,352,62,159,383.8,14,15,566.7,37,108,349.2,8,36,44,38,25,17,18,6,47,257,219,213,82,365.25624999999997,46.9,30.40625,12.40625,560.5,496.90625,419.0,87.15625,10
137,Dorian Finney-Smith,Brooklyn Nets,PF,89,310,32,77,390.2,9,10,375.0,16,52,300.0,16,30,46,19,20,13,8,5,-24,154,135,108,65,304.853515625,27.056640625,23.3515625,24.65625,463.625,431.1640625,329.025390625,58.697265625,10
138,Doug McDermott,Indiana Pacers,SF,39,117,15,39,285.0,1,2,50.0,8,30,199.89999999999998,1,7,8,9,8,3,2,0,-8,56,47,48,17,197.92499999999998,11.2,11.3,10.0,302.425,252.325,244.825,25.699999999999996,10
139,Draymond Green,Golden State Warriors,PF,76,278,31,75,445.1,10,13,325.0,4,22,103.3,19,65,84,64,30,9,26,10,14,224,160,140,148,94.41165972635336,94.24271267102915,112.24271267102915,4.586555621653778,508.3688280785247,202.14753123140989,270.14753123140986,336.9708506841166,10
140,Drew Eubanks,Phoenix Suns,PF,49,148,21,31,650.0,7,7,300.0,0,0,0.0,14,31,45,4,12,3,5,7,1,98,94,53,49,69.07100591715977,74.07955292570678,2.5272846811308347,0.0,239.32544378698225,243.19000657462198,68.10322156476003,73.71005917159763,10
141,Duncan Robinson,Miami Heat,F,146,321,53,111,467.0,8,9,350.0,32,84,339.0,2,33,35,30,26,10,16,3,-13,211,181,176,65,468.41111111111104,21.877777777777776,36.01111111111111,37.7,674.5,489.5777777777777,640.8444444444444,70.37777777777778,10
142,Duop Reath,Portland Trail Blazers,C,80,176,28,63,352.0,12,14,435.7,12,30,283.4,10,12,22,7,20,3,9,2,-66,109,102,87,29,383.060032449973,37.63115197404002,10.24067063277447,17.600865332612223,708.4083288263927,582.3277447268794,478.0730124391563,78.93942671714441,10
143,Dwight Powell,Dallas Mavericks,C,20,119,7,12,450.0,6,11,325.0,0,0,0.0,12,20,32,9,19,0,9,3,-9,61,52,29,41,37.0,85.5625,9.822500000000002,0.0,230.40999999999997,184.0625,54.722500000000004,124.01,9
144,Dylan Windler,Atlanta Hawks,G,0,5,0,0,0.0,0,0,0.0,0,0,0.0,0,1,1,0,1,0,0,0,-8,1,1,0,1,0.81,0.16000000000000003,0.25,0.09,1.0,0.25,1.9599999999999997,0.010000000000000018,1
145,Dylan Windler,Los Angeles Lakers,G,3,14,1,4,25.0,0,0,0.0,1,4,25.0,0,1,1,2,1,0,0,0,-7,6,4,5,3,5.220000000000001,0.52,0.5,0.58,4.0,2.5,6.920000000000001,0.8199999999999998,2
146,Dyson Daniels,New Orleans Pelicans,G,38,181,16,32,311.4,1,2,50.0,5,13,250.0,7,20,27,20,12,15,12,8,25,85,65,58,47,123.55555555555556,24.0,25.555555555555557,4.222222222222222,146.22222222222223,113.55555555555556,128.22222222222223,77.55555555555556,9
147,Emoni Bates,Cleveland Cavaliers,F,7,12,3,7,42.9,0,2,0.0,1,4,25.0,0,1,1,0,0,0,1,0,-3,8,8,7,1,0.0,0.0,0.0,0.0,0.0,0.0,0.0,0.0,1
148,Eric Gordon,Phoenix Suns,SG,90,258,33,77,366.2,5,8,216.7,19,46,356.3,2,12,14,22,11,9,7,3,-8,126,104,112,36,501.431640625,7.2265625,11.666015625,27.7265625,523.40625,436.181640625,593.7890625,13.759765625,10
149,Eugene Omoruyi,Washington Wizards,F,39,106,17,38,391.3,5,10,200.0,0,6,0.0,7,13,20,7,18,7,5,1,-68,66,59,46,27,94.91836734693878,9.033163265306124,6.798469387755102,0.012755102040816325,87.34693877551021,71.67602040816327,106.89030612244898,19.530612244897956,10
150,Evan Fournier,Detroit Pistons,SG,58,174,21,66,308.5,6,7,266.7,10,41,184.3,1,17,18,21,20,9,7,1,-25,97,76,79,39,314.5444444444444,10.5,15.07777777777778,15.877777777777776,405.70000000000005,391.24444444444447,333.79999999999995,20.777777777777775,10
151,Evan Mobley,Cleveland Cavaliers,PF,147,305,60,107,547.9,24,42,522.6,3,14,175.0,25,76,101,35,27,12,16,20,-29,283,248,182,136,371.84429065743944,105.37370242214533,75.2006920415225,2.6262975778546713,782.1418685121107,674.0,423.83391003460207,236.7266435986159,10
152,Frank Ntilikina,Charlotte Hornets,PG,5,39,1,8,50.0,2,2,100.0,1,7,50.0,1,4,5,3,4,0,0,0,0,13,10,8,8,19.0,7.0,6.84,0.7600000000000002,24.439999999999998,14.0,18.64,24.640000000000004,4
153,Franz Wagner,Orlando Magic,SF,159,303,60,128,481.4,33,40,795.0,6,36,107.9,5,42,47,27,26,11,19,5,69,233,206,186,74,362.8582907231557,56.132213294375454,37.84587289992695,12.461650840029217,666.0518626734844,536.9276844411979,482.5522279035793,103.40832724616509,10
154,Fred VanVleet,Houston Rockets,PG,177,373,58,132,439.3,27,31,502.4,34,77,433.6,4,35,39,103,20,18,20,6,93,319,216,280,142,459.0,23.146938775510204,68.83673469387757,24.351020408163265,521.7591836734694,532.0326530612244,452.5795918367348,88.13061224489795,10
155,Furkan Korkmaz,Philadelphia 76ers,SG,41,116,13,29,278.6,7,10,241.7,8,18,258.3,3,12,15,12,6,3,2,2,22,68,56,53,27,292.875,14.875,10.0,20.0,404.0,340.0,363.875,17.875,8
156,GG Jackson,Memphis Grizzlies,F,195,330,63,148,408.8,42,51,757.4,27,81,289.3,17,33,50,17,15,5,19,4,-76,262,245,212,67,776.546485260771,36.95804988662131,18.713151927437643,49.0,939.7913832199546,848.3049886621316,858.5,65.20408163265306,10
157,Garrett Temple,Toronto Raptors,SF,13,30,4,6,150.0,3,4,150.0,2,4,100.0,1,2,3,2,2,3,1,0,6,18,16,15,5,29.0,1.0,2.36734693877551,2.36734693877551,57.224489795918366,40.0,43.36734693877551,6.224489795918369,2
158,Garrison Mathews,Atlanta Hawks,SG,46,175,13,31,390.0,10,11,283.3,10,23,375.1,4,10,14,7,23,4,0,2,-56,67,60,53,21,108.8,16.556250000000002,16.256249999999998,12.00625,250.5,179.05625,168.15625,44.900000000000006,10
159,Gary Harris,Orlando Magic,SG,74,238,27,54,532.8,4,7,125.0,16,38,477.6,2,13,15,9,12,8,7,3,22,98,89,83,24,116.5,10.677777777777777,12.944444444444445,4.800000000000001,212.5,172.1111111111111,147.7111111111111,32.8,10
160,Gary Payton II,Golden State Warriors,SG,33,137,14,25,443.3,2,5,100.0,3,6,300.0,12,8,20,10,14,4,8,2,-17,63,53,43,30,95.56198347107437,24.587695133149676,4.14692378328742,2.4416896235078056,119.35078053259872,133.43342516069788,82.06703397612488,28.14692378328742,10
161,Gary Trent Jr.,Toronto Raptors,SG,181,330,67,153,436.6,15,19,521.7,32,86,364.0,9,33,42,13,14,14,3,2,-52,236,223,194,55,566.0260145681582,12.678459937565037,14.567117585848075,31.60665972944849,543.369406867846,591.10197710718,513.8917793964621,31.647242455775235,10
162,Georges Niang,Cleveland Cavaliers,SF,137,298,50,94,550.0,11,11,500.0,26,57,492.7,2,33,35,17,29,8,15,4,-10,189,172,154,52,219.1165972635336,24.67995240928019,18.180249851278997,18.609161213563354,391.0011897679953,300.43307555026774,293.46103509815583,59.08387864366449,10
163,Giannis Antetokounmpo,Milwaukee Bucks,PF,298,346,106,177,605.1,77,106,708.2,9,20,433.3,23,84,107,65,24,5,31,7,53,470,405,363,172,494.94444444444446,84.2,90.77777777777777,5.611111111111111,1176.9,870.6777777777778,760.5,215.64444444444445,10
164,Goga Bitadze,Orlando Magic,C,28,99,11,20,480.0,6,9,283.3,0,3,0.0,10,12,22,9,10,2,8,9,3,59,50,37,31,46.68639053254438,61.609467455621306,8.213017751479288,0.0,224.5207100591716,168.0,72.69822485207101,100.33136094674555,9
165,Gordon Hayward,Oklahoma City Thunder,SF,55,190,17,34,520.0,13,19,410.0,8,15,500.0,5,19,24,24,14,5,7,0,4,103,79,79,48,66.66803840877915,26.507544581618657,39.40466392318244,3.635116598079561,152.2071330589849,99.44444444444444,105.49382716049384,79.84910836762688,10
166,Gradey Dick,Toronto Raptors,G,103,304,39,104,359.3,6,8,333.3,19,56,335.8,6,22,28,16,18,7,16,1,-141,147,131,119,44,273.0,27.200000000000003,40.43265306122449,19.146938775510204,511.8326530612245,391.79999999999995,380.1755102040816,80.48979591836735,10
167,Grant Williams,Charlotte Hornets,PF,133,318,48,96,524.0,26,33,524.6,11,35,372.5,17,35,52,25,31,11,27,5,-47,210,185,158,77,351.845872899927,89.94886778670562,24.884587289992698,10.609934258582907,679.8597516435354,608.8889700511322,372.08327246165084,165.56683710737767,10
168,Grayson Allen,Phoenix Suns,SG,188,359,62,109,565.9,17,19,725.0,47,87,515.3,3,26,29,32,18,11,10,8,34,249,217,220,61,694.9307479224377,18.954293628808866,30.426592797783936,86.39058171745154,830.0013850415513,724.2119113573407,805.2963988919668,44.80470914127423,10
169,Gui Santos,Golden State Warriors,F,38,103,13,24,372.5,8,9,350.0,4,8,250.0,9,21,30,9,14,2,5,2,22,77,68,47,39,159.5,94.28125,13.40625,4.125,502.375,450.78125,177.40625,141.375,8
170,Harrison Barnes,Sacramento Kings,SF,137,268,49,96,511.2,20,25,450.0,19,46,292.6,6,20,26,12,14,4,7,2,-24,175,163,149,38,228.44731404958677,50.946280991735534,9.640495867768596,46.125,438.02582644628103,343.7778925619835,304.125,79.15702479338843,10
171,Harry III Giles,Brooklyn Nets,F,8,8,3,6,50.0,1,2,50.0,1,1,100.0,2,2,4,2,3,0,0,0,-12,14,12,10,6,44.1833910034602,10.089965397923876,3.325259515570934,0.7785467128027681,135.65397923875432,96.50173010380624,71.75086505190312,25.0,1
172,Harry III Giles,Los Angeles Lakers,F,2,5,1,1,100.0,0,0,0.0,0,0,0.0,0,1,1,0,0,0,0,0,-3,3,3,2,1,0.41868512110726636,0.03114186851211074,0.031141868512110732,0.01384083044982699,0.41868512110726636,0.6782006920415228,0.22145328719723192,0.0,1
173,Haywood Highsmith,Miami Heat,F,24,120,9,24,348.8,1,4,50.0,5,16,200.0,5,13,18,10,7,0,1,1,-48,52,42,34,28,137.5398100803506,27.59970781592403,8.467494521548575,9.641344046749452,284.94083272461654,259.76333089846605,149.4521548575603,49.332359386413444,10
174,Herbert Jones,New Orleans Pelicans,SF,92,314,33,60,496.4,14,17,525.0,12,29,277.4,6,26,32,28,29,10,12,13,71,152,124,120,60,213.3780864197531,26.625,18.118827160493826,20.8641975308642,322.4027777777777,266.8641975308642,241.61111111111111,72.04938271604938,10
175,Hunter Tyson,Denver Nuggets,F,0,7,0,3,0.0,0,0,0.0,0,3,0.0,0,1,1,0,1,0,2,0,-1,1,1,0,1,4.0,0.11111111111111106,0.0,0.4444444444444444,5.4444444444444455,5.4444444444444455,4.0,0.11111111111111106,1
176,Ibou Badji,Portland Trail Blazers,C,7,32,3,4,150.0,1,2,50.0,0,0,0.0,1,2,3,4,6,0,5,3,-17,14,10,11,7,15.720000000000002,3.0800000000000005,2.75,0.0,37.06999999999999,30.32,21.470000000000002,6.83,3
177,Immanuel Quickley,Toronto Raptors,SG,195,364,68,158,420.7,33,45,597.2,26,77,328.3,2,55,57,88,17,11,26,3,-71,340,252,283,145,477.0639999999999,39.496,197.456,20.976,930.7840000000001,541.9359999999999,785.464,317.4,10
178,Isaac Okoro,Cleveland Cavaliers,SF,104,351,39,86,470.5,11,17,391.7,15,43,402.2,6,28,34,19,30,11,9,8,-40,157,138,123,53,141.6573468173706,41.19809637120762,8.900059488399762,10.51338488994646,180.00059488399762,195.5621653777513,129.32956573468172,46.86436644854254,10
179,Isaiah Hartenstein,New York Knicks,C,88,229,39,54,764.5,10,15,530.0,0,0,0.0,32,49,81,32,26,9,9,14,69,201,169,120,113,235.44489795918366,78.37959183673468,32.261224489795914,0.0,379.8,341.2040816326531,265.95102040816323,118.73061224489796,10
180,Isaiah Jackson,Indiana Pacers,SF,92,188,35,56,681.8,22,30,708.3,0,1,0.0,21,36,57,14,25,11,9,7,-3,163,149,106,71,223.90625,197.125,28.40277777777778,0.0,805.1840277777778,691.15625,257.85069444444446,305.6111111111111,10
181,Isaiah Joe,Oklahoma City Thunder,SG,57,169,21,62,281.2,3,3,100.0,12,44,228.3,3,15,18,9,11,3,3,4,-2,84,75,66,27,156.23265306122448,9.608163265306121,7.0,7.7306122448979595,217.5020408163265,194.27346938775509,177.9183673469388,18.151020408163266,10
182,Isaiah Mobley,Cleveland Cavaliers,F,5,33,2,7,58.3,0,0,0.0,1,4,25.0,0,4,4,2,2,0,0,0,-1,11,9,7,6,0.6799999999999997,10.880000000000003,0.72,0.6800000000000002,13.32,9.0,2.1199999999999997,14.479999999999999,2
183,Isaiah Stewart,Detroit Pistons,C,106,319,40,71,587.7,10,12,516.7,16,38,409.0,10,48,58,12,11,4,10,10,-48,176,164,118,70,131.47520661157026,49.603305785123965,9.603305785123966,12.764462809917354,245.47520661157023,193.27685950413223,178.88016528925618,64.0,10
184,Ish Smith,Charlotte Hornets,PG,18,181,8,34,236.0,0,0,0.0,2,2,200.0,1,19,20,41,16,5,6,1,-90,79,38,59,61,54.36000000000001,24.0,78.09,1.5600000000000003,170.49,69.16000000000001,134.09,123.69,9
185,Ish Wainright,Phoenix Suns,F,3,11,1,6,16.7,0,0,0.0,1,4,25.0,3,2,5,1,1,1,1,0,-3,9,8,4,6,6.024793388429752,16.735537190082646,0.6694214876033057,0.6694214876033057,54.22314049586777,42.84297520661156,10.71074380165289,24.09917355371901,1
186,Ivica Zubac,LA Clippers,C,94,247,39,56,696.2,16,18,600.0,0,0,0.0,27,54,81,16,27,7,15,9,-13,191,175,110,97,228.78373702422144,37.0,10.449826989619378,0.0,323.2404844290657,283.96020761245677,241.12283737024222,74.39100346020761,10
187,JT Thor,Charlotte Hornets,F,19,104,8,16,408.3,0,0,0.0,3,8,200.0,1,15,16,5,9,0,2,3,24,40,35,24,21,41.317580340264655,17.735349716446127,3.071833648393194,4.258979206049149,75.78071833648393,67.23818525519849,46.36672967863894,24.300567107750474,10
188,JaVale McGee,Sacramento Kings,C,23,44,11,18,355.0,0,3,0.0,1,2,100.0,5,8,13,1,6,2,1,0,3,37,36,24,14,46.83333333333333,12.833333333333332,0.8333333333333335,0.8333333333333335,78.83333333333334,84.0,46.0,9.333333333333332,6
189,Jabari Smith Jr.,Houston Rockets,PF,134,308,48,106,433.0,19,23,791.7,19,52,343.4,16,56,72,13,29,10,12,9,25,219,206,147,85,324.0,138.85317750182617,12.170197224251279,15.035062089116144,588.3791088385683,551.0153396639882,358.7647918188459,153.62235208181156,10
190,Jabari Walker,Portland Trail Blazers,F,102,238,40,79,498.0,17,22,665.0,5,16,266.7,21,48,69,16,31,8,9,1,-8,187,171,118,85,308.0,95.48979591836735,17.06122448979592,6.746938775510205,585.0163265306122,515.1469387755102,335.9183673469388,154.50204081632654,10
191,Jacob Gilyard,Memphis Grizzlies,G,67,205,23,52,431.8,1,1,100.0,20,45,431.8,1,14,15,41,10,10,12,2,-62,123,82,108,56,274.1404958677686,10.685950413223141,31.595041322314046,24.0,454.1404958677686,332.0,382.0,56.561983471074385,10
192,Jacob Toppin,New York Knicks,F,13,29,5,9,107.1,2,2,100.0,1,4,33.3,3,3,6,1,3,0,1,0,-18,20,19,14,7,78.05555555555556,8.722222222222221,0.5555555555555556,0.7222222222222223,130.22222222222223,136.55555555555554,72.5,8.5,2
193,Jaden Hardy,Dallas Mavericks,G,77,116,32,65,499.4,4,5,250.0,9,21,300.0,1,9,10,18,10,3,7,1,9,105,87,95,28,142.2853185595568,10.0,31.601108033240994,7.166204986149584,209.0,166.2853185595568,173.0,53.601108033241005,10
194,Jaden Ivey,Detroit Pistons,PG,169,322,62,145,432.5,31,38,696.7,14,54,227.7,9,23,32,40,25,11,31,6,-53,241,201,209,72,408.09138724523336,20.231426692965155,60.532544378698226,28.760026298487837,483.36160420775803,480.3438527284681,403.94937541091383,87.92373438527285,10
195,Jaden McDaniels,Minnesota Timberwolves,PF,107,305,43,104,412.6,12,22,298.8,9,38,261.7,12,36,48,13,31,10,10,7,-16,168,155,120,61,410.50566893424036,51.03061224489796,28.736961451247165,16.387755102040817,584.8083900226758,542.5907029478458,410.56689342403627,121.92403628117913,10
196,Jaden Springer,Boston Celtics,G,58,175,21,50,363.7,13,14,575.0,3,17,183.3,13,18,31,18,22,13,12,4,-17,107,89,76,49,186.84499314128942,37.82853223593965,24.345679012345677,2.45679012345679,518.0589849108368,375.48285322359396,285.3552812071331,106.24005486968449,10
197,Jae Crowder,Milwaukee Bucks,PF,53,205,21,48,392.9,2,2,100.0,9,26,266.6,8,17,25,9,17,9,2,1,-1,87,78,62,34,114.725,22.30625,8.30625,10.5,161.125,156.90625,120.75624999999997,28.800000000000004,10
198,Jae'Sean Tate,Houston Rockets,SF,37,125,15,34,428.7,5,9,200.0,2,6,133.3,10,18,28,6,17,9,11,3,10,71,65,43,34,60.119140625,29.681640625,5.15625,1.603515625,149.40625,119.0,74.634765625,50.728515625,10
199,Jahmi'us Ramsey,Toronto Raptors,SG,39,102,15,36,246.29999999999998,5,6,175.0,4,18,133.3,4,14,18,7,8,7,7,0,-37,64,57,46,25,68.75999999999999,34.66666666666667,3.0,1.5733333333333335,94.56,105.02666666666667,76.96000000000001,19.0,6
200,Jaime Jr. Jaquez,Miami Heat,G,104,291,39,86,430.4,18,25,616.7,8,25,244.89999999999998,9,40,49,27,20,12,9,3,3,180,153,131,76,399.9229968782518,41.14984391259105,22.292403746097815,7.839750260145682,373.75650364203955,369.74921956295526,390.9687825182102,76.40374609781477,10
201,Jake LaRavia,Memphis Grizzlies,F,134,290,38,108,356.9,43,51,743.9,15,49,310.2,26,32,58,20,24,15,12,5,-24,212,192,154,78,136.0,115.58168574401665,30.04162330905307,4.523413111342352,345.3069719042664,345.6462018730489,154.23517169614985,127.04890738813737,10
202,Jakob Poeltl,Toronto Raptors,C,122,251,55,101,543.9,12,20,491.7,0,0,0.0,39,53,92,31,28,10,11,19,35,245,214,153,123,161.8469387755102,127.67346938775509,30.387755102040813,0.0,516.704081632653,398.98979591836735,256.6224489795918,181.0,10
203,Jalen Brunson,New York Knicks,PG,291,337,107,232,464.8,46,55,650.0,31,82,409.5,6,26,32,64,15,10,27,2,57,387,323,355,96,918.53324099723,19.613573407202217,96.44875346260388,14.62880886426593,727.1274238227146,853.9030470914128,817.6911357340721,90.12880886426593,10
204,Jalen Duren,Detroit Pistons,C,132,273,49,79,611.5,34,41,755.0,0,0,0.0,31,86,117,21,31,6,27,4,-81,270,249,153,138,262.72315558802046,252.23593864134403,23.061358655953253,0.0,1020.0,865.0613586559533,346.23593864134403,346.72315558802046,10
205,Jalen Green,Houston Rockets,SG,265,361,97,196,484.9,35,45,706.3,36,92,374.79999999999995,7,52,59,34,14,9,17,4,124,358,324,299,93,724.50625,114.15625,10.425,38.625,1165.6,1168.425,710.15625,136.10625,10
206,Jalen HoodSchifino,Los Angeles Lakers,G,5,11,1,6,33.3,2,4,100.0,1,3,50.0,0,2,2,0,1,0,1,0,-13,7,7,5,2,9.0,0.9799999999999999,0.020000000000000004,0.8200000000000001,13.32,14.180000000000001,8.42,0.72,2
207,Jalen Johnson,Atlanta Hawks,SF,178,339,71,149,485.0,19,29,568.3,17,46,399.9,13,75,88,44,19,7,16,11,35,310,266,222,132,525.5086505190311,92.60899653979239,50.449826989619375,14.681660899653977,1018.8442906574395,708.3044982698963,776.0,203.10726643598616,10
208,Jalen McDaniels,Toronto Raptors,PF,41,132,18,44,312.0,2,4,66.7,3,15,116.7,6,20,26,11,13,7,13,1,-46,78,67,52,37,167.37414965986395,87.35374149659863,12.210884353741497,4.326530612244898,410.61224489795916,338.98639455782313,209.2312925170068,129.33333333333331,9
209,Jalen Pickett,Denver Nuggets,G,2,7,1,3,33.3,0,0,0.0,0,2,0.0,0,0,0,2,0,0,0,0,-1,4,2,4,2,2.25,0.0,1.3611111111111107,0.0,7.1111111111111125,2.25,7.1111111111111125,1.3611111111111107,1
210,Jalen Slawson,Sacramento Kings,F,2,8,1,2,50.0,0,0,0.0,0,1,0.0,1,1,2,0,2,1,0,0,3,4,4,2,2,0.44444444444444453,0.11111111111111106,0.0,0.0,1.0,1.0,0.44444444444444453,0.11111111111111106,1
211,Jalen Smith,Indiana Pacers,PF,99,174,36,64,576.2,16,26,515.0,11,29,411.9,23,36,59,11,19,1,6,5,10,169,158,110,70,99.67602040816327,43.48979591836735,17.0,9.03061224489796,110.67602040816328,86.31887755102042,130.31887755102042,54.204081632653065,10
212,Jalen Suggs,Orlando Magic,SG,136,260,48,87,560.1,15,19,583.3,25,53,467.9,4,26,30,29,28,15,17,5,151,195,166,165,59,249.65570934256056,30.70069204152249,15.835640138408307,22.923875432525953,325.30276816609,271.3771626297578,283.2006920415225,66.91695501730104,10
213,Jalen Williams,Oklahoma City Thunder,F,196,293,77,146,514.9,29,32,836.7,13,33,318.2,3,36,39,36,21,16,19,10,49,271,235,232,75,597.2889273356401,27.067474048442907,22.75605536332179,14.5,868.9913494809689,770.4948096885813,675.9515570934255,69.65743944636677,10
214,Jalen Wilson,Brooklyn Nets,F,35,128,13,38,430.5,7,8,350.0,2,15,150.0,13,17,30,10,10,1,9,0,2,75,65,45,40,48.011111111111106,35.6,6.0,2.3111111111111113,122.67777777777778,94.67777777777778,56.011111111111106,61.6,10
215,Jamal Cain,Miami Heat,F,4,16,0,3,0.0,4,4,200.0,0,1,0.0,1,2,3,1,1,1,1,0,-4,8,7,5,4,1.4693877551020411,1.7346938775510201,0.510204081632653,0.0,5.8775510204081645,5.897959183673469,2.2244897959183674,1.4693877551020411,2
216,Jamal Murray,Denver Nuggets,PG,227,360,87,190,450.6,33,39,861.4,20,50,410.0,10,43,53,82,18,16,22,3,51,362,280,309,135,469.5123456790123,47.56944444444444,69.60030864197532,20.123456790123456,652.401234567901,478.6003086419752,617.655864197531,142.82716049382717,10
217,James Bouknight,Charlotte Hornets,SG,10,13,4,10,83.3,0,0,0.0,2,7,58.3,0,0,0,0,0,1,1,0,13,10,10,10,0,18.0,0.0,0.0,0.72,18.0,18.0,18.0,0.0,2
218,James Harden,LA Clippers,SG,164,347,51,122,406.0,34,38,941.7,28,75,344.5,5,46,51,94,17,7,27,10,17,309,215,258,145,568.4,51.12244897959184,42.236734693877544,37.6734693877551,534.9183673469388,548.7224489795918,541.4367346938776,106.51836734693877,10
219,James Johnson,Indiana Pacers,PF,2,7,0,1,0.0,2,2,100.0,0,0,0.0,0,0,0,1,3,0,0,1,1,3,2,3,1,2.5600000000000005,0.0,0.6400000000000001,0.0,5.76,2.5600000000000005,5.76,0.6400000000000001,1
220,James Wiseman,Detroit Pistons,C,103,204,43,68,580.9,17,20,600.0,0,0,0.0,26,51,77,17,23,2,13,8,-40,197,180,120,94,385.01903114186854,86.21626297577853,19.108996539792386,0.0,838.7560553633218,633.7301038062285,547.9792387543253,147.39100346020763,10
221,Jamie Jr. Jaquez,Miami Heat,G,10,45,4,12,74.3,1,1,100.0,1,6,20.0,0,1,1,5,5,0,1,0,-22,16,11,15,6,8.88888888888889,0.5555555555555556,0.5555555555555555,0.5555555555555556,8.888888888888888,13.888888888888888,5.0,0.0,2
222,Jarace Walker,Indiana Pacers,F,26,101,9,29,232.2,2,2,100.0,6,17,200.0,3,20,23,8,9,4,5,6,19,57,49,34,31,105.35734072022161,47.24376731301938,32.681440443213305,6.664819944598337,400.3518005540166,261.1108033240998,181.08033240997227,143.44321329639888,8
223,Jared Butler,Washington Wizards,SG,58,166,25,58,503.5,5,5,300.0,3,17,83.4,3,12,15,35,14,6,17,1,-28,108,73,93,50,171.55102040816325,19.316326530612248,76.04336734693878,4.186224489795919,502.625,219.27551020408163,399.65561224489795,150.6045918367347,10
224,Jared Rhoden,Detroit Pistons,G,11,30,5,7,130.0,0,0,0.0,1,2,50.0,0,6,6,1,2,1,3,2,-5,18,17,12,7,27.222222222222225,8.88888888888889,0.5555555555555556,0.5555555555555556,55.55555555555555,67.22222222222223,20.0,5.0,2
225,Jaren Jackson Jr.,Memphis Grizzlies,PF,244,342,85,195,435.7,56,75,738.9,18,53,347.2,16,46,62,29,37,17,31,18,-85,335,306,273,91,352.87603305785126,145.86593204775025,39.8852157943067,9.603305785123966,669.9586776859505,735.0394857667584,356.48025711662075,117.06611570247934,10
226,Jarred Vanderbilt,Los Angeles Lakers,PF,68,142,26,42,412.7,13,17,375.0,3,5,166.7,12,22,34,12,8,16,11,2,23,114,102,80,46,111.33333333333334,59.333333333333336,18.0,3.5,362.0,274.0,157.33333333333334,119.33333333333334,6
227,Jarrett Allen,Cleveland Cavaliers,C,192,349,71,119,605.4,50,63,813.8,0,0,0.0,30,97,127,23,12,4,13,13,-17,342,319,215,150,392.9708506841166,209.07376561570493,18.509815585960737,0.0,1106.0,974.80249851279,451.7566924449733,299.99524092801903,10
228,Jason Preston,Utah Jazz,G,4,25,2,6,66.6,0,0,0.0,0,0,0.0,2,4,6,7,1,0,1,0,10,17,10,11,13,1.020408163265306,3.724489795918367,7.112244897959184,0.0,28.020408163265305,7.3979591836734695,11.39795918367347,21.081632653061224,2
229,Javon Freeman-Liberty,Toronto Raptors,G,38,116,12,30,213.8,12,13,480.0,2,12,83.3,2,17,19,11,9,1,5,2,-19,68,57,49,30,145.375,12.5859375,6.3984375,1.59375,254.0,215.6484375,174.3359375,28.375,6
230,Jaxson Hayes,Los Angeles Lakers,C,55,144,21,28,743.4,13,20,475.0,0,1,0.0,14,33,47,3,17,2,9,4,-2,105,102,58,50,51.61111111111111,86.21141975308642,4.179012345679013,0.0,149.2854938271605,145.52623456790124,49.382716049382715,96.37808641975309,10
231,Jay Huff,Denver Nuggets,C,3,5,1,2,50.0,0,0,0.0,1,2,50.0,0,0,0,0,2,0,0,0,-3,3,3,3,0,3.0625,0.5625,0.0,0.5625,1.0,1.0,3.0625,0.5625,1
232,Jaylen Brown,Boston Celtics,SG,292,331,113,215,524.8,37,57,675.9,29,71,410.0,18,42,60,32,24,15,15,0,118,384,352,324,92,547.6999999999998,103.34444444444443,19.61111111111111,18.91111111111111,819.2999999999997,804.9777777777779,539.7777777777778,145.2,10
233,Jaylin Williams,Oklahoma City Thunder,F,39,129,14,31,408.3,2,3,150.0,9,21,424.9,5,30,35,11,13,4,3,5,56,85,74,50,46,55.22405876951332,60.0119375573921,10.900826446280991,3.1983471074380163,228.35537190082647,196.0,74.44444444444444,84.04775022956841,10
234,Jayson Tatum,Boston Celtics,SF,280,350,92,196,478.9,55,63,870.0,41,82,508.9,9,59,68,50,20,10,26,5,130,398,348,330,118,312.625,89.4765625,47.9140625,15.556640625,330.40625,480.5390625,210.7265625,89.15625,10
235,Jeenathan Williams,Houston Rockets,G,8,17,4,7,66.7,0,2,0.0,0,0,0.0,2,1,3,0,4,0,0,0,17,11,11,8,3,42.376543209876544,2.2839506172839505,0.05555555555555555,0.0,59.172839506172835,61.26543209876543,40.913580246913575,1.7098765432098761,2
236,Jeff Dowtin,Philadelphia 76ers,G,28,69,10,16,203.8,2,2,100.0,6,11,183.4,1,5,6,13,0,4,3,1,23,47,34,41,19,152.0,7.25,33.25,5.25,396.0,207.25,313.25,68.0,5
237,Jeff Green,Houston Rockets,PF,59,154,21,49,365.6,7,12,275.0,10,24,425.0,4,16,20,8,8,3,4,4,-16,87,79,67,28,207.46952908587258,42.001385041551245,7.746537396121883,8.006925207756233,371.11495844875344,382.72299168975064,208.77839335180056,36.83102493074792,10
238,Jerami Grant,Portland Trail Blazers,SF,169,342,56,142,386.6,38,46,711.3,19,49,402.0,6,19,25,35,18,14,28,2,-77,229,194,204,60,473.98961937716257,45.9204152249135,32.71626297577855,5.083044982698962,888.6262975778548,739.6678200692041,583.0934256055364,118.49134948096886,10
239,Jeremiah Robinson-Earl,New Orleans Pelicans,F,28,87,11,24,269.6,4,7,80.0,2,9,100.0,9,9,18,10,6,3,2,1,30,56,46,38,28,61.70247933884297,33.68595041322314,27.89876033057851,1.5041322314049586,204.16322314049586,139.05785123966942,101.94834710743802,86.44421487603306,7
240,Jeremy Sochan,San Antonio Spurs,F,128,319,50,122,407.3,18,23,583.4,10,39,216.6,23,56,79,37,27,9,23,11,11,244,207,165,116,325.19395134779745,23.01051939513478,32.30177514792899,10.0,220.54437869822482,245.86390532544377,279.48783694937543,75.69888231426694,10
241,Jericho Sims,New York Knicks,C,27,187,11,14,466.7,5,8,113.3,0,0,0.0,19,33,52,11,14,5,7,6,5,90,79,38,63,113.8989298454221,64.14030915576696,13.466111771700358,0.0,329.16052318668255,247.0784780023781,183.9833531510107,89.6040428061831,10
242,Jerome Robinson,Golden State Warriors,SG,10,17,4,10,40.0,1,2,50.0,1,6,16.7,0,0,0,1,1,0,0,1,-2,11,10,11,1,61.5621301775148,0.21301775147928997,0.4792899408284023,0.7159763313609467,65.23668639053254,54.53254437869823,72.90532544378698,0.053254437869822466,1
243,Jett Howard,Orlando Magic,G,0,5,0,1,0.0,0,0,0.0,0,1,0.0,0,0,0,0,1,0,0,0,-5,0,0,0,0,0.25,0.0,0.0,0.027777777777777776,0.25,0.25,0.25,0.0,1
244,Jevon Carter,Chicago Bulls,PG,41,150,17,38,405.20000000000005,1,2,50.0,6,19,191.7,2,9,11,13,9,4,4,2,5,65,52,54,24,163.53979238754326,11.697231833910035,8.29930795847751,6.7768166089965405,241.07612456747407,204.46539792387543,185.95328719723184,34.19377162629758,10
245,Jimmy Butler,Miami Heat,SF,217,364,76,155,485.8,56,67,815.0,9,29,308.3,15,35,50,50,13,14,17,3,27,317,267,267,100,514.4540466392318,44.68861454046639,40.054869684499316,9.515775034293553,727.716049382716,510.17421124828525,703.2277091906722,113.51165980795612,10
246,Jock Landale,Houston Rockets,C,77,175,29,50,519.6,16,18,450.0,3,7,250.0,22,24,46,19,19,3,6,13,41,142,123,96,65,248.103515625,95.056640625,42.759765625,2.40625,734.072265625,516.6640625,406.1015625,197.2265625,10
247,Joe Harris,Detroit Pistons,SF,2,12,1,3,33.3,0,0,0.0,0,1,0.0,0,0,0,0,1,0,0,0,-5,2,2,2,0,0.0,0.0,0.0,0.0,0.0,0.0,0.0,0.0,1
248,Joe Ingles,Orlando Magic,SG,33,162,10,20,355.0,5,6,250.0,8,17,325.0,1,14,15,29,12,8,11,0,23,77,48,62,44,112.96785975164353,11.159240321402484,47.40321402483565,9.81300219138057,167.16946676406135,120.63988312636961,151.6493791088386,66.41051862673484,10
249,Joel Embiid,Philadelphia 76ers,C,45,61,16,38,82.8,9,12,170.0,4,10,83.3,2,12,14,5,6,2,10,0,-41,64,59,50,19,144.5,0.0,0.5,0.0,162.0,144.5,162.0,0.5,2
250,John Collins,Utah Jazz,PF,158,293,61,112,534.6,24,32,754.2,12,29,388.9,24,64,88,10,32,3,17,13,-37,256,246,168,98,292.625,114.0,10.069444444444445,7.896604938271604,557.1111111111111,545.625,295.77777777777777,132.40277777777777,10
251,John Konchar,Memphis Grizzlies,SG,57,299,19,46,385.8,8,9,266.7,11,29,391.6,19,45,64,29,20,13,17,9,-3,150,121,86,93,132.76479181884588,70.43535427319212,15.061358655953251,7.452885317750182,294.93791088385683,226.21402483564646,168.53761869978086,118.44777209642075,10
252,Johnny Davis,Washington Wizards,G,33,133,12,35,333.3,5,6,250.0,4,13,183.3,4,12,16,7,13,2,1,4,-42,56,49,40,23,78.57925493060628,14.435354273192111,8.222790357925494,4.64572680788897,156.6807888970051,121.67494521548576,116.11687363038715,20.126369612856102,10
253,Johnny Juzang,Utah Jazz,G,50,121,19,39,276.9,0,0,0.0,12,28,219.2,2,13,15,3,9,0,4,0,3,68,65,53,18,260.92063492063494,18.92063492063492,2.285714285714286,22.444444444444443,338.44444444444446,352.53968253968253,245.3015873015873,22.730158730158728,7
254,Jonas Valanciunas,New Orleans Pelicans,C,70,191,29,57,536.3,8,8,400.0,4,12,250.0,14,62,76,17,23,2,14,7,47,163,146,87,93,138.2097505668934,52.48185941043084,20.519274376417236,4.662131519274376,271.4444444444444,265.8367346938775,173.84693877551018,42.971655328798185,10
255,Jonathan Isaac,Orlando Magic,PF,90,169,34,55,659.0,8,10,316.7,14,23,568.3,15,35,50,5,5,7,4,13,53,145,140,95,55,96.54444444444445,36.84444444444444,4.677777777777777,12.9,168.11111111111114,196.67777777777778,77.40000000000002,32.1,10
256,Jonathan Kuminga,Golden State Warriors,PF,196,289,75,149,492.1,36,43,690.0,10,24,350.1,7,37,44,23,29,11,20,5,-23,263,240,219,67,430.92561983471074,70.61157024793388,12.554752066115702,10.25309917355372,523.3564049586777,494.694214876033,464.54648760330576,78.20764462809917,10
257,Jontay Porter,Toronto Raptors,C,49,159,18,41,352.3,4,6,150.0,9,26,230.4,10,23,33,32,11,10,13,9,-28,114,82,81,65,223.44444444444443,32.35069444444444,61.934027777777786,16.18402777777778,495.1111111111111,281.4340277777777,412.40625,119.0,10
258,Jordan Clarkson,Utah Jazz,PG,174,327,64,151,396.6,29,32,757.9,17,59,244.1,7,28,35,60,19,10,22,0,-76,269,209,234,95,814.0,107.44444444444446,81.07029478458051,20.83673469387755,1289.530612244898,1206.7777777777778,873.736961451247,211.53061224489798,10
259,Jordan Goodwin,Memphis Grizzlies,G,71,257,29,86,350.5,5,12,225.0,8,31,229.89999999999998,13,33,46,42,16,16,17,10,-68,159,117,113,88,114.5,127.45679012345678,76.2777777777778,3.6604938271604937,413.8641975308642,275.2901234567901,120.7777777777778,336.0308641975309,10
260,Jordan Hawkins,New Orleans Pelicans,G,48,123,17,56,371.5,4,5,150.0,10,37,210.0,2,12,14,6,8,1,2,2,4,68,62,54,20,164.33293697978596,16.48038049940547,6.430439952437575,10.760998810939359,241.18192627824016,208.58977407847803,199.82401902497028,20.011890606420923,10
261,Jordan McLaughlin,Minnesota Timberwolves,PG,59,159,20,32,561.1,4,4,200.0,15,24,369.4,3,19,22,27,9,7,4,2,64,108,81,86,49,200.00219138056977,28.911614317019723,21.930606281957633,29.159240321402486,279.0474799123448,262.22425127830536,213.1424397370343,54.525200876552226,10
262,Jordan Miller,LA Clippers,G,4,5,1,1,100.0,2,2,100.0,0,0,0.0,0,1,1,0,0,0,0,0,3,5,5,4,1,9.679012345679013,0.44444444444444453,0.0,0.0,14.271604938271604,14.271604938271604,9.679012345679013,0.44444444444444453,1
263,Jordan Nwora,Toronto Raptors,SF,104,181,43,86,501.70000000000005,7,8,366.7,11,37,301.6,5,37,42,8,9,9,14,4,-45,154,146,112,50,226.73048907388136,45.694068678459935,5.706555671175858,7.0,258.23517169614985,283.098855359001,196.67845993756504,56.58896982310094,10
264,Jordan Poole,Washington Wizards,SG,185,287,68,150,435.9,19,21,630.0,30,77,386.6,5,22,27,42,27,11,28,5,-84,254,212,227,69,777.095041322314,28.140495867768596,45.61673553719008,23.01239669421488,611.9555785123966,697.9710743801653,683.8274793388429,81.00929752066116,10
265,Jordan Walsh,Boston Celtics,G,2,27,1,4,100.0,0,0,0.0,0,2,0.0,2,4,6,1,5,2,2,1,24,9,8,3,7,2.617283950617284,11.555555555555554,1.2469135802469138,0.0,0.5555555555555558,3.2098765432098766,7.222222222222222,5.5432098765432105,2
266,Jose Alvarado,New Orleans Pelicans,PG,68,218,24,59,386.2,5,8,250.0,15,32,467.1,3,19,22,25,18,11,9,0,58,115,90,93,47,182.3490304709141,33.74653739612188,45.8573407202216,12.610803324099724,468.3240997229917,319.5581717451523,292.2229916897507,118.49584487534628,10
267,Josh Giddey,Oklahoma City Thunder,SG,130,239,57,108,538.3000000000001,4,4,300.0,12,35,386.9,16,44,60,46,18,7,19,6,75,236,190,176,106,189.5134779750164,102.00657462195925,37.58053911900066,1.8211702827087441,333.9631821170282,252.4010519395135,214.89940828402368,195.76331360946747,10
268,Josh Green,Dallas Mavericks,SG,67,259,28,55,498.7,4,5,80.0,7,23,270.0,11,24,35,13,16,11,9,2,-34,115,102,80,48,175.42568370986916,41.573127229488705,10.20332936979786,7.416171224732463,227.9346016646849,241.15576694411413,176.20927467300828,37.77170035671819,10
269,Josh Hart,New York Knicks,SG,109,414,44,110,387.7,10,14,308.3,11,45,183.9,21,96,117,53,26,12,17,6,46,279,226,162,170,293.53063652587747,241.0095181439619,126.11005353955979,17.770969660916123,1278.3265913146936,746.7864366448542,634.672218917311,557.5181439619274,10
270,Josh Minott,Minnesota Timberwolves,F,0,5,0,0,0.0,0,0,0.0,0,0,0.0,0,4,4,0,0,0,0,0,6,4,4,0,4,5.224489795918367,10.331632653061225,0.02040816326530612,0.18367346938775508,0.6173469387755101,0.8622448979591834,5.897959183673469,9.433673469387754,1
271,Josh Okogie,Phoenix Suns,SF,46,141,15,32,423.8,10,11,350.0,6,14,300.0,16,6,22,10,4,8,10,2,6,78,68,56,32,116.44982698961938,13.598615916955017,8.13840830449827,6.422145328719724,170.26989619377161,161.01730103806227,120.75432525951557,26.685121107266436,10
272,Josh Richardson,Miami Heat,SG,98,211,38,76,433.2,6,6,200.0,16,45,301.7,4,26,30,19,16,5,3,2,3,147,128,117,49,296.8888888888889,20.0,10.88888888888889,27.555555555555557,468.0,427.55555555555554,344.0,24.22222222222222,9
273,Joshua Primo,LA Clippers,G,0,5,0,1,0.0,0,0,0.0,0,0,0.0,1,0,1,0,0,0,1,0,1,1,1,0,1,0.0,0.0,0.0,0.0,0.0,0.0,0.0,0.0,1
274,Jrue Holiday,Boston Celtics,PG,114,323,45,81,564.5,4,4,200.0,20,44,531.8,8,25,33,55,13,14,17,11,120,202,147,169,88,82.40532544378698,48.251479289940825,52.514792899408285,6.014792899408284,209.71597633136096,168.31360946745562,164.9023668639053,59.6715976331361,10
275,Jules Bernard,Washington Wizards,G,37,62,14,27,346.2,3,5,200.0,6,11,285.0,6,5,11,9,3,1,3,1,21,57,48,46,20,155.4555765595463,10.43100189035917,11.466918714555764,4.863894139886579,243.6181474480151,191.01323251417767,208.54820415879018,21.410207939508506,5
276,Julian Champagnie,San Antonio Spurs,F,63,221,17,48,272.0,13,15,500.0,16,40,285.8,2,21,23,13,7,5,8,4,21,99,86,76,36,270.29501385041556,31.3808864265928,18.117728531855956,27.718836565096954,603.4529085872576,429.3961218836565,403.85041551246536,90.0,10
277,Julian Phillips,Chicago Bulls,F,39,132,13,31,272.9,7,8,266.7,6,13,283.4,6,12,18,5,12,5,3,1,-11,62,57,44,23,170.91975308641975,27.290123456790123,6.777777777777779,6.401234567901234,314.4444444444444,289.44444444444446,184.5493827160494,45.43827160493827,10
278,Julian Strawther,Denver Nuggets,G,9,27,3,11,37.5,2,2,100.0,1,8,20.0,0,3,3,4,1,1,2,0,-15,16,12,13,7,37.0,7.512396694214877,4.231404958677686,0.8347107438016528,108.4297520661157,76.69421487603304,61.59504132231405,18.884297520661153,2
279,Julius Randle,New York Knicks,PF,66,99,23,48,142.2,14,14,300.0,6,11,195.0,8,17,25,18,7,1,10,0,25,109,91,84,43,98.0,2.666666666666667,14.0,2.0,140.66666666666669,120.66666666666666,126.0,8.666666666666668,3
280,Justin Champagnie,Washington Wizards,SF,45,114,15,38,184.3,8,8,200.0,7,22,133.3,11,14,25,8,7,6,8,4,-45,78,70,53,33,256.5416666666667,76.09375,5.34375,9.208333333333334,668.0416666666666,596.6770833333333,300.34375,109.0,6
281,Justin Holiday,Denver Nuggets,SF,45,155,17,34,413.70000000000005,0,0,0.0,11,25,326.7,0,13,13,19,13,3,1,3,23,77,58,64,32,224.61248852157945,10.17722681359045,43.46097337006427,14.904499540863178,394.4802571166208,267.60330578512395,328.0,77.12764003673095,10
282,Justin Minaya,Portland Trail Blazers,F,12,94,4,17,149.89999999999998,1,2,50.0,3,14,116.6,6,9,15,4,5,3,3,2,-37,31,27,16,19,20.0032,15.8832,2.3872,1.8768,41.70720000000001,49.0,14.4608,16.520000000000003,8
283,Jusuf Nurkic,Phoenix Suns,C,94,290,40,74,572.1,14,32,355.4,0,2,0.0,48,100,148,38,35,5,33,11,10,280,242,132,186,64.6281957633309,574.4937910883858,38.115412710007305,0.0,854.8619430241052,832.953981008035,77.92695398100803,621.218407596786,10
284,Karl-Anthony Towns,Minnesota Timberwolves,C,193,306,66,146,451.8,41,47,734.2,20,56,341.5,20,55,75,29,33,8,24,8,98,297,268,222,104,265.0493827160493,98.62345679012346,46.91975308641975,18.771604938271604,548.530864197531,414.4012345679012,362.2777777777778,182.44444444444443,10
285,Kawhi Leonard,LA Clippers,SF,225,331,85,162,529.5,41,48,794.2,14,42,319.1,9,41,50,31,6,14,17,8,49,306,275,256,81,522.274241522903,43.71921475312315,28.904818560380726,8.24271267102915,680.9649018441405,638.2302201070792,542.8268887566924,94.80606781677574,10
286,Keegan Murray,Sacramento Kings,SF,122,352,45,111,393.4,18,21,425.0,14,56,242.6,16,44,60,17,27,10,8,11,32,199,182,139,77,218.0,80.20408163265306,18.11451247165533,19.54308390022676,504.5226757369614,428.4897959183673,263.92403628117916,128.42743764172337,10
287,Keita Bates-Diop,Brooklyn Nets,SF,35,85,12,20,615.0,6,6,300.0,5,11,350.0,3,10,13,5,1,2,5,4,-13,53,48,40,18,44.43758573388203,16.2318244170096,4.530864197530864,5.271604938271604,78.05075445816186,74.17832647462278,41.182441700960226,27.890260631001368,10
288,Keldon Johnson,San Antonio Spurs,SF,160,299,57,120,466.1,19,23,500.0,27,67,383.1,17,41,58,19,17,2,9,1,-26,237,218,179,77,322.41632653061225,60.775510204081634,15.359183673469385,22.89387755102041,358.4040816326532,400.75102040816324,317.0,39.20408163265306,10
289,Kelly Olynyk,Toronto Raptors,PF,131,283,51,92,518.7,17,24,415.7,12,30,408.3,16,38,54,45,39,13,32,10,-108,230,185,176,99,357.93061224489793,28.759183673469384,59.00816326530611,8.775510204081632,631.6653061224489,479.4,491.6734693877551,106.28979591836736,10
290,Kelly Oubre Jr.,Philadelphia 76ers,SG,202,343,73,179,407.2,41,55,634.5,15,53,258.5,19,43,62,22,25,12,22,10,-42,286,264,224,84,333.82499999999993,63.825,18.825,9.725000000000001,585.625,451.29999999999995,432.4000000000001,118.39999999999999,10
291,Kendall Brown,Indiana Pacers,SG,0,7,0,0,0.0,0,0,0.0,0,0,0.0,0,0,0,0,0,0,0,0,4,0,0,0,0,1.9171597633136093,0.09467455621301776,0.4792899408284023,0.0,5.686390532544379,2.863905325443787,4.313609467455622,1.0,1
292,Kenneth Lofton Jr.,Philadelphia 76ers,F,2,5,1,4,25.0,0,0,0.0,0,2,0.0,0,1,1,0,0,0,0,0,-4,3,3,2,1,0.0,0.0,0.0,0.0,0.0,0.0,0.0,0.0,1
293,Kenrich Williams,Oklahoma City Thunder,SF,30,119,12,29,253.10000000000002,0,0,0.0,6,18,216.7,12,23,35,14,10,7,3,1,39,79,65,44,49,164.76989619377161,43.622837370242216,14.783737024221455,7.773356401384082,278.4532871972318,242.28546712802768,179.48096885813152,79.86332179930795,10
294,Kentavious Caldwell-Pope,Denver Nuggets,SG,94,327,34,71,472.9,7,7,300.0,19,44,408.3,2,21,23,25,22,16,11,11,40,142,117,119,48,177.72318339100346,20.112456747404842,19.745674740484432,14.064013840830452,170.90657439446366,213.84256055363323,133.53806228373702,41.107266435986155,10
295,Kenyon Martin Jr.,Philadelphia 76ers,F,47,157,18,35,506.1,8,12,400.0,3,5,250.0,11,28,39,11,27,4,5,3,-16,97,86,58,50,113.27146814404432,141.62049861495845,10.90443213296399,2.117728531855956,566.8490304709142,463.2686980609418,174.53878116343492,194.83795013850417,10
296,Keon Ellis,Sacramento Kings,G,57,232,22,43,470.8,1,2,50.0,12,27,360.0,7,20,27,17,25,21,5,9,92,101,84,74,44,165.4334251606979,30.239669421487605,47.44444444444445,11.794306703397613,190.48025711662075,218.1469237832874,134.43342516069788,81.01744719926539,10
297,Keon Johnson,Brooklyn Nets,G,12,26,3,8,73.3,4,4,100.0,2,4,133.3,2,1,3,2,2,2,2,0,-9,17,15,14,5,18.88888888888889,0.5555555555555556,2.2222222222222223,0.22222222222222227,27.222222222222225,13.888888888888888,34.0,1.0,2
298,Kessler Edwards,Sacramento Kings,SF,24,67,9,21,206.7,1,2,50.0,5,14,211.7,2,12,14,4,8,4,1,1,21,42,38,28,18,79.4375,18.03571428571429,2.1517857142857144,4.321428571428571,116.89285714285715,104.79464285714286,82.28571428571429,29.4375,7
299,Kevin Durant,Phoenix Suns,PF,257,369,96,196,476.1,42,48,773.1,23,60,376.2,3,60,63,37,15,8,36,12,-4,357,320,294,100,1294.4556213017752,65.3905325443787,37.51545036160421,18.651545036160424,1683.4247205785668,1470.4023668639054,1413.111111111111,197.27284681130834,10
300,Kevin Huerter,Sacramento Kings,SG,72,231,29,79,330.1,2,4,100.0,12,45,205.0,6,24,30,25,23,8,11,2,5,127,102,97,55,287.75259515570934,30.70069204152249,4.716262975778547,16.048442906574394,456.93079584775086,441.79930795847747,290.10553633217995,48.19550173010381,10
301,Kevin Knox II,Detroit Pistons,SF,22,89,9,26,148.9,3,3,200.0,1,11,33.3,3,11,14,4,9,2,6,0,21,40,36,26,18,115.33333333333334,19.333333333333336,3.3333333333333335,0.8333333333333335,167.33333333333331,188.0,101.33333333333334,16.0,6
302,Kevin Love,Miami Heat,PF,88,158,30,62,483.6,10,14,208.3,18,45,387.4,10,55,65,19,20,3,10,3,31,172,153,107,84,362.530612244898,61.03061224489795,13.244897959183673,16.97959183673469,574.7448979591837,534.5,405.0,72.05102040816325,10
303,Kevon Looney,Golden State Warriors,F,23,98,10,20,533.3,3,7,75.0,0,0,0.0,6,22,28,10,16,1,6,3,25,61,51,33,38,20.836734693877553,20.543367346938776,4.1147959183673475,0.0,19.60204081632653,22.247448979591837,13.53316326530612,29.316326530612248,10
304,Keyontae Johnson,Oklahoma City Thunder,F,5,39,2,8,66.7,0,0,0.0,1,2,100.0,2,4,6,2,4,0,2,0,-15,13,11,7,8,20.0,7.0,1.2653061224489797,0.8163265306122451,29.69387755102041,35.0,17.26530612244898,5.6938775510204085,5
305,Keyonte George,Utah Jazz,G,190,309,64,148,387.9,39,43,792.5,23,66,317.4,0,33,33,48,12,5,35,2,-96,271,223,238,81,871.0827474310439,30.145484045429964,61.821525148729044,45.46727961060033,1215.3147647376961,950.616008653326,1144.3807463493781,83.36776636019471,10
306,Khris Middleton,Milwaukee Bucks,SF,130,231,50,96,440.3,16,19,417.5,14,33,393.3,8,31,39,45,29,8,17,3,18,214,169,175,84,299.1022222222222,37.480000000000004,47.43555555555555,3.6088888888888886,490.4800000000001,335.2755555555556,463.0,76.22222222222221,8
307,Killian Hayes,Detroit Pistons,PG,18,79,7,14,209.6,1,3,33.3,3,6,100.0,0,15,15,20,4,0,5,2,-12,53,33,38,35,27.0,18.75,54.0,2.75,252.75,74.75,153.0,124.75,4
308,Kira Lewis Jr.,Utah Jazz,PG,0,14,0,2,0.0,0,0,0.0,0,0,0.0,0,0,0,3,1,0,0,0,-10,3,0,3,3,4.678200692041522,0.17301038062283738,4.709342560553633,0.0,9.0,6.650519031141868,7.408304498269898,4.501730103806229,2
309,Klay Thompson,Golden State Warriors,SG,181,257,64,145,451.2,16,18,616.7,37,88,409.1,4,19,23,25,10,8,10,3,-14,229,204,206,48,536.9444444444445,19.75736961451247,45.1859410430839,22.219954648526077,581.6111111111111,510.90816326530614,611.4795918367347,61.111111111111114,10
310,Kobe Brown,LA Clippers,G,2,27,1,5,100.0,0,0,0.0,0,2,0.0,4,5,9,2,4,0,3,0,-23,13,11,4,11,3.140625,11.75,1.5625,0.015625,19.765625,12.140625,3.265625,20.8125,4
311,Kobe Bufkin,Atlanta Hawks,G,27,81,11,31,158.4,1,2,50.0,4,14,115.0,1,10,11,14,6,3,4,1,21,52,38,41,25,72.63265306122449,3.9795918367346945,14.959183673469388,2.836734693877551,134.6326530612245,95.83673469387756,113.83673469387753,16.53061224489796,5
312,Kris Dunn,Utah Jazz,G,49,222,21,49,368.1,0,0,0.0,7,21,275.0,8,16,24,34,28,10,9,3,-37,107,73,83,58,111.0,19.025,19.15625,6.60625,256.40625,147.325,193.90624999999997,64.35625,10
313,Kris Murray,Portland Trail Blazers,F,98,288,38,80,497.8,10,16,358.4,12,37,303.3,13,37,50,24,23,8,13,6,-16,172,148,122,74,387.4741225461035,72.5901249256395,35.12433075550268,12.218917311124331,687.3123140987507,570.1963117192148,420.9149315883403,191.3896490184414,10
314,Kristaps Porzingis,Boston Celtics,C,202,280,69,148,483.70000000000005,38,41,833.3,26,63,441.1,19,48,67,18,24,9,10,14,118,287,269,220,85,136.15625,102.23611111111111,9.777777777777777,18.90625,427.90625,390.0173611111111,178.9340277777778,107.125,10
315,Kyle Anderson,Minnesota Timberwolves,SF,78,267,32,71,418.5,12,16,500.0,2,6,100.0,10,29,39,51,21,10,9,6,50,168,117,129,90,111.54503616042078,19.8310322156476,26.907955292570676,1.6094674556213018,201.71597633136096,160.284681130835,128.60420775805392,71.11111111111111,10
316,Kyle Kuzma,Washington Wizards,SF,249,344,93,178,535.3,43,53,855.3,20,52,308.3,5,60,65,47,21,9,28,9,-55,361,314,296,112,427.71107266435985,41.54671280276816,53.85813148788927,29.046712802768162,644.1055363321798,555.4065743944636,504.5,107.31487889273357,10
317,Kyle Lowry,Philadelphia 76ers,PG,81,300,25,71,326.3,16,19,575.0,15,45,305.4,3,27,30,46,19,11,12,3,-42,157,111,127,76,185.32647462277092,17.371742112482853,65.32235939643347,12.530864197530864,151.22770919067216,202.34705075445817,112.4567901234568,104.44444444444444,10
318,Kyrie Irving,Dallas Mavericks,PG,236,353,91,187,486.9,27,27,700.0,27,75,344.0,9,44,53,58,17,14,21,4,16,347,289,294,111,397.5510204081633,30.999999999999996,115.43673469387755,20.2,840.2000000000002,479.97959183673464,726.0,178.20816326530613,10
319,LaMelo Ball,Charlotte Hornets,PG,32,55,12,37,66.1,5,6,150.0,3,17,34.7,1,5,6,15,10,3,7,0,-49,53,38,47,21,2.0,2.0,0.5,0.5,4.5,8.0,0.5,0.5,2
320,Lamar Stevens,Memphis Grizzlies,PF,111,215,46,97,495.5,13,18,333.3,6,15,425.0,12,32,44,7,18,7,12,7,-20,162,155,118,51,211.0,48.44444444444444,6.111111111111112,2.4444444444444446,334.9777777777778,267.17777777777775,274.44444444444446,58.91111111111111,10
321,Landry Shamet,Washington Wizards,SG,55,184,20,55,273.1,7,7,300.0,8,35,104.1,4,10,14,8,12,4,9,2,-68,77,69,63,22,330.90000000000003,22.5,5.700000000000001,15.624999999999998,463.7,413.80000000000007,373.0,35.99999999999999,10
322,Larry Nance Jr.,New Orleans Pelicans,PF,64,224,26,40,630.3,10,12,333.4,2,5,133.3,16,35,51,22,13,11,5,3,42,137,115,86,73,177.10153396639885,68.84075967859752,7.649379108838568,1.754565376186998,288.70489408327245,318.80861943024104,172.77867056245435,50.709276844411974,10
323,Lauri Markkanen,Utah Jazz,PF,199,339,64,166,388.6,45,48,856.7,26,78,325.2,18,51,69,23,13,10,17,4,-79,291,268,222,92,189.81360946745562,139.801775147929,51.0,24.437869822485208,597.9822485207101,405.4437869822485,356.73668639053255,216.4171597633136,10
324,LeBron James,Los Angeles Lakers,SF,273,363,102,179,567.7,46,58,754.8,23,54,404.9,6,68,74,90,11,9,39,5,41,437,347,363,164,452.23966942148763,76.82460973370064,28.449954086317724,28.17722681359045,395.0,322.17722681359044,552.188246097337,78.1487603305785,10
325,Leaky Black,Charlotte Hornets,F,27,151,8,25,232.1,7,10,275.0,4,10,150.0,5,21,26,13,12,2,3,2,-31,66,53,40,39,88.0,30.96,8.41,8.25,118.49000000000001,84.96000000000001,110.40999999999998,50.49,9
326,Leonard Miller,Minnesota Timberwolves,F,0,5,0,1,0.0,0,0,0.0,0,0,0.0,0,0,0,2,0,0,0,0,8,2,0,2,2,0.04938271604938271,0.308641975308642,0.44444444444444453,0.0,0.01234567901234569,0.6049382716049383,0.19753086419753085,0.01234567901234569,1
327,Lester Quinones,Golden State Warriors,G,58,162,20,53,357.0,9,13,325.0,9,31,250.0,8,18,26,11,17,2,5,0,-34,95,84,69,37,196.17602040816328,18.989795918367346,14.900510204081634,10.900510204081634,258.9183673469388,291.01275510204084,181.3163265306123,16.65561224489796,10
328,Lindy Waters III,Oklahoma City Thunder,F,29,71,10,26,323.3,0,0,0.0,9,20,283.3,3,15,18,4,7,1,3,2,-36,51,47,33,22,112.44628099173553,30.92561983471074,4.066115702479339,12.975206611570247,244.9917355371901,212.6859504132231,132.86776859504133,46.876033057851245,8
329,Lonnie Walker IV,Brooklyn Nets,G,75,160,29,74,383.8,3,4,150.0,14,43,205.7,1,19,20,6,13,2,7,5,11,101,95,81,26,549.0,18.17313019390582,2.986149584487534,32.986149584487535,726.2063711911358,683.1204986149585,586.7229916897508,26.522160664819946,10
330,Luguentz Dort,Oklahoma City Thunder,G,118,284,40,82,507.3,13,13,500.0,25,53,482.70000000000005,8,23,31,18,32,10,9,2,71,167,149,136,49,124.83497698882314,35.01051939513478,15.621301775147929,18.51347797501644,173.59171597633136,139.48520710059174,156.44444444444443,53.12886259040105,10
331,Luka Doncic,Dallas Mavericks,PG,325,376,113,248,454.5,59,73,825.0,40,111,349.1,13,85,98,103,19,13,43,2,44,526,423,428,201,536.6929012345679,62.04475308641976,108.1003086419753,29.111111111111114,682.341049382716,770.1111111111111,407.77777777777777,211.29012345679013,10
332,Luka Garza,Minnesota Timberwolves,C,45,61,16,35,240.8,6,8,200.0,7,20,233.3,8,6,14,1,8,2,3,1,-7,60,59,46,15,15.678638941398866,17.317580340264648,0.9224952741020795,1.2136105860113422,61.47637051039698,57.47258979206049,18.778827977315686,19.14366729678639,5
333,Luka Samanic,Utah Jazz,F,42,107,13,39,288.8,12,14,450.0,4,19,178.3,5,19,24,5,9,1,5,4,-42,71,66,47,29,107.51800554016623,51.78116343490305,4.73961218836565,2.371191135734072,327.3462603878116,283.5983379501385,135.9196675900277,71.86703601108033,9
334,Luke Kennard,Memphis Grizzlies,SG,124,269,39,78,499.6,18,20,571.4,28,59,476.40000000000003,2,23,25,40,10,8,18,0,-65,189,149,164,65,418.7712665406427,7.29867674858223,89.46313799621927,24.192816635160682,601.7599243856333,437.31758034026467,557.0359168241965,122.93950850661625,10
335,Luke Kornet,Boston Celtics,C,61,182,25,41,548.4,11,12,350.0,0,0,0.0,21,25,46,15,10,3,2,13,74,122,107,76,61,250.52433425160697,94.40587695133149,37.93480257116621,0.0,658.0973370064279,533.9256198347107,340.5123966942149,166.52433425160697,10
336,M. Pereira,Memphis Grizzlies,F,2,19,1,5,50.0,0,0,0.0,0,2,0.0,0,3,3,0,2,1,1,0,2,5,5,2,3,2.2222222222222223,5.0,0.0,0.0,0.5555555555555555,0.5555555555555555,2.2222222222222223,5.0,2
337,Malachi Flynn,Detroit Pistons,PG,47,101,16,47,270.0,7,10,275.0,8,23,281.7,0,12,12,12,5,5,6,0,-43,71,59,59,24,138.93827160493828,6.790123456790123,13.160493827160495,6.123456790123456,252.19753086419752,192.66666666666669,191.30864197530863,27.111111111111114,9
338,Malaki Branham,San Antonio Spurs,G,111,217,40,95,383.9,16,18,441.7,15,43,273.7,6,15,21,22,13,4,15,1,-39,154,132,133,43,698.5,18.989197530864196,31.88271604938272,35.0,997.4027777777778,762.3780864197531,916.8271604938273,67.56944444444444,10
339,Malcolm Brogdon,Portland Trail Blazers,PG,102,218,37,83,266.20000000000005,17,19,433.3,11,30,202.89999999999998,7,22,29,40,13,4,17,2,4,171,131,142,69,100.0,28.833333333333336,7.333333333333334,6.833333333333334,113.5,66.83333333333334,151.33333333333331,31.5,6
340,Malik Beasley,Milwaukee Bucks,SG,110,300,39,104,362.8,6,7,250.0,26,79,314.6,4,36,40,13,15,6,7,1,25,163,150,123,53,305.08641975308643,22.27777777777778,10.308641975308642,26.0,244.94444444444443,267.51234567901236,293.0,22.104938271604937,10
341,Malik Monk,Sacramento Kings,SG,191,289,68,151,440.3,36,38,930.0,19,68,283.3,7,33,40,55,29,7,22,2,68,286,231,246,95,362.5,32.06611570247934,42.125,7.480371900826446,616.9638429752066,482.0206611570248,438.625,133.00929752066116,10
342,MarJon Beauchamp,Milwaukee Bucks,F,30,42,10,16,350.0,7,8,175.0,3,7,200.0,2,9,11,1,4,1,3,0,-17,42,41,31,12,58.991735537190095,10.140495867768596,0.8677685950413222,1.8099173553719008,103.32231404958677,93.38016528925618,65.92561983471074,14.016528925619834,6
343,Marcus Morris Sr.,Cleveland Cavaliers,SF,29,62,10,20,144.7,3,4,150.0,6,12,150.0,1,12,13,4,5,0,5,0,-4,46,42,33,17,52.69387755102041,13.816326530612244,4.709183673469387,6.061224489795919,62.75,97.53061224489795,26.137755102040817,10.301020408163264,3
344,Marcus Morris Sr.,Philadelphia 76ers,SF,40,98,16,38,166.7,4,4,200.0,4,13,103.3,0,14,14,3,5,2,6,1,-21,57,54,43,17,86.73469387755102,5.183673469387756,3.6122448979591835,4.938775510204082,127.0,107.18367346938776,104.75510204081633,10.59183673469388,4
345,Marcus Sasser,Detroit Pistons,G,64,205,25,67,370.8,2,2,100.0,12,36,349.6,1,24,25,35,15,6,16,0,-51,124,89,99,60,125.87716262975779,20.923875432525953,45.30276816608996,9.752595155709344,318.51903114186854,223.24048442906573,214.3356401384083,73.04671280276816,10
346,Markelle Fultz,Orlando Magic,PG,69,176,31,69,418.6,7,9,183.3,0,3,0.0,11,18,29,19,13,4,12,2,30,117,98,88,48,209.59105098855358,47.96149843912591,29.104058272632674,0.010405827263267428,316.1175858480749,301.2778355879292,226.4058272632674,75.09053069719043,10
347,Markieff Morris,Dallas Mavericks,PF,5,11,2,3,150.0,0,0,0.0,1,2,50.0,0,2,2,0,0,0,0,0,4,7,7,5,2,0.625,2.5,0.0,0.625,4.625,4.625,0.625,2.5,2
348,Marques Bolden,Charlotte Hornets,C,0,13,0,1,0.0,0,0,0.0,0,0,0.0,0,1,1,0,1,0,1,0,2,1,1,0,1,0.0,0.7551020408163267,0.0,0.0,0.7551020408163267,0.7551020408163267,0.0,0.7551020408163267,2
349,Marvin Bagley III,Washington Wizards,PF,119,262,53,102,492.7,10,14,383.3,3,8,250.0,40,46,86,16,13,7,8,11,-40,221,205,135,102,366.9111111111111,136.0,12.577777777777778,2.2000000000000006,625.0,593.0444444444445,373.0,174.44444444444446,10
350,Mason Jones,Sacramento Kings,G,1,13,0,3,0.0,1,2,50.0,0,2,0.0,1,3,4,4,0,0,0,0,10,9,5,5,8,0.0,0.0,0.0,0.0,0.0,0.0,0.0,0.0,1
351,Mason Plumlee,LA Clippers,C,51,117,17,31,536.6,17,24,466.7,0,0,0.0,12,34,46,11,17,4,9,4,-11,108,97,62,57,61.36686390532545,108.0,13.12886259040105,0.0,251.08349769888233,230.44378698224853,79.39119000657463,123.74424720578567,10
352,Matisse Thybulle,Portland Trail Blazers,SG,75,232,28,57,448.9,6,9,250.0,13,32,368.3,8,23,31,21,15,19,12,8,-28,127,106,96,52,302.47923875432525,37.42906574394464,22.024221453287197,11.0,647.607266435986,487.6280276816608,434.4653979238755,87.44636678200692,10
353,Matt Ryan,New Orleans Pelicans,F,28,60,10,24,233.3,0,0,0.0,8,19,194.4,1,8,9,2,6,0,2,0,-2,39,37,30,11,171.57142857142856,14.321428571428571,1.4285714285714286,16.14285714285714,283.75000000000006,273.46428571428567,181.0,16.607142857142854,7
354,Matthew Hurt,Memphis Grizzlies,F,32,110,12,33,215.9,3,3,200.0,5,19,233.4,9,7,16,4,8,3,2,3,-7,52,48,36,20,156.50661625708887,33.126654064272216,4.8204158790170135,5.156899810964084,340.6502835538753,280.1398865784499,204.4536862003781,50.51039697542533,7
355,Max Christie,Los Angeles Lakers,G,33,110,12,24,569.4,3,5,200.0,6,12,300.0,1,13,14,5,3,0,4,1,-15,52,47,38,19,91.46193771626297,9.164359861591695,2.9238754325259517,4.899653979238755,148.0,129.51211072664358,110.8114186851211,11.226643598615917,10
356,Max Strus,Cleveland Cavaliers,SG,118,312,42,93,422.4,12,15,316.7,22,62,318.5,11,20,31,48,25,6,16,4,-32,197,149,166,79,284.77562326869804,32.988919667590025,26.775623268698062,31.81717451523546,400.2908587257617,331.86426592797784,377.1024930747922,35.86426592797784,10
357,Maxi Kleber,Dallas Mavericks,PF,22,183,6,22,250.0,6,8,300.0,4,18,216.7,2,27,29,15,23,5,1,4,65,66,51,37,44,84.0,35.08725761772853,16.501385041551245,5.36426592797784,146.9432132963989,96.56094182825485,142.606648199446,43.36426592797784,10
358,Maxwell Lewis,Los Angeles Lakers,F,0,5,0,1,0.0,0,0,0.0,0,1,0.0,0,0,0,2,0,0,0,0,-3,2,0,2,2,0.04938271604938271,0.0,1.7777777777777781,0.0,1.234567901234568,0.04938271604938271,1.234567901234568,1.7777777777777781,1
359,Micah Potter,Utah Jazz,C,26,62,9,12,300.0,3,3,200.0,5,7,250.0,2,9,11,2,4,0,2,1,0,39,37,28,13,67.28395061728395,2.8888888888888893,1.2098765432098766,4.061728395061729,74.88888888888889,65.35802469135803,75.55555555555556,5.3580246913580245,5
360,Michael Porter Jr.,Denver Nuggets,SF,207,325,80,133,606.8,14,16,530.0,33,68,498.7,10,54,64,15,16,7,11,5,58,286,271,222,79,388.8261504747991,50.891161431701974,18.5018261504748,17.16946676406136,595.972242512783,572.7384952520088,392.0,89.45288531775017,10
361,Mikal Bridges,Brooklyn Nets,SF,167,352,54,135,387.2,26,32,685.7,33,73,463.7,9,33,42,38,14,10,18,1,-56,247,209,205,80,260.7441998810232,47.800118976799524,35.08506841165973,24.11719214753123,278.3063652587745,290.6632956573468,258.6775728732897,72.59488399762046,10
362,Mike Conley,Minnesota Timberwolves,PG,128,293,45,100,402.7,20,22,546.7,18,54,283.3,10,24,34,45,17,11,12,2,10,207,162,173,79,691.1190006574622,35.44378698224852,26.633136094674555,34.23142669296515,606.9592373438528,578.681130834977,706.6515450361604,74.82248520710058,10
363,Mike Muscala,Oklahoma City Thunder,C,26,127,9,35,234.2,1,2,50.0,7,25,250.0,5,15,20,6,8,2,1,2,24,52,46,32,26,104.06400000000001,19.744,7.4239999999999995,11.256000000000002,225.584,194.81599999999997,123.20000000000002,38.800000000000004,10
364,Miles Bridges,Charlotte Hornets,SF,208,390,85,188,451.1,22,30,546.4,16,62,231.0,11,70,81,40,12,8,19,3,-87,329,289,248,121,498.92570677186063,82.56213017751479,16.532544378698226,25.13872452333991,827.8270874424721,838.8566732412886,505.7777777777778,81.2130177514793,10
365,Miles McBride,New York Knicks,PG,123,317,44,94,417.5,10,11,383.3,25,56,366.6,7,11,18,27,25,7,5,2,21,168,141,150,45,764.3765615704937,9.685901249256395,74.44437834622249,45.0,982.3842950624628,796.9488399762047,951.1267102914933,82.81558596073765,10
366,Mo Bamba,Philadelphia 76ers,C,59,202,22,40,559.7,7,10,175.0,8,19,340.0,10,36,46,10,27,8,10,11,-36,115,105,69,56,83.60628195763331,44.981738495252,18.467494521548577,5.60262965668371,212.58948137326516,139.46603360116873,140.5325054784514,79.64645726807889,10
367,Monte Morris,Minnesota Timberwolves,PG,52,166,19,49,508.6,5,8,225.0,9,18,400.0,3,10,13,29,3,6,2,0,4,94,65,81,42,50.0,20.346938775510203,46.673469387755105,4.918367346938775,193.66530612244898,96.51836734693877,118.61632653061224,95.55102040816325,10
368,Moritz Wagner,Orlando Magic,C,96,150,38,59,623.8,14,16,560.0,6,17,316.6,8,25,33,11,11,2,12,2,17,140,129,107,44,227.65522279035793,46.200876552227896,7.06135865595325,4.435354273192111,404.3214024835646,409.081811541271,215.47918188458726,60.67786705624545,10
369,Moses Brown,Portland Trail Blazers,C,22,48,9,16,283.3,4,13,70.8,0,0,0.0,9,9,18,4,7,0,2,1,9,44,40,26,22,63.0,17.0,5.12396694214876,0.0,130.2148760330578,104.0,80.48760330578513,30.85123966942149,5
370,Moses Moody,Golden State Warriors,SG,79,192,32,76,421.5,9,12,233.3,6,32,168.3,11,25,36,5,14,9,6,8,28,120,115,84,41,232.20083246618105,83.97710718002081,2.5650364203954212,8.826222684703433,524.8907388137358,525.5952133194588,237.97294484911552,80.06555671175859,10
371,Mouhamadou Gueye,Toronto Raptors,F,5,19,2,9,50.0,1,4,25.0,0,0,0.0,3,2,5,0,2,1,3,3,-15,10,10,5,5,1.625,2.03125,0.0,0.0,5.28125,5.28125,1.625,2.03125,2
372,Moussa Diabate,LA Clippers,F,2,7,1,1,100.0,0,2,0.0,0,0,0.0,1,3,4,0,0,1,0,1,1,6,6,2,4,0.0,0.0,0.0,0.0,0.0,0.0,0.0,0.0,1
373,Myles Turner,Indiana Pacers,C,154,275,58,124,458.3,20,29,495.0,18,46,355.2,12,52,64,13,27,3,12,24,45,231,218,167,77,377.93364197530866,60.489197530864196,16.23611111111111,24.32716049382716,394.17438271604937,396.34567901234567,424.38271604938274,28.104938271604937,10
374,Naji Marshall,New Orleans Pelicans,SF,85,201,35,67,472.8,4,5,250.0,11,26,435.0,5,38,43,20,8,11,6,1,56,148,128,105,63,273.57462195923733,44.91715976331361,10.059171597633137,13.681130834976988,428.21170282708744,421.5923734385273,265.0105193951348,70.15976331360947,10
375,Nassir Little,Phoenix Suns,SF,9,50,3,12,133.3,0,0,0.0,3,8,200.0,0,10,10,3,6,0,1,2,-8,22,19,12,13,13.646694214876034,13.927685950413224,4.274793388429752,1.597107438016529,45.71280991735538,38.20661157024793,16.619834710743802,22.73553719008264,5
376,Nate Hinton,Houston Rockets,G,12,22,4,7,110.0,2,3,66.7,2,3,66.7,1,5,6,3,4,1,1,2,10,21,18,15,9,48.05555555555556,6.722222222222221,1.3888888888888884,2.5,97.38888888888886,75.55555555555557,65.0,13.0,2
377,Nathan Mensah,Charlotte Hornets,C,4,59,2,5,66.7,0,0,0.0,0,0,0.0,4,6,10,1,13,2,1,4,-17,15,14,5,11,13.75,9.9375,0.859375,0.0,41.359375,44.4375,13.484375,7.984375,7
378,Naz Reid,Minnesota Timberwolves,C,168,280,61,132,459.7,19,26,559.2,27,64,379.2,10,55,65,23,19,7,12,13,14,256,233,191,88,781.5865595325055,83.56975894813733,22.493060628195764,50.44046749452155,907.0299488677866,772.3966398831263,873.7991234477722,148.48356464572677,10
379,Neemias Queta,Boston Celtics,C,39,80,19,26,443.4,1,2,100.0,0,0,0.0,12,17,29,4,8,3,4,6,63,72,68,43,33,83.71428571428572,53.17857142857142,1.75,0.0,238.57142857142858,241.75,84.89285714285714,50.57142857142858,7
380,Nic Claxton,Brooklyn Nets,C,127,303,52,79,667.3,23,34,604.7,0,1,0.0,23,70,93,24,25,7,12,17,-58,244,220,151,117,241.07376561570493,54.181439619274244,15.043426531826293,0.0,323.3634741225461,340.9994051160023,246.2956573468174,46.36704342653182,10
381,Nick Jr. Smith,Charlotte Hornets,G,53,164,17,59,301.1,8,9,187.5,11,32,275.0,2,10,12,17,19,4,5,0,8,82,65,70,29,227.10425240054872,11.382716049382719,21.0,15.087791495198903,287.0754458161866,231.26063100137176,261.8079561042524,53.49382716049383,10
382,Nick Richards,Charlotte Hornets,C,90,296,38,56,653.6,14,20,400.0,0,1,0.0,26,64,90,7,27,5,12,8,-27,187,180,97,97,269.3518005540166,152.00692520775624,10.711911357340721,0.0,378.5,393.0540166204986,274.9279778393352,142.58864265927977,10
383,Nickeil Alexander-Walker,Minnesota Timberwolves,SG,103,274,37,78,434.1,11,12,383.3,18,42,375.0,8,19,27,22,17,9,9,5,23,152,130,125,49,558.9444444444446,40.73696145124716,30.56689342403628,27.6734693877551,799.9104308390023,697.7607709750566,610.3367346938776,122.06122448979592,10
384,Nicolas Batum,Philadelphia 76ers,PF,42,286,15,48,274.6,6,7,250.0,6,30,178.3,14,43,57,20,18,13,8,7,12,119,99,62,77,134.81373569198752,85.27887617065556,22.842872008324658,4.969823100936525,337.0,264.61706555671174,163.633714880333,151.684703433923,10
385,Nikola Jokic,Denver Nuggets,C,277,377,111,190,590.0,45,52,870.5,10,25,218.7,27,96,123,74,15,13,29,7,96,474,400,351,197,596.0065741417093,131.31555880204527,91.48721694667641,18.116873630387143,936.8444119795471,758.9218407596786,760.0299488677866,236.7019722425128,10
386,Nikola Jovic,Miami Heat,F,78,217,29,66,440.2,6,7,250.0,14,41,336.6,2,40,42,18,18,9,11,4,4,138,120,96,60,88.19281663516068,52.69187145557655,20.05671077504726,11.550094517958412,242.99432892249527,192.07561436672967,119.0359168241966,92.8241965973535,10
387,Nikola Vucevic,Chicago Bulls,C,199,342,86,169,500.4,12,15,450.0,15,42,351.6,29,78,107,29,21,5,20,4,-37,335,306,228,136,510.15450361604206,72.55292570677186,31.231426692965155,6.514792899408284,666.2215647600264,611.207100591716,554.9940828402367,113.95923734385273,10
388,Noah Clowney,Brooklyn Nets,F,13,55,5,11,90.0,0,0,0.0,1,6,25.0,4,7,11,6,2,2,1,0,3,30,24,19,17,51.653061224489804,9.938775510204081,3.938775510204082,0.7551020408163265,101.6530612244898,102.0,50.183673469387756,15.0,4
389,Norman Powell,LA Clippers,G,153,282,54,116,463.2,21,27,525.0,24,68,384.1,3,29,32,16,23,10,10,2,0,201,185,169,48,363.20395421436007,32.3309053069719,17.00104058272633,20.40374609781478,435.0,481.80749219562955,306.2341311134235,59.494276795005206,10
390,O.G. Anunoby,New York Knicks,SF,83,194,33,70,262.7,9,14,243.3,8,28,138.3,3,24,27,12,12,16,13,5,107,122,110,95,39,431.93491124260356,55.0,6.0,8.757396449704142,260.7810650887574,260.7810650887574,441.9349112426035,51.0,6
391,Obi Toppin,Indiana Pacers,PF,78,177,31,54,533.0,9,11,450.0,7,22,250.0,7,33,40,10,14,4,6,4,24,128,118,88,50,226.10913872452335,44.02629848783695,17.4792899408284,6.489809335963183,379.97633136094674,380.36686390532543,215.3241288625904,71.9000657462196,10
392,Ochai Agbaji,Toronto Raptors,G,76,277,31,86,331.8,7,12,275.0,7,31,175.89999999999998,17,24,41,15,24,10,11,4,-90,132,117,91,56,185.55017301038063,73.39446366782008,29.546712802768162,4.188581314878893,485.71626297577853,405.3114186851211,241.74048442906576,127.15570934256056,10
393,Olivier Sarr,Oklahoma City Thunder,C,11,22,4,7,125.0,3,5,116.7,0,1,0.0,4,4,8,0,3,0,1,1,-14,19,19,11,8,34.92,6.920000000000002,0.0,0.0,59.68000000000001,59.68000000000001,34.92,6.920000000000002,3
394,OlivierMaxence Prosper,Dallas Mavericks,F,10,36,3,6,150.0,4,7,57.1,0,2,0.0,2,6,8,0,1,1,1,1,-14,18,18,10,8,28.946745562130175,14.059171597633139,0.0,0.0,82.53254437869823,82.53254437869823,28.946745562130175,14.059171597633139,4
395,Omer Yurtseven,Utah Jazz,C,43,86,19,28,326.1,4,7,200.0,1,3,50.0,12,15,27,5,10,1,3,6,-14,75,70,48,32,143.67674858223063,24.712665406427224,10.005671077504726,0.833648393194707,259.1890359168242,205.62570888468807,185.66729678638941,46.291115311909266,6
396,Onuralp Bitim,Chicago Bulls,SF,49,159,21,45,421.1,1,2,50.0,6,23,166.7,6,12,18,9,13,2,4,2,-25,76,67,58,27,247.71330589849106,55.111111111111114,5.203017832647463,6.419753086419753,499.9807956104252,463.36762688614544,267.7091906721536,76.93141289437587,10
397,Onyeka Okongwu,Atlanta Hawks,PF,147,296,61,89,703.8000000000001,16,22,492.9,9,19,466.6,32,44,76,11,28,7,5,15,4,234,223,158,87,289.70000000000005,179.29999999999998,9.525,5.300000000000001,756.4249999999998,775.0,286.82500000000005,173.125,10
398,Orlando Robinson,Miami Heat,C,13,54,4,10,108.3,4,5,175.0,1,2,100.0,7,9,16,4,4,1,3,0,6,33,29,17,20,43.23828125,16.42578125,2.828125,0.8125,54.703125,39.25,61.33203125,16.61328125,5
399,Oscar Tshiebwe,Indiana Pacers,C,3,5,1,3,33.3,1,2,50.0,0,0,0.0,2,0,2,0,1,0,0,1,8,5,5,3,2,0.25,0.0,0.0,0.0,0.25,0.25,0.25,0.0,1
400,Oshae Brissett,Boston Celtics,SF,47,168,14,35,427.2,15,26,488.3,4,13,283.3,14,24,38,16,12,4,4,2,46,101,85,63,54,102.46492271105826,63.76218787158146,20.87514863258026,2.5541022592152203,330.60760998810935,221.51367419738406,197.0713436385256,99.12485136741975,10
401,Ousmane Dieng,Oklahoma City Thunder,F,28,90,10,25,324.4,4,4,200.0,4,14,220.0,1,7,8,14,3,3,6,3,16,50,36,42,22,118.88888888888887,6.0,20.222222222222218,4.222222222222223,234.0,160.88888888888886,188.0,30.222222222222225,8
402,P.J. Tucker,LA Clippers,PF,19,135,7,18,183.3,0,0,0.0,5,11,283.4,7,19,26,4,9,3,3,4,-8,49,45,23,30,58.9224376731302,39.39612188365651,4.049861495844875,4.252077562326869,155.61495844875344,121.6371191135734,77.51523545706371,58.83102493074792,8
403,P.J. Washington,Dallas Mavericks,PF,92,321,33,92,377.0,15,20,400.0,11,53,204.3,12,48,60,13,18,11,7,10,38,165,152,105,73,214.16775728732898,54.005948839976206,10.367043426531826,13.183224271267102,338.8072575847709,264.8732897085069,266.022010707912,86.45270672218916,10
404,Paolo Banchero,Orlando Magic,PF,218,344,81,156,575.3,40,52,642.8,16,39,491.3,8,54,62,63,20,7,34,6,77,343,280,281,125,227.6326530612245,74.12244897959184,82.26530612244898,8.922448979591838,464.3469387755102,392.81632653061223,276.9510204081633,178.6,10
405,Pascal Siakam,Indiana Pacers,PF,210,325,86,158,545.3,32,45,621.8,6,19,191.6,25,74,99,34,21,11,13,5,53,343,309,244,133,189.91715976331363,116.0059171597633,30.625904010519395,5.443786982248521,340.4503616042077,251.7100591715976,221.80144641683106,203.48783694937543,10
406,Pat Connaughton,Milwaukee Bucks,SG,64,233,21,47,437.9,11,13,525.0,11,30,381.0,7,20,27,17,10,3,5,3,-9,108,91,81,44,200.625,32.85625,21.15625,13.300000000000002,345.625,350.30625,205.95625,44.0,10
407,Patrick Baldwin Jr.,Washington Wizards,F,46,144,16,50,322.6,6,9,310.0,8,31,196.9,4,31,35,12,11,7,5,4,-46,93,81,58,47,127.75234131113424,59.33298647242456,18.599375650364205,5.881373569198751,326.8896982310094,219.0,192.2767950052029,121.29760665972947,10
408,Patrick Beverley,Milwaukee Bucks,PG,57,215,18,51,294.2,11,13,533.4,10,30,282.9,3,26,29,16,22,9,7,7,-24,102,86,73,45,193.19592373438527,64.20710059171597,31.92899408284024,10.006574621959237,424.36554898093357,364.7797501643655,252.59237343852726,96.32544378698225,10
409,Patrick Williams,Chicago Bulls,PF,6,24,2,9,22.2,2,2,100.0,0,5,0.0,0,6,6,2,5,0,2,2,-11,14,12,8,8,0.0,0.0,0.0,0.0,0.0,0.0,0.0,0.0,1
410,Patty Mills,Atlanta Hawks,PG,0,17,0,2,0.0,0,0,0.0,0,1,0.0,0,2,2,1,0,1,0,0,8,3,2,1,3,27.986282578875173,2.13443072702332,3.765432098765432,0.617283950617284,60.20987654320987,34.0,50.8710562414266,9.224965706447188,2
411,Patty Mills,Miami Heat,PG,40,128,15,52,203.6,4,4,200.0,6,35,132.5,4,8,12,14,9,6,5,0,19,66,52,54,26,160.68587105624144,6.463648834019205,15.506172839506172,7.80246913580247,180.83950617283946,186.0,155.63237311385458,21.862825788751714,8
412,Paul George,LA Clippers,F,247,359,85,160,543.6,39,45,789.6,38,84,464.4,2,48,50,37,24,17,20,11,52,334,297,284,87,228.13477975016437,12.006574621959237,70.24523339907955,20.023668639053255,343.7541091387245,249.2827087442472,324.5443786982248,80.31360946745562,10
413,Paul Reed,Philadelphia 76ers,SF,92,233,37,82,462.3,12,18,450.0,6,16,250.0,34,38,72,15,26,12,9,16,-8,179,164,107,87,313.4205829863177,63.64663890541345,10.501487209994051,6.839976204640095,612.8929208804283,586.661511005354,329.63533610945865,84.16478286734088,10
414,Payton Pritchard,Boston Celtics,PG,112,263,43,91,417.8,4,4,200.0,22,51,399.7,9,26,35,45,10,3,11,0,81,192,147,157,80,572.8698060941829,52.74930747922437,177.8573407202216,32.34903047091413,1314.6648199445983,672.9265927977839,1142.44459833795,302.7700831024931,10
415,Peyton Watson,Denver Nuggets,F,66,186,28,63,437.3,7,12,250.0,3,22,225.0,4,28,32,9,16,5,5,10,-8,107,98,75,41,111.3961218836565,15.817174515235457,16.909972299168974,2.3171745152354566,195.3753462603878,172.42659279778394,127.8518005540166,39.2202216066482,10
416,Precious Achiuwa,New York Knicks,PF,86,239,36,64,546.7,9,16,408.3,5,11,283.3,24,46,70,18,19,9,14,17,29,174,156,104,88,277.50029744199884,104.587745389649,19.628792385484832,4.8346222486615105,545.5217132659131,508.6448542534206,291.1731112433075,147.4205829863177,10
417,Quentin Grimes,Detroit Pistons,SG,82,213,26,80,296.2,19,24,525.0,11,50,200.0,2,27,29,19,13,7,9,4,-12,130,111,101,48,312.44628099173553,35.19834710743802,14.900826446280991,10.900826446280991,442.06611570247935,483.0495867768595,277.6942148760331,43.86776859504132,10
418,R. Rupert,Portland Trail Blazers,G,38,150,13,30,398.1,7,8,350.0,5,14,225.0,8,17,25,13,16,3,7,1,3,76,63,51,38,161.376,28.616,15.0,9.175999999999998,329.504,300.984,180.13600000000002,53.376000000000005,10
419,RJ Barrett,Toronto Raptors,SG,208,328,85,152,559.5,20,43,406.1,18,37,425.0,9,42,51,46,22,5,28,4,-39,305,259,254,97,255.64444444444445,58.24444444444445,50.577777777777776,15.777777777777777,454.77777777777777,307.8,398.8,112.64444444444445,10
420,Reggie Bullock,Houston Rockets,SF,26,114,9,21,424.9,0,0,0.0,8,18,449.9,2,20,22,3,5,5,2,0,26,51,48,29,25,28.790123456790123,25.635116598079563,2.149519890260631,3.890260631001371,62.19067215363512,65.44581618655693,26.651577503429355,26.66803840877915,10
421,Reggie Jackson,Denver Nuggets,PG,52,138,21,61,304.3,2,2,100.0,8,23,310.0,1,10,11,23,9,1,8,2,32,86,63,75,34,100.50969529085874,8.5,36.39058171745153,5.6011080332409975,138.48891966759004,98.37811634349032,125.93628808864267,59.57479224376731,10
422,Richaun Holmes,Washington Wizards,F,69,203,27,52,498.0,14,16,500.0,1,2,100.0,23,38,61,7,28,6,5,6,-20,137,130,76,68,210.90449954086318,183.33976124885217,6.133149678604224,0.9485766758494033,648.1937557392104,572.653810835629,250.4132231404959,225.50413223140495,10
423,Ricky IV Council,Philadelphia 76ers,G,62,114,21,48,420.2,17,23,530.0,3,14,125.0,2,15,17,6,5,0,3,1,-8,85,79,68,23,264.5,32.15289256198348,6.466942148760332,4.702479338842975,485.6570247933884,417.74380165289256,326.6942148760331,44.33884297520661,10
424,Robin Lopez,Milwaukee Bucks,C,6,23,3,9,37.5,0,0,0.0,0,2,0.0,1,0,1,1,3,1,0,2,-16,8,7,7,2,21.92,0.52,0.6800000000000002,0.0,24.48,29.0,18.28,0.32000000000000006,2
425,Royce O'Neale,Phoenix Suns,PF,69,255,26,70,400.5,0,0,0.0,17,49,385.9,7,38,45,32,17,3,8,4,39,146,114,101,77,290.084487534626,21.670360110803326,41.66759002770083,21.685595567867036,337.8573407202216,349.26454293628814,256.0069252077563,86.00831024930747,10
426,Rudy Gobert,Minnesota Timberwolves,C,128,372,53,83,641.7,22,35,505.0,0,1,0.0,48,101,149,13,35,7,14,26,21,290,277,141,162,293.15625,108.11111111111113,12.11111111111111,0.0,438.15625,470.35069444444446,249.18402777777777,132.0,10
427,Rui Hachimura,Los Angeles Lakers,PF,159,305,67,118,560.2,10,14,333.3,15,35,395.0,6,31,37,14,19,4,6,2,-10,210,196,173,51,409.65373961218836,38.71191135734072,6.865650969529087,12.673130193905816,338.32825484764544,358.3545706371191,392.2950138504155,42.90997229916897,10
428,Russell Westbrook,LA Clippers,PG,93,216,37,98,389.9,15,21,523.3,4,26,95.0,8,19,27,29,17,13,15,1,-10,149,120,122,56,193.55363321799308,25.844290657439448,33.636678200692046,4.7543252595155705,366.9792387543252,307.43252595155707,227.9515570934256,84.62975778546712,10
429,Ryan Arcidiacono,New York Knicks,G,0,5,0,1,0.0,0,0,0.0,0,1,0.0,0,0,0,0,1,1,0,0,3,0,0,0,0,0.0,0.0625,0.0,0.0,0.0625,0.0625,0.0,0.0625,1
430,Saben Lee,Phoenix Suns,G,35,98,9,28,194.29999999999998,15,20,416.7,2,9,83.3,3,15,18,17,6,4,2,0,11,70,53,52,35,190.68,24.479999999999997,5.720000000000001,1.5200000000000005,336.32,336.0,189.68,31.519999999999996,8
431,Saddiq Bey,Atlanta Hawks,SF,146,337,48,125,372.4,31,35,800.0,19,59,298.4,29,32,61,14,7,4,10,4,-23,221,207,160,75,398.90000000000003,67.125,9.625,14.9,439.4000000000001,478.32500000000005,362.225,74.5,10
432,Sam Hauser,Boston Celtics,SF,114,213,40,84,431.8,0,0,0.0,34,72,419.1,2,35,37,9,10,7,1,6,122,160,151,123,46,754.5777777777779,31.211111111111112,4.9111111111111105,78.44444444444444,892.5444444444445,887.3000000000001,752.2,43.74444444444444,10
433,Sam Merrill,Cleveland Cavaliers,SG,80,236,24,76,319.9,9,9,500.0,23,72,323.2,2,22,24,23,13,3,4,3,2,127,104,103,47,183.8240997229917,48.865650969529085,69.74238227146814,20.738227146814406,374.30193905817174,259.3961218836565,301.3808864265928,115.95706371191136,10
434,Samardo Samuels,Houston Rockets,F,0,6,0,1,0.0,0,0,0.0,0,0,0.0,1,1,2,0,0,0,0,0,-5,2,2,0,2,1.44,1.9599999999999997,0.0,0.0,0.03999999999999998,0.03999999999999998,1.44,1.9599999999999997,1
435,Sandro Mamukelashvili,San Antonio Spurs,PF,20,47,10,16,296.7,0,1,0.0,0,2,0.0,8,3,11,5,5,2,0,0,21,36,31,25,16,61.83673469387756,13.5,6.918367346938775,0.0,142.1938775510204,98.76530612244899,89.12244897959182,36.56122448979592,6
436,Santi Aldama,Memphis Grizzlies,PF,153,339,55,116,481.0,17,25,616.7,26,64,369.3,12,57,69,31,13,9,12,13,-81,253,222,184,100,297.7718606180145,72.92899408284023,33.05785667324129,32.59171597633136,571.128862590401,474.81130834976983,399.7541091387245,100.32215647600263,10
437,Sasha Vezenkov,Sacramento Kings,F,9,22,2,7,28.6,3,3,100.0,2,4,50.0,0,1,1,1,4,1,0,0,24,11,10,10,2,4.5,0.5,0.5,2.0,4.5,2.0,8.0,0.0,2
438,Scoot Henderson,Portland Trail Blazers,G,136,291,47,124,383.2,32,37,808.3,10,39,243.3,6,25,31,57,32,11,31,1,-102,224,167,193,88,274.4326530612245,55.12244897959184,67.20408163265307,8.204081632653061,629.3877551020408,374.8938775510204,500.2734693877551,150.9795918367347,10
439,Scottie Barnes,Toronto Raptors,SF,179,333,70,155,460.1,33,39,674.9,6,36,159.89999999999998,28,63,91,75,18,13,31,14,21,345,270,254,166,391.6640625,102.8515625,85.6640625,4.8515625,827.2890625,587.40625,576.65625,243.40625,10
440,Scotty Pippen Jr.,Memphis Grizzlies,G,108,226,37,74,433.1,19,30,390.4,15,27,555.0,9,24,33,47,25,14,20,5,2,188,141,155,80,216.0,18.0,42.0625,6.5625,263.39583333333337,278.0,198.0625,63.39583333333333,9
441,Seth Curry,Charlotte Hornets,SG,81,181,29,67,372.5,14,15,566.7,9,31,256.6,4,15,19,17,7,5,7,3,-33,117,100,98,36,233.0,12.900826446280993,16.140495867768593,4.900826446280991,334.3388429752066,276.08264462809916,269.8677685950413,50.429752066115704,10
442,Shai Gilgeous-Alexander,Oklahoma City Thunder,PG,287,342,104,203,509.9,65,80,808.2,14,48,284.3,8,53,61,58,28,20,26,11,79,406,348,345,119,408.91715976331363,66.95529257067719,30.51545036160421,18.527284681130837,552.1604207758054,443.68310322156475,525.4444444444445,89.42077580539119,10
443,Shake Milton,New York Knicks,SG,40,105,17,39,321.1,2,3,66.7,4,11,150.0,9,13,22,11,6,3,5,2,-16,73,62,51,33,109.48000000000002,70.72,17.27,7.920000000000001,423.83000000000004,324.52,167.02999999999997,129.75,7
444,Simone Fontecchio,Detroit Pistons,F,158,307,55,116,455.5,19,21,616.7,29,65,413.2,8,41,49,16,20,10,13,5,5,223,207,174,65,506.0,36.90963139120095,14.430439952437576,30.11296076099881,589.4708680142687,547.3923900118907,538.8442330558859,60.574316290130795,10
445,Skylar Mays,Los Angeles Lakers,SG,8,34,4,10,170.0,0,0,0.0,0,3,0.0,0,1,1,3,2,3,2,1,-3,12,9,11,4,11.54325259515571,0.7508650519031141,2.854671280276816,0.0,6.996539792387543,12.40484429065744,7.615916955017302,2.124567474048443,4
446,Spencer Dinwiddie,Los Angeles Lakers,PG,49,229,14,38,372.5,10,13,416.7,11,24,416.7,1,11,12,20,15,2,6,4,40,81,61,69,32,144.1743827160494,5.711419753086419,20.919753086419757,9.0,165.21604938271602,133.49382716049382,177.90277777777777,24.625,10
447,Stanley Umude,Detroit Pistons,G,49,150,16,39,260.4,8,9,366.7,9,25,243.3,5,16,21,3,15,4,4,2,-32,73,70,52,24,177.08,44.0,1.9200000000000002,10.88,278.68,272.78,180.88,48.02,8
448,Stephen Curry,Golden State Warriors,PG,219,295,77,195,393.7,20,22,655.0,45,128,352.3,11,47,58,40,7,4,22,2,27,317,277,259,98,898.9237343852727,113.74621959237344,38.318211702827085,49.88231426692965,1556.8014464168307,1365.1683103221565,1090.905325443787,151.71597633136093,10
449,Svi Mykhailiuk,Boston Celtics,SG,43,115,15,37,435.4,1,1,100.0,12,31,288.3,2,14,16,11,1,4,2,0,76,70,59,54,27,47.109640831758036,22.37807183364839,8.353497164461247,8.034026465028356,183.14177693761815,125.69943289224953,85.70132325141776,49.582230623818525,8
450,T.J. McConnell,Indiana Pacers,PG,138,200,62,108,560.5,8,9,350.0,6,11,400.0,4,23,27,44,10,16,19,2,30,209,165,182,71,297.37808641975306,30.35956790123457,40.52623456790123,4.563271604938271,477.7299382716049,386.11111111111114,389.1111111111111,70.77160493827161,10
451,T.J. Warren,Minnesota Timberwolves,SF,29,98,13,34,301.2,1,2,50.0,2,11,83.3,5,11,16,7,10,3,4,1,31,52,45,36,23,31.96825396825397,13.492063492063492,6.396825396825397,1.4285714285714286,32.492063492063494,46.0,14.142857142857142,24.206349206349206,7
452,Taj Gibson,Detroit Pistons,F,3,11,1,2,50.0,0,0,0.0,1,2,50.0,0,2,2,0,1,1,0,0,-3,5,5,3,2,2.5600000000000005,0.03999999999999998,0.16000000000000003,0.36,1.9599999999999997,3.2399999999999993,1.44,0.04000000000000007,1
453,Taj Gibson,New York Knicks,F,2,68,0,9,0.0,2,2,100.0,0,2,0.0,4,6,10,4,8,1,3,0,2,16,12,6,14,8.2,10.200000000000001,1.6,0.8000000000000002,15.600000000000001,12.400000000000002,6.6000000000000005,16.599999999999998,5
454,Talen Horton-Tucker,Utah Jazz,SG,64,154,19,65,304.2,16,18,566.7,10,30,384.9,3,17,20,23,12,6,3,5,-48,107,84,87,43,47.82716049382716,53.11111111111111,31.729766803840878,2.0548696844993137,214.10836762688615,140.41975308641975,112.20713305898491,94.14951989026062,10
455,Taurean Prince,Los Angeles Lakers,PF,63,186,24,53,497.70000000000005,2,2,100.0,13,33,342.0,3,27,30,11,12,4,6,6,17,104,93,74,41,147.6111111111111,34.37808641975309,11.734567901234568,16.75308641975309,301.0694444444444,279.9521604938272,165.6049382716049,49.23611111111111,10
456,Taylor Hendricks,Utah Jazz,F,86,257,31,67,500.6,10,12,325.0,14,39,371.9,13,52,65,7,34,6,4,12,-66,158,151,93,72,100.90625,128.5390625,2.1015625,6.40625,273.90625,245.1640625,120.6640625,139.625,10
457,Taze Moore,Portland Trail Blazers,G,2,5,1,1,100.0,0,0,0.0,0,0,0.0,0,0,0,1,0,0,1,0,7,3,2,3,1,1.44,0.0,0.6400000000000001,0.0,4.0,1.44,4.0,0.6400000000000001,1
458,Terance Mann,LA Clippers,SG,103,265,36,71,527.0,19,19,800.0,12,30,403.5,6,21,27,10,23,9,5,4,-25,140,130,113,37,245.33399079552927,21.130177514792898,15.111111111111112,7.7514792899408285,282.73241288625906,206.3734385272847,326.10322156476,31.831032215647593,10
459,Terquavion Smith,Philadelphia 76ers,G,40,59,14,34,241.1,2,3,100.0,10,26,216.6,0,2,2,10,3,7,4,0,9,52,42,50,12,186.96296296296296,1.4074074074074074,17.185185185185183,17.185185185185183,177.40740740740742,184.66666666666663,179.62962962962965,18.666666666666668,6
460,Terry Rozier,Miami Heat,SG,180,342,71,163,436.2,16,19,472.7,22,54,355.4,6,44,50,45,18,9,14,2,-19,275,230,225,95,197.0612244897959,30.130612244897957,106.50204081632653,34.416326530612245,450.66530612244895,249.80408163265304,397.8897959183674,136.66530612244898,10
461,Terry Taylor,Chicago Bulls,F,11,46,4,8,275.0,1,2,50.0,2,3,150.0,2,10,12,3,1,1,0,0,-17,26,23,14,15,11.419753086419755,29.12345679012346,3.123456790123457,1.6049382716049383,88.41975308641973,69.44444444444443,17.641975308641975,45.0,4
462,Thaddeus Young,Phoenix Suns,F,6,29,3,6,100.0,0,2,0.0,0,0,0.0,7,3,10,0,4,1,1,0,3,16,16,6,10,3.7578125,26.5078125,3.125,0.0,8.03125,10.53125,11.5703125,19.3203125,2
463,Thaddeus Young,Phoenix Suns,PF,53,152,26,34,569.9,1,5,50.0,0,2,0.0,15,20,35,18,15,3,4,2,-39,106,88,71,53,232.15234375,51.77734375,39.9375,0.0,703.609375,426.859375,442.74609375,157.87109375,7
464,Thanasis Antetokounmpo,Milwaukee Bucks,SF,10,48,5,11,266.7,0,2,0.0,0,1,0.0,2,1,3,4,8,1,3,1,-18,17,13,14,7,12.833333333333332,1.666666666666667,2.0000000000000004,0.0,20.83333333333334,17.5,15.5,4.333333333333334,6
465,Theo Maledon,Phoenix Suns,PG,5,10,1,2,50.0,3,3,100.0,0,0,0.0,0,1,1,0,3,0,3,0,-11,6,6,5,1,14.0625,0.5625,0.0,0.0,20.25,20.25,14.0625,0.5625,1
466,Thomas Bryant,Miami Heat,C,56,119,20,37,430.2,13,15,625.0,3,11,200.0,8,28,36,5,12,1,0,7,-1,97,92,61,41,170.2117202268431,90.76748582230624,4.504725897920605,4.122873345935727,389.88846880907374,385.9395085066162,176.44801512287336,92.98487712665406,10
467,Tim Hardaway Jr.,Dallas Mavericks,SF,74,179,25,76,266.1,9,14,350.0,15,49,248.9,2,16,18,16,5,5,5,0,28,108,92,90,34,556.2343842950625,77.42058298631767,12.402141582391433,30.535990481856036,1032.7531231409873,929.7989292088043,639.1326591314694,109.87864366448541,10
468,Tobias Harris,Philadelphia 76ers,PF,163,348,66,153,406.2,16,23,593.3,15,49,266.1,14,62,76,25,14,12,11,5,-34,264,239,188,101,694.6840277777778,154.51736111111111,21.90277777777778,23.350694444444446,1263.611111111111,1106.125,783.65625,244.93402777777777,10
469,Torrey Craig,Chicago Bulls,SF,65,209,23,53,366.3,3,6,150.0,16,39,327.1,8,26,34,15,19,3,9,5,-50,114,99,80,49,154.61479591836735,38.89030612244898,20.512755102040813,14.418367346938775,384.625,331.03061224489795,194.05102040816325,73.56122448979592,10
470,Tosan Evbuomwan,Detroit Pistons,F,53,169,19,39,495.8,8,12,191.7,7,17,323.3,10,20,30,7,10,2,4,1,-81,90,83,60,37,200.0,135.34072022160666,10.700831024930748,5.556786703601109,475.22160664819944,436.2880886426593,189.12188365650968,195.85318559556785,9
471,Toumani Camara,Portland Trail Blazers,F,82,286,30,62,480.5,12,15,400.0,10,25,353.3,22,27,49,19,24,7,9,6,-23,150,131,101,68,261.6982152514872,79.04975662520282,17.30935640886966,8.914007571660358,584.6360194699837,557.4997295835587,286.42779881016764,98.7658193618172,10
472,Trae Young,Atlanta Hawks,PG,235,370,76,173,432.4,45,55,813.4,38,93,399.0,2,18,20,109,22,11,45,2,-38,364,255,344,129,758.2361111111111,12.069444444444445,83.0,45.06944444444444,786.5,622.5,926.4027777777778,90.90277777777777,10
473,Trayce JacksonDavis,Golden State Warriors,F,116,233,53,65,830.5,10,22,445.0,0,0,0.0,26,44,70,20,19,4,7,19,-6,206,186,136,90,133.2254610350982,83.1338488994646,23.338488994646045,0.0,344.78524687685893,298.31766805472927,162.0928019036288,124.0725758477097,10
474,Tre Jones,San Antonio Spurs,PG,102,304,37,72,485.5,17,19,558.3,11,25,237.1,8,35,43,74,11,12,13,1,46,219,145,176,117,606.909972299169,26.711911357340725,68.43351800554017,25.930747922437675,639.3490304709142,616.8656509695292,599.5069252077562,125.03185595567867,10
475,Tre Mann,Charlotte Hornets,PG,118,315,46,99,465.8,14,23,457.1,12,36,288.3,6,41,47,42,17,19,12,0,-51,207,165,160,89,237.7544378698225,32.91715976331361,38.023668639053255,8.097633136094675,489.3402366863905,388.1686390532545,328.5,81.36686390532545,10
476,Trendon Watford,Brooklyn Nets,PF,63,128,20,48,431.4,19,21,535.7,4,10,200.0,10,17,27,2,17,2,9,4,-52,92,90,65,29,278.0487514863258,55.62306777645661,1.7217598097502973,4.9179548156956,421.96195005945305,402.80618311533885,306.15814506539834,48.391200951248514,10
477,Trent Forrest,Atlanta Hawks,G,25,123,11,22,408.3,3,4,150.0,0,1,0.0,3,11,14,27,7,1,3,1,-20,66,39,52,41,53.34444444444444,14.57777777777778,47.44444444444444,0.0,143.61111111111111,70.5,107.47777777777777,81.0,10
478,Trevelin Queen,Orlando Magic,SG,0,13,0,3,0.0,0,0,0.0,0,2,0.0,0,1,1,1,1,0,0,0,-17,2,1,1,2,0.0,0.5555555555555556,0.5555555555555556,0.0,0.22222222222222227,0.5555555555555556,0.5555555555555556,0.22222222222222227,2
479,Trey Jemison,Memphis Grizzlies,C,80,228,36,57,561.0,8,10,400.0,0,0,0.0,24,27,51,11,32,3,15,9,4,142,131,91,62,478.0,22.08418367346939,6.961734693877551,0.0,549.3877551020408,610.655612244898,419.8188775510203,25.959183673469386,10
480,Trey Lyles,Sacramento Kings,PF,53,186,18,46,392.9,12,16,625.0,5,22,236.7,11,28,39,8,19,0,7,3,1,100,92,61,47,103.99173553719008,15.06198347107438,7.640495867768594,7.148760330578514,183.88429752066114,131.55785123966942,140.88016528925618,38.14049586776859,10
481,Trey Murphy III,New Orleans Pelicans,SG,190,299,62,124,485.9,25,31,802.4,41,91,424.2,9,46,55,25,9,6,9,2,73,270,245,215,80,848.1070791195716,51.584176085663294,20.53718024985128,80.66329565734682,930.7531231409873,1029.6389054134445,741.819750148721,79.52290303390839,10
482,Tristan Thompson,Cleveland Cavaliers,C,12,53,5,9,183.4,2,6,100.0,0,0,0.0,8,12,20,5,8,3,2,2,-1,37,32,17,25,18.3265306122449,6.326530612244898,0.7551020408163266,0.0,37.89795918367347,41.30612244897959,17.0,5.0,4
483,Troy Brown Jr.,Detroit Pistons,SF,42,133,16,41,359.1,2,2,100.0,8,25,239.89999999999998,3,21,24,11,6,1,3,0,-41,77,66,53,35,83.70000000000002,21.425,9.524999999999999,6.5,210.20000000000002,159.625,130.325,34.9,10
484,TyTy Washington Jr.,Milwaukee Bucks,G,0,8,0,2,0.0,0,0,0.0,0,1,0.0,0,0,0,1,0,0,0,0,-4,1,0,1,1,0.0,0.0,0.44444444444444453,0.0,0.44444444444444453,0.0,0.44444444444444453,0.44444444444444453,1
485,Tyler Herro,Miami Heat,PG,183,325,71,166,433.4,10,13,333.4,31,80,406.0,3,46,49,50,11,0,13,1,35,282,232,233,99,148.11111111111111,40.94444444444444,28.069444444444443,12.944444444444445,309.7361111111111,207.61111111111111,206.125,113.125,10
486,Tyrese Haliburton,Indiana Pacers,PG,183,342,69,152,458.9,29,32,705.0,16,70,230.79999999999998,5,42,47,102,14,14,26,10,58,332,230,285,149,199.0163265306123,37.40816326530612,90.77551020408164,12.693877551020407,331.1999999999999,166.66122448979598,410.95102040816323,80.78775510204083,10
487,Tyrese Maxey,Philadelphia 76ers,PG,253,367,89,207,425.8,47,50,825.0,28,82,320.8,4,29,33,52,21,12,16,3,-25,338,286,305,85,618.3204775022957,47.67584940312212,44.411386593204774,25.70615243342516,950.4444444444445,899.0174471992655,622.6859504132232,139.1487603305785,10
488,Tyus Jones,Washington Wizards,PG,91,313,36,84,402.0,4,4,300.0,15,43,360.8,3,22,25,97,4,9,13,2,-70,213,116,188,122,345.04336734693874,43.53316326530612,160.5,20.959183673469386,776.265306122449,542.0510204081633,542.9719387755102,240.3188775510204,10
489,Udoka Azubuike,Phoenix Suns,C,2,11,1,3,33.3,0,2,0.0,0,0,0.0,2,4,6,0,1,0,0,0,-3,8,8,2,6,1.7777777777777781,13.444444444444443,0.0,0.0,25.0,25.0,1.7777777777777781,13.444444444444443,1
490,Vasilije Micic,Charlotte Hornets,G,160,310,60,115,530.5,26,29,844.5,14,38,330.0,6,18,24,53,13,11,31,2,-60,237,184,213,77,389.28999269539815,43.78670562454347,79.84587289992696,22.965668371073775,562.308984660336,429.04601899196484,482.3235938641343,163.86194302410516,10
491,Victor Wembanyama,San Antonio Spurs,C,219,324,76,169,433.8,45,61,702.8,22,67,336.2,27,97,124,47,28,12,41,45,52,390,343,266,171,723.9525200876552,54.837107377647904,31.511322132943754,20.945215485756023,1306.4411979547115,1064.1132213294377,926.2045288531775,126.4243973703433,10
492,Vince Williams Jr.,Memphis Grizzlies,G,127,336,42,92,459.70000000000005,30,38,723.3,13,34,328.8,8,54,62,61,30,12,34,9,-54,250,189,188,123,231.93628808864267,72.8808864265928,35.61495844875347,18.00831024930748,492.2326869806094,474.07479224376726,226.76454293628805,131.82548476454295,10
493,Vit Krejci,Atlanta Hawks,G,40,192,15,36,280.2,4,5,150.0,6,21,178.3,2,7,9,20,17,6,4,4,4,69,49,60,29,70.5808,3.6208,13.879999999999999,3.0767999999999995,68.07520000000001,76.4032,60.1568,19.5968,7
494,Walker Kessler,Utah Jazz,C,71,243,32,48,715.0,7,10,300.0,0,1,0.0,29,60,89,11,17,3,11,13,-104,171,160,82,100,169.0,98.90625,6.90625,0.0,397.125,364.15625,187.75625,120.02499999999999,10
495,Wendell Carter Jr.,Orlando Magic,C,112,264,41,80,519.2,19,29,506.7,11,33,306.7,27,52,79,24,17,9,15,7,55,215,191,136,103,163.71141975308643,100.87808641975307,8.549382716049383,6.915123456790123,352.84567901234567,346.67901234567904,180.40277777777777,98.90277777777776,10
496,Wendell Moore Jr.,Minnesota Timberwolves,G,2,5,1,1,100.0,0,0,0.0,0,0,0.0,0,2,2,0,1,0,0,0,8,4,4,2,2,2.777777777777778,3.0625,0.006944444444444444,0.0,11.111111111111112,11.67361111111111,2.506944444444444,2.777777777777778,1
497,Wenyen Gabriel,Memphis Grizzlies,F,17,81,8,22,168.3,0,5,0.0,1,6,50.0,7,18,25,3,10,2,8,2,-16,45,42,20,28,56.555555555555564,36.30034722222222,3.967013888888889,0.8680555555555554,159.0,151.38368055555557,56.21701388888888,48.22222222222223,5
498,Wesley Matthews,Atlanta Hawks,SG,42,108,14,29,502.6,2,3,100.0,12,20,565.0,0,12,12,5,8,3,0,4,-35,59,54,47,17,107.51479289940829,22.782544378698226,9.437869822485208,6.147928994082839,188.32100591715977,180.1198224852071,123.0,24.936390532544376,9
499,Xavier Moon,LA Clippers,G,2,11,1,6,33.3,0,0,0.0,0,2,0.0,1,1,2,0,1,1,1,0,-20,4,4,2,2,4.768166089965398,2.4429065743944642,0.17301038062283738,0.0,2.0,0.9965397923875436,6.325259515570934,2.0622837370242215,2
500,Xavier Tillman,Boston Celtics,F,44,194,19,36,497.5,3,4,150.0,3,15,183.3,12,27,39,11,12,8,3,4,30,94,83,55,50,95.94378698224851,32.20710059171598,9.213017751479288,2.14792899408284,205.36390532544377,172.0147928994083,127.8136094674556,42.899408284023664,10
501,Yuta Watanabe,Memphis Grizzlies,SF,22,97,10,24,250.0,0,2,0.0,2,12,64.3,0,11,11,5,6,5,4,0,-36,38,33,27,16,115.08000000000001,11.27,3.75,1.4800000000000004,136.28,131.43,116.23000000000002,18.72,7
502,Zach Collins,San Antonio Spurs,PF,101,182,39,73,534.6,17,23,541.7,6,11,466.7,17,34,51,20,30,5,18,10,-37,172,152,121,71,256.00520291363165,63.58272632674298,24.093652445369408,4.534859521331946,514.7887617065556,385.81061394380856,354.47762747138404,118.18210197710718,10
503,Zeke Nnaji,Denver Nuggets,PF,18,100,6,17,350.0,6,8,300.0,0,2,0.0,7,10,17,4,10,2,2,10,-19,39,35,22,21,50.40625,16.277777777777775,7.350694444444445,0.0,130.125,94.18402777777779,73.06944444444443,36.90625,10
504,Ziaire Williams,Memphis Grizzlies,F,103,270,39,94,389.0,13,16,421.4,12,46,213.7,6,38,44,20,15,12,15,0,-39,167,147,123,64,552.1,32.4,24.0,17.599999999999998,788.1,632.1,714.1,50.4,10
505,Zion Williamson,New Orleans Pelicans,PF,219,309,86,142,579.0,47,61,704.5,0,1,0.0,20,54,74,45,19,11,31,11,75,338,293,264,119,963.3655489809336,63.408284023668635,54.580539119000655,0.006574621959237343,1069.4937541091388,1232.7698882314266,843.3596318211703,74.71860618014463,10
