,First Last Name,team,position,points,minutes,fgm,fga,fgp,ftm,fta,ftp,tpm,tpa,tpp,offReb,defReb,totReb,assists,pFouls,steals,turnovers,blocks,plusMinus,Points_Rebounds_Assist,Points_Rebounds,Points_Assist,Rebounds_Assist,points_deviation,totReb_deviation,assists_deviation,tpm_deviation,Points_Rebounds_Assist_deviation,Points_Rebounds_deviation,Points_Assist_deviation,Rebounds_Assist_deviation,count
0,A. Flagler,Oklahoma City Thunder,F,0,6,0,3,0.0,0,0,0.0,0,3,0.0,0,0,0,1,0,0,0,0,0,1,0,1,1,0.0,0.0,0.0,0.0,0.0,0.0,0.0,0.0,1
1,A.J. Green,Milwaukee Bucks,G,72,146,24,55,410.6,5,6,266.7,19,47,375.3,1,16,17,10,9,3,6,1,-20,99,89,82,27,521.5390625,12.2890625,12.9765625,38.0390625,654.2265625,532.5,644.40625,24.125,10
2,A.J. Lawson,Dallas Mavericks,G,14,31,6,13,170.0,1,4,50.0,1,4,50.0,2,4,6,1,4,0,0,1,-7,21,20,15,7,27.950413223140497,5.983471074380166,0.7685950413223139,0.8512396694214874,35.0,33.04132231404959,28.43801652892562,8.223140495867767,4
3,Aaron Gordon,Denver Nuggets,PF,148,299,60,102,644.9,25,31,635.0,3,18,108.3,17,46,63,40,21,13,21,3,104,251,211,188,103,307.7950138504155,164.18005540166206,42.692520775623265,2.401662049861496,672.7229916897508,836.7950138504156,239.25207756232686,111.34349030470914,10
4,Aaron Holiday,Houston Rockets,G,51,119,19,46,263.4,3,3,100.0,10,21,269.2,3,4,7,13,14,5,7,1,-41,71,58,64,20,354.925,5.700000000000001,9.7,24.1,423.925,421.625,356.62500000000006,16.0,10
5,Aaron Nesmith,Indiana Pacers,SF,114,275,38,84,440.6,22,31,598.8,16,43,381.5,4,26,30,16,30,8,12,6,8,160,144,130,46,335.77777777777777,54.400000000000006,16.0,8.57777777777778,672.1777777777778,581.7777777777778,389.77777777777777,106.80000000000001,10
6,Aaron Wiggins,Oklahoma City Thunder,SG,64,161,24,47,490.0,9,10,450.0,7,18,300.0,11,12,23,4,9,10,9,7,46,91,87,68,27,149.98185941043084,7.816326530612247,4.489795918367347,7.662131519274377,196.83219954648527,158.31519274376416,183.11111111111111,17.693877551020414,10
7,Al Horford,Boston Celtics,C,75,252,31,60,451.4,6,6,300.0,7,25,229.3,13,48,61,15,14,5,4,8,55,151,136,90,76,200.53086419753086,53.44444444444444,30.475308641975303,7.364197530864198,500.7716049382716,340.71604938271605,331.51234567901236,112.99382716049384,10
8,Alec Burks,New York Knicks,SG,65,148,24,84,261.0,7,13,258.3,10,41,231.79999999999998,5,11,16,8,6,2,6,1,-51,89,81,73,24,164.10493827160496,12.271604938271606,4.9444444444444455,5.111111111111111,251.4444444444444,236.5,178.08641975308643,18.179012345679013,10
9,Aleksej Pokusevski,Charlotte Hornets,F,7,8,2,2,100.0,2,2,100.0,1,1,100.0,0,2,2,0,0,1,1,1,7,9,9,7,2,6.25,0.5625,0.0,0.0625,10.5625,10.5625,6.25,0.5625,1
10,Aleksej Pokusevski,Oklahoma City Thunder,F,4,13,1,3,50.0,1,2,50.0,1,2,100.0,0,1,1,0,0,1,0,0,-8,5,5,4,1,20.5,1.625,0.0,0.625,33.625,33.625,20.5,1.625,2
11,Alex Caruso,Chicago Bulls,SG,85,301,33,80,437.4,4,5,200.0,15,49,331.7,6,28,34,33,27,25,11,12,-21,152,119,118,67,114.89999999999999,35.625,42.125,10.600000000000001,137.20000000000002,149.125,136.225,44.5,10
12,Alex Len,Sacramento Kings,C,29,92,13,24,386.7,3,7,60.0,0,1,0.0,10,16,26,4,12,4,6,7,18,59,55,33,30,104.40236686390533,5.994082840236688,4.485207100591716,0.0,102.56213017751479,101.09467455621301,110.05917159763312,6.289940828402368,9
13,Alondes Williams,Miami Heat,G,0,6,0,1,0.0,0,0,0.0,0,1,0.0,0,1,1,0,0,0,1,0,-2,1,1,0,1,0.0,0.25,0.0,0.0,0.25,0.25,0.0,0.25,1
14,Alperen Sengun,Houston Rockets,C,214,329,82,159,512.7,45,73,651.5,5,14,250.0,42,64,106,49,38,15,27,8,-9,369,320,263,155,800.0,198.8,119.92500000000001,4.6000000000000005,1735.925,1511.6000000000001,893.325,449.72499999999997,10
15,Amen Thompson,Houston Rockets,F,97,227,40,83,396.6,16,25,468.3,1,12,33.3,26,41,67,18,26,15,11,17,0,182,164,115,85,548.0612244897959,77.6938775510204,20.839002267573694,0.927437641723356,1013.1383219954648,819.6734693877552,728.1111111111111,111.94784580498865,10
16,Amir Coffey,LA Clippers,SG,46,220,18,50,295.0,4,5,250.0,6,22,225.0,5,16,21,16,15,10,6,2,-7,83,67,62,37,208.43100189035917,29.249527410207946,14.215500945179583,7.379962192816635,314.8638941398866,255.01890359168237,269.88279773156904,41.85822306238185,10
17,Andre Drummond,Chicago Bulls,C,92,205,37,73,398.9,18,28,666.7,0,0,0.0,36,68,104,2,21,2,13,7,25,198,196,94,106,322.28512396694214,349.14049586776855,1.6033057851239667,0.0,1124.3347107438017,1084.5661157024792,335.27685950413223,377.52066115702473,10
18,Andre Jr. Jackson,Milwaukee Bucks,G,8,62,3,8,233.3,0,0,0.0,2,5,200.0,0,8,8,8,6,3,2,0,-3,24,16,16,16,11.58677685950413,3.0,8.256198347107436,1.4380165289256195,32.2809917355372,25.132231404958677,17.644628099173552,12.347107438016527,5
19,Andrew Nembhard,Indiana Pacers,PG,100,294,43,80,586.2,2,3,66.7,12,27,516.7,7,23,30,34,21,17,13,1,-8,164,130,134,64,75.09141274238229,38.443213296398895,41.91689750692521,5.689750692520775,130.79778393351802,77.08033240997229,124.44875346260388,84.72022160664821,10
20,Andrew Wiggins,Golden State Warriors,SF,128,257,49,100,478.1,13,15,616.7,17,37,456.6,10,28,38,22,18,12,8,3,16,188,166,150,60,242.34903047091413,40.2382271468144,11.689750692520775,8.878116343490305,335.73407202216066,330.404432132964,241.3573407202216,58.24930747922438,10
21,Anfernee Simons,Portland Trail Blazers,SG,215,375,77,186,411.3,28,31,857.1,33,85,383.3,5,35,40,62,25,6,39,0,-66,317,255,277,102,747.9478458049886,24.566893424036284,125.12471655328798,24.410430839002267,1172.219954648526,753.0,1123.308390022676,193.55102040816328,10
22,Anthony Black,Orlando Magic,G,70,238,23,55,366.9,11,16,450.0,13,25,408.3,7,23,30,11,17,6,9,2,23,111,100,81,41,341.19113573407196,56.0,5.565096952908587,18.196675900277008,520.1468144044321,480.6648199445983,377.51523545706374,64.72299168975069,10
23,Anthony Davis,Los Angeles Lakers,PF,251,363,96,171,561.1,58,69,758.4,1,10,33.3,27,104,131,22,23,8,16,23,8,404,382,273,153,634.925,26.5,43.22500000000001,1.125,842.5,877.8250000000002,627.0,42.32499999999999,10
24,Anthony Edwards,Minnesota Timberwolves,SG,273,354,97,224,419.6,58,69,850.1,21,68,305.7,5,47,52,40,13,16,23,8,46,365,325,313,92,956.5,45.65289256198347,28.975206611570254,20.15702479338843,1241.1942148760331,1151.2438016528927,1031.6570247933885,89.42148760330579,10
25,Anthony Gill,Washington Wizards,PF,3,21,1,4,100.0,0,0,0.0,1,2,100.0,0,3,3,3,0,4,4,0,13,9,6,6,6,6.333333333333334,2.5925925925925926,7.333333333333333,0.8148148148148148,9.814814814814815,14.037037037037038,6.333333333333334,5.703703703703704,3
26,Ashton Hagans,Portland Trail Blazers,G,43,187,16,41,421.3,8,11,350.0,3,11,100.0,7,19,26,32,26,7,19,7,-23,101,69,75,58,119.44444444444443,15.11111111111111,52.44444444444445,4.111111111111112,376.5111111111111,188.91111111111115,282.6,92.0,10
27,Ausar Thompson,Detroit Pistons,F,103,314,42,87,508.0,11,25,325.0,8,29,195.3,15,44,59,21,26,17,14,11,-6,183,162,124,80,120.725,29.0,23.525,7.999999999999999,335.70000000000005,230.82500000000002,196.89999999999998,81.225,10
28,Austin Reaves,Los Angeles Lakers,SG,158,343,63,117,548.4,9,11,450.0,23,51,420.7,5,41,46,65,14,8,25,4,-14,269,204,223,111,146.5,34.0,90.58264462809917,14.21900826446281,209.08264462809922,102.5,285.9917355371901,91.67355371900827,10
29,Ayo Dosunmu,Chicago Bulls,SG,146,387,56,128,431.4,11,13,358.3,23,62,357.7,10,28,38,58,22,12,20,4,-50,242,184,204,96,208.56198347107437,41.29338842975207,47.29338842975206,14.338842975206612,250.6942148760331,204.33471074380165,228.33471074380165,115.17355371900824,10
30,Bam Adebayo,Miami Heat,C,186,349,76,146,504.2,34,48,645.3,0,3,0.0,22,70,92,41,21,13,26,8,36,319,278,227,133,470.0,43.20000000000001,83.8,0.0,613.0,452.0,557.0,201.0,10
31,Ben Sheppard,Indiana Pacers,G,83,191,29,55,518.7,5,5,300.0,20,40,496.2,1,25,26,6,24,9,4,2,25,115,109,89,32,183.9140625,66.0,14.6640625,24.5,370.15625,302.6640625,258.65625,73.4140625,10
32,Ben Simmons,Brooklyn Nets,PG,53,168,24,38,521.1,5,11,150.0,0,0,0.0,15,39,54,46,20,9,12,4,-5,153,107,99,100,134.88888888888889,64.0,78.88888888888889,0.0,382.0,162.8888888888889,300.0,196.88888888888889,9
33,Bennedict Mathurin,Indiana Pacers,SG,139,275,44,115,340.3,35,45,614.5,16,44,245.0,10,33,43,23,24,7,17,4,-18,205,182,162,66,781.0,123.09467455621302,38.14792899408284,30.68639053254438,1447.5443786982248,1127.940828402367,996.8402366863905,265.00591715976327,10
34,Bilal Coulibaly,Washington Wizards,SG,87,277,28,78,430.9,22,30,603.3,9,37,173.3,14,28,42,13,25,8,13,6,-112,142,129,100,55,270.27777777777777,47.882716049382715,6.277777777777778,14.944444444444443,525.8827160493828,468.0864197530864,316.0,66.23456790123457,10
35,Bismack Biyombo,Oklahoma City Thunder,C,2,22,1,4,33.3,0,0,0.0,0,0,0.0,2,1,3,1,5,0,1,1,5,6,5,3,4,2.75,2.0,0.6875,0.0,14.1875,8.75,6.1875,4.6875,3
36,Blake Wesley,San Antonio Spurs,G,43,158,15,32,358.3,12,14,450.0,1,9,100.0,3,13,16,32,14,3,10,3,-21,91,59,75,48,155.6893424036281,20.458049886621314,80.9795918367347,1.0907029478458048,303.7755102040816,167.40816326530611,261.02267573696145,132.4716553287982,10
37,Bobby Portis,Milwaukee Bucks,F,165,236,70,132,524.4,13,16,530.0,12,32,411.7,17,63,80,16,19,6,12,3,17,261,245,181,96,256.9395085066163,96.17013232514178,12.54820415879017,9.708884688090738,611.1285444234404,541.7750472589792,299.97542533081287,135.0359168241966,10
38,Bogdan Bogdanovic,Atlanta Hawks,SG,158,320,55,129,409.3,20,21,850.0,28,72,386.5,7,30,37,36,16,12,24,5,48,231,195,194,73,379.12471655328795,28.73696145124717,16.458049886621314,17.709750566893426,418.1111111111111,384.6326530612245,437.38775510204084,20.410430839002267,10
39,Bojan Bogdanovic,New York Knicks,SF,138,241,47,114,382.2,21,26,625.0,23,63,342.2,4,24,28,11,23,5,14,1,-74,177,166,149,39,371.6015625,31.9765625,24.90625,32.1015625,596.125,478.65625,468.9140625,77.0390625,10
40,Bol Bol,Phoenix Suns,C,88,157,39,65,582.4,3,5,200.0,7,19,361.7,14,37,51,4,15,2,2,7,1,143,139,92,55,438.15625,119.7265625,2.4765625,4.2890625,933.125,960.1640625,421.4140625,111.90625,10
41,Bones Hyland,LA Clippers,PG,34,91,14,44,285.1,1,2,50.0,5,22,183.3,1,6,7,19,9,6,7,1,-10,60,41,53,26,89.10743801652892,3.2479338842975203,37.0,9.0,104.74380165289256,121.01652892561985,85.3801652892562,27.702479338842974,8
42,Bradley Beal,Phoenix Suns,SG,217,306,83,156,572.6,27,32,615.0,24,47,581.7,10,26,36,47,22,14,27,2,32,300,253,264,83,1244.125,76.4140625,59.5390625,26.5390625,1679.625,1339.6015625,1583.1015625,137.0,10
43,Brandin Podziemski,Golden State Warriors,G,101,299,38,89,407.8,9,17,258.3,16,39,432.9,19,39,58,49,8,7,12,3,56,208,159,150,107,361.19834710743805,31.3099173553719,47.97107438016529,22.148760330578515,667.900826446281,477.01239669421494,556.5,74.86776859504133,10
44,Brandon Boston Jr.,LA Clippers,SG,31,65,12,33,210.5,4,6,200.0,3,8,200.0,4,5,9,2,6,1,0,3,-13,42,40,33,11,106.33884297520662,12.289256198347106,1.471074380165289,1.8099173553719008,163.70247933884298,142.3801652892562,120.42148760330579,21.0,6
45,Brandon Ingram,New Orleans Pelicans,SF,212,334,76,157,502.6,47,58,719.5,13,36,346.2,7,42,49,62,28,8,37,10,46,323,261,274,111,416.94444444444446,48.60493827160494,21.38271604938272,11.444444444444445,572.3271604938271,654.9197530864197,361.3641975308642,42.9753086419753,10
46,Brandon Miller,Charlotte Hornets,F,193,357,76,178,422.4,15,18,500.0,26,78,328.8,9,44,53,27,22,13,26,7,-39,273,246,220,80,251.54064272211718,53.0,27.66540642722117,10.427221172022684,453.33270321361056,482.80151228733456,235.8979206049149,66.83931947069944,10
47,Brandon Williams,Dallas Mavericks,G,5,19,1,7,33.3,3,3,100.0,0,1,0.0,1,1,2,4,1,0,1,0,-12,11,7,9,6,18.0,3.0000000000000004,3.0,0.0,29.999999999999993,15.666666666666668,29.0,9.333333333333336,3
48,Braxton Key,Denver Nuggets,F,2,6,1,1,100.0,0,1,0.0,0,0,0.0,1,1,2,0,1,0,0,0,2,4,4,2,2,2.25,1.0,0.0,0.0,6.25,6.25,2.25,1.0,1
49,Brice Sensabaugh,Utah Jazz,F,64,156,24,48,366.1,7,8,266.7,9,25,320.0,4,17,21,8,13,4,15,0,-23,93,85,72,29,168.22222222222223,109.0,8.0,5.222222222222223,498.22222222222223,440.2222222222222,216.22222222222223,127.0,8
50,Brook Lopez,Milwaukee Bucks,C,94,284,32,77,391.5,11,14,450.0,19,49,355.1,11,32,43,17,17,6,5,20,123,154,137,111,60,244.50000000000003,78.5,14.325000000000003,23.4,474.42499999999995,429.0,265.525,117.225,10
51,Bruce Brown,Toronto Raptors,SF,78,238,29,68,397.2,18,18,700.0,2,17,100.0,6,25,31,23,17,4,7,1,-65,132,109,101,54,175.77777777777777,42.111111111111114,24.37777777777778,2.0,376.0,261.5777777777778,268.9111111111111,87.77777777777779,10
52,Bruno Fernando,Atlanta Hawks,PF,61,192,25,46,495.8,11,16,425.0,0,0,0.0,22,36,58,10,28,10,11,7,-14,129,119,71,68,107.40625,105.6015625,14.15625,0.0,170.0390625,165.3515625,136.125,95.7265625,10
53,Bryce McGowens,Charlotte Hornets,G,54,155,18,37,330.8,13,18,441.7,5,15,180.0,3,21,24,8,15,7,4,3,-10,86,78,62,32,239.21799307958474,28.50519031141868,5.6055363321799305,6.923875432525952,407.15570934256056,394.8927335640138,254.0968858131488,31.494809688581313,10
54,Buddy Hield,Philadelphia 76ers,SG,126,310,44,118,368.5,8,8,300.0,30,77,408.6,5,25,30,44,24,12,15,4,-55,200,156,170,74,166.61157024793388,12.516528925619834,58.0,8.743801652892564,385.0123966942149,212.46694214876032,356.97520661157023,52.69834710743802,10
55,CJ McCollum,New Orleans Pelicans,SG,152,283,58,148,368.7,10,12,241.7,26,79,308.1,4,37,41,34,18,5,10,4,19,227,193,186,75,645.7777777777778,14.901234567901234,47.586419753086425,26.5,992.5,780.3086419753087,854.8456790123457,65.61111111111111,10
56,Cade Cunningham,Detroit Pistons,PG,245,323,87,178,487.0,41,47,607.8,30,64,425.8,10,39,49,79,21,5,34,6,6,373,294,324,128,620.1111111111111,34.901234567901234,43.61111111111111,25.734567901234566,972.4012345679013,862.2716049382716,732.5,76.25308641975309,10
57,Caleb Houstan,Orlando Magic,G,32,96,10,21,211.1,2,2,100.0,10,20,244.4,2,9,11,2,8,2,2,2,7,45,43,34,13,134.0,29.688888888888883,1.4000000000000004,17.200000000000003,267.75555555555553,250.8888888888889,141.0,40.95555555555556,5
58,Caleb Martin,Miami Heat,SF,108,291,37,84,435.1,15,18,626.7,19,42,451.3,8,34,42,18,27,5,13,9,52,168,150,126,60,225.20000000000002,55.6,13.825000000000001,18.5,447.225,427.6,256.025,58.225,10
59,Cam Reddish,Los Angeles Lakers,SF,14,67,5,12,133.3,1,2,50.0,3,7,133.3,3,4,7,0,4,2,1,1,8,21,21,14,7,21.183673469387756,7.0,0.0,0.7551020408163265,19.897959183673468,19.897959183673468,21.183673469387756,7.0,4
60,Cam Thomas,Brooklyn Nets,SG,189,322,68,176,370.8,30,34,882.6,23,62,349.0,6,28,34,35,24,11,16,0,-78,258,223,224,69,570.0612244897959,48.41836734693877,36.95918367346939,33.816326530612244,606.7448979591836,554.5,584.1224489795917,123.56122448979593,10
61,Cam Whitmore,Houston Rockets,F,133,201,49,110,430.8,21,30,485.0,14,50,259.8,14,30,44,6,12,5,17,5,2,183,177,139,50,184.5,62.54938271604938,2.419753086419753,11.438271604938272,288.77777777777777,295.71604938271605,188.25308641975306,54.277777777777786,10
62,Cameron Johnson,Brooklyn Nets,SF,130,248,42,96,410.8,22,26,571.7,24,62,370.9,7,28,35,21,21,10,10,5,-34,186,165,151,56,590.792899408284,61.69822485207101,18.928994082840237,36.437869822485204,802.3313609467457,689.2840236686391,702.4674556213018,82.0,10
63,Cameron Payne,Philadelphia 76ers,PG,105,190,38,89,413.6,14,14,500.0,15,43,286.2,4,12,16,27,16,4,9,1,-9,148,121,132,43,293.12244897959187,25.328798185941043,44.99546485260771,18.95918367346939,419.6734693877551,362.79138321995464,341.12471655328795,79.20408163265307,10
64,Caris LeVert,Cleveland Cavaliers,SG,109,297,40,116,347.8,16,21,443.3,13,47,257.8,7,44,51,70,21,9,17,8,20,230,160,179,121,167.69387755102042,71.40816326530611,115.80498866213154,8.11111111111111,710.1859410430839,382.2040816326531,405.44444444444446,277.44444444444446,10
65,Cason Wallace,Oklahoma City Thunder,G,56,176,22,46,489.1,1,3,100.0,11,27,408.3,9,17,26,13,7,12,5,5,43,95,82,69,39,104.6938775510204,22.594104308390023,8.736961451247165,8.900226757369614,213.9795918367347,190.30839002267572,116.69614512471655,43.0,10
66,Cedi Osman,San Antonio Spurs,SF,36,142,15,32,400.0,0,0,0.0,6,19,216.6,3,18,21,18,12,6,8,0,-32,75,57,54,39,105.05817174515236,15.166204986149584,21.03601108033241,6.448753462603877,107.12742382271466,133.93628808864264,89.08587257617728,25.365650969529085,10
67,Charlie Brown Jr.,New York Knicks,G,3,27,1,5,20.0,0,0,0.0,1,3,33.3,1,1,2,0,4,0,0,1,-6,5,5,3,2,6.79591836734694,3.020408163265307,0.0,0.7551020408163267,18.877551020408163,18.877551020408163,6.79591836734694,3.020408163265307,2
68,Chet Holmgren,Oklahoma City Thunder,PF,182,310,66,117,553.2,33,38,776.7,17,45,319.1,19,71,90,29,22,4,14,19,32,301,272,211,119,426.1179138321996,91.26530612244898,43.090702947845806,18.138321995464853,854.3469387755102,687.0702947845805,593.8163265306123,133.9342403628118,10
69,Chimezie Metu,Phoenix Suns,PF,4,15,2,4,50.0,0,0,0.0,0,0,0.0,1,3,4,1,1,2,3,0,-7,9,8,5,5,10.0,4.0,0.625,0.0,34.625,26.0,15.625,7.625,2
70,Chris Boucher,Toronto Raptors,PF,60,103,21,27,523.3,14,16,450.0,4,9,216.7,10,25,35,5,10,1,9,5,11,100,95,65,40,138.47,46.629999999999995,5.670000000000001,3.7199999999999998,402.07,320.48,189.28,83.08,7
71,Chris Duarte,Sacramento Kings,SG,39,106,14,29,275.0,1,1,100.0,10,21,266.7,5,13,18,3,6,5,0,3,0,60,57,42,21,231.75,13.984375,1.734375,11.734375,320.4375,303.359375,248.109375,16.4375,7
72,Chris Livingston,Milwaukee Bucks,F,0,6,0,2,0.0,0,0,0.0,0,2,0.0,0,1,1,1,4,0,1,0,-10,2,1,1,2,0.0,0.0625,0.5625,0.0,1.0,0.0625,0.5625,1.0,1
73,Chris Paul,Golden State Warriors,PG,66,166,24,52,313.6,5,6,175.0,13,29,300.0,2,23,25,47,7,16,8,0,-18,138,91,113,72,114.23,3.75,18.0,6.88,105.08000000000001,146.28,83.03,11.75,7
74,Christian Braun,Denver Nuggets,G,63,203,24,50,517.1,8,16,258.3,7,19,266.7,12,30,42,13,25,8,5,8,49,118,105,76,55,130.24653739612188,51.81717451523546,12.711911357340723,8.113573407202216,252.3490304709141,278.50692520775624,112.5595567867036,56.05817174515235,10
75,Christian Wood,Los Angeles Lakers,F,59,133,22,51,477.0,11,14,450.0,4,19,225.0,6,28,34,6,12,5,5,2,-14,99,93,65,40,152.9,54.39999999999999,4.3999999999999995,2.4000000000000004,304.9,284.1,156.5,76.0,10
76,Chuma Okeke,Orlando Magic,PF,0,19,0,2,0.0,0,0,0.0,0,2,0.0,0,1,1,1,2,1,0,0,-3,2,1,1,2,2.1479289940828403,0.6745562130177515,0.8639053254437871,0.01775147928994083,1.8994082840236688,3.082840236686391,1.7100591715976334,0.7928994082840237,3
77,Clint Capela,Atlanta Hawks,C,100,227,41,83,499.9,18,24,575.0,0,0,0.0,41,56,97,15,22,2,11,10,6,212,197,115,112,177.7777777777778,73.31111111111112,14.777777777777779,0.0,510.3111111111111,428.20000000000005,249.0,98.97777777777779,10
78,Coby White,Chicago Bulls,PG,215,404,73,166,438.4,37,41,838.3,32,84,370.3,6,46,52,55,28,9,24,2,-41,322,267,270,107,592.5206611570247,31.838842975206614,75.47520661157026,37.64049586776859,675.5041322314049,616.2190082644628,609.4917355371902,149.62809917355372,10
79,Cody Martin,Charlotte Hornets,SF,69,285,28,76,367.2,6,7,250.0,7,30,228.2,6,44,50,42,15,11,20,7,-28,161,119,111,92,119.44444444444446,25.111111111111107,68.97777777777779,3.4444444444444446,210.51111111111112,123.0,199.84444444444446,101.2,10
80,Cody Zeller,New Orleans Pelicans,C,5,26,2,5,100.0,1,2,50.0,0,0,0.0,3,8,11,1,3,2,3,0,11,17,16,6,12,3.6122448979591835,2.795918367346939,0.8775510204081631,0.0,7.0,9.30612244897959,2.6530612244897958,2.3265306122448974,4
81,Colby Jones,Sacramento Kings,G,2,7,1,3,33.3,0,0,0.0,0,0,0.0,0,3,3,1,1,0,0,0,0,6,5,3,4,1.0,1.0,0.25,0.0,6.25,4.0,2.25,2.25,1
82,Cole Anthony,Orlando Magic,PG,104,232,42,95,435.4,12,17,633.3,8,32,248.3,4,32,36,31,24,10,12,8,27,171,140,135,67,195.50413223140495,44.764462809917354,51.971074380165284,7.867768595041323,264.9669421487603,206.202479338843,288.21900826446284,62.78512396694215,10
83,Cole Swider,Miami Heat,F,2,11,0,4,0.0,2,2,100.0,0,4,0.0,0,2,2,1,0,0,3,0,-8,5,4,3,3,2.0,0.0,0.5,0.0,4.5,2.0,4.5,0.5,2
84,Collin Gillespie,Denver Nuggets,G,30,64,11,20,197.8,1,3,50.0,7,11,200.0,0,7,7,7,6,5,5,0,8,44,37,37,14,157.84,3.24,7.24,9.24,242.96,167.15999999999997,231.16,12.96,4
85,Collin Sexton,Utah Jazz,PG,215,308,69,145,466.5,54,64,765.6,23,50,373.4,5,15,20,57,17,15,18,3,15,292,235,272,77,363.40000000000003,14.625,55.324999999999996,24.125,646.5,447.52500000000003,528.625,103.7,10
86,Corey Kispert,Washington Wizards,SF,132,254,46,108,413.4,18,23,508.3,22,62,343.5,3,29,32,26,20,7,18,3,-59,190,164,158,58,374.625,20.0,48.800000000000004,19.6,683.025,437.625,589.225,99.60000000000001,10
87,Cory Joseph,Golden State Warriors,PG,13,33,5,10,150.0,0,0,0.0,3,7,116.7,1,3,4,5,4,0,1,0,-6,22,17,18,9,20.666666666666664,0.6666666666666666,0.6666666666666666,2.0,12.666666666666666,18.666666666666664,14.0,2.0,3
88,Craig Jr. Porter,Cleveland Cavaliers,G,23,45,10,20,208.3,3,3,200.0,0,2,0.0,3,7,10,7,3,2,2,0,-6,40,33,30,17,113.2603550295858,12.958579881656803,5.704142011834319,0.0,213.73372781065086,183.11834319526628,138.4319526627219,24.106508875739642,5
89,D'Angelo Russell,Los Angeles Lakers,PG,208,355,76,151,491.5,21,26,710.0,35,78,395.0,4,40,44,68,24,11,22,4,-2,320,252,276,112,848.2448979591837,56.471655328798185,162.6485260770975,53.49886621315193,1219.0702947845807,977.8866213151927,957.6961451247165,350.8526077097506,10
90,D.J. Carton,Toronto Raptors,G,8,31,2,7,83.3,3,4,150.0,1,4,50.0,2,1,3,3,1,1,1,0,-30,14,11,11,6,8.666666666666668,2.0,2.0,0.6666666666666667,8.666666666666666,2.6666666666666665,18.666666666666668,0.0,3
91,Daishen Nix,Minnesota Timberwolves,SG,5,5,2,3,66.7,0,0,0.0,1,2,50.0,0,0,0,0,1,1,0,0,6,5,5,5,0,2.25,0.0,0.25,0.0625,1.0,2.25,1.0,0.25,1
92,Dalano Banton,Portland Trail Blazers,G,140,227,52,120,400.7,19,30,476.7,17,44,295.8,15,31,46,25,16,5,11,6,-18,211,186,165,71,780.4432132963989,74.7202216066482,40.501385041551245,28.180055401662045,1605.1939058171745,1232.409972299169,1094.8282548476454,173.62049861495845,10
93,Dalen Terry,Chicago Bulls,F,27,107,11,23,398.3,2,4,100.0,3,10,183.3,5,13,18,15,17,8,2,0,2,60,45,42,33,46.44378698224853,26.6094674556213,8.366863905325445,2.0946745562130173,132.4023668639053,111.2544378698225,62.621301775147934,39.946745562130175,9
94,Damian Jones,Cleveland Cavaliers,C,9,33,3,7,150.0,3,3,100.0,0,0,0.0,3,7,10,1,4,0,3,4,-27,20,19,10,11,36.830000000000005,17.72,0.75,0.0,114.67999999999999,104.02999999999999,43.68000000000001,22.270000000000003,3
95,Damian Lillard,Milwaukee Bucks,PG,227,336,73,173,435.3,45,48,905.0,36,91,416.9,3,48,51,72,21,9,29,2,117,350,278,299,123,548.2653061224489,74.32879818594104,73.92743764172336,7.387755102040818,758.5532879818594,677.4104308390022,602.9274376417234,174.73696145124717,10
96,Daniel Gafford,Dallas Mavericks,C,84,176,36,44,590.5,12,20,365.0,0,0,0.0,17,42,59,7,27,5,8,13,-18,150,143,91,66,418.7645429362881,121.53185595567865,6.479224376731302,0.0,1025.290858725762,910.0914127423824,489.97506925207756,172.0,10
97,Daniel Theis,LA Clippers,C,53,158,24,48,441.1,2,2,100.0,3,14,175.0,12,34,46,8,17,0,7,6,13,107,99,61,54,94.25308641975309,139.43827160493825,7.882716049382715,2.111111111111111,390.5,323.9382716049383,139.49382716049382,168.64197530864197,10
98,Danilo Gallinari,Milwaukee Bucks,PF,21,106,6,23,333.3,8,8,300.0,1,12,100.0,5,9,14,10,10,3,5,1,-27,45,35,31,24,70.125,12.8515625,14.15625,1.65625,111.1015625,95.2890625,79.40625,33.5390625,10
99,Dante Exum,Dallas Mavericks,G,28,91,7,16,263.3,11,13,400.0,3,5,200.0,1,12,13,18,9,1,2,0,29,59,41,46,31,94.34375,9.09375,27.5,3.59375,254.875,151.875,172.09375,61.84375,6
100,Danuel House Jr.,Philadelphia 76ers,SF,26,96,7,17,166.7,11,11,400.0,1,8,33.3,4,8,12,6,10,3,1,1,-25,44,38,32,18,22.8,11.2,6.800000000000001,0.8000000000000002,26.8,35.2,21.2,11.200000000000001,5
101,Dario Saric,Golden State Warriors,PF,28,112,12,37,298.3,2,3,100.0,2,21,83.3,7,17,24,19,8,0,12,1,-23,71,52,47,43,52.5,23.025000000000002,12.925,1.6999999999999997,109.0,77.625,65.325,54.5,10
102,Darius Garland,Cleveland Cavaliers,PG,199,372,68,167,401.2,26,33,622.4,37,88,410.6,5,22,27,73,26,11,31,0,46,299,226,272,100,521.0,27.276859504132233,48.421487603305785,59.42975206611571,691.6570247933885,719.095041322314,510.33057851239676,58.9297520661157,10
103,David Roddy,Phoenix Suns,F,80,196,31,81,418.8,11,17,401.7,7,32,171.9,6,28,34,14,11,3,13,1,-85,128,114,94,48,401.91836734693874,111.26530612244899,22.0,10.5,905.2653061224489,732.6938775510204,539.0612244897959,168.69387755102042,10
104,Davion Mitchell,Sacramento Kings,PG,64,145,26,38,632.5,2,4,100.0,10,19,383.3,1,7,8,13,15,1,4,1,-38,85,72,77,21,203.32879818594105,10.471655328798185,10.111111111111112,14.0,274.50566893424036,251.6009070294785,218.83673469387756,27.979591836734695,10
105,Davis Bertans,Charlotte Hornets,SF,99,193,33,80,457.2,4,5,166.7,29,69,462.8,4,16,20,11,16,5,2,2,22,130,119,110,31,159.4,54.17777777777778,20.24444444444444,13.177777777777777,377.1111111111111,296.9111111111111,202.17777777777778,111.84444444444443,10
106,Day'Ron Sharpe,Brooklyn Nets,C,62,137,24,40,621.8,11,18,350.0,3,5,200.0,23,31,54,15,18,4,13,3,-24,131,116,77,69,79.05785123966942,30.413223140495866,10.520661157024794,4.107438016528926,206.28925619834712,148.1487603305785,125.23140495867769,52.900826446280995,10
107,De'Aaron Fox,Sacramento Kings,PG,285,366,117,233,502.0,33,45,556.7,18,64,274.8,14,35,49,70,27,24,35,2,30,404,334,355,119,858.8282548476454,78.7174515235457,62.19390581717453,15.617728531855954,1127.1634349030471,1270.1551246537394,731.7202216066482,125.02770083102494,10
108,De'Andre Hunter,Atlanta Hawks,SF,182,272,59,116,511.59999999999997,41,50,761.1,23,49,465.7,5,31,36,10,27,8,10,3,27,228,218,192,46,212.99382716049388,43.3641975308642,8.771604938271604,10.160493827160494,370.9197530864197,388.9382716049382,192.0,55.111111111111114,10
109,De'Anthony Melton,Philadelphia 76ers,SG,23,43,7,20,75.0,4,4,200.0,5,14,75.0,0,5,5,5,3,2,1,1,-2,33,28,28,10,128.66666666666666,2.666666666666667,2.666666666666667,8.666666666666666,206.0,164.66666666666669,164.66666666666669,10.666666666666668,3
110,DeAndre Jordan,Denver Nuggets,C,19,38,9,15,350.0,1,1,100.0,0,0,0.0,7,10,17,1,6,0,0,1,-17,37,36,20,18,13.88888888888889,38.0,0.8055555555555557,0.0,87.25,72.55555555555556,19.25,48.1388888888889,5
111,DeMar DeRozan,Chicago Bulls,SF,258,396,82,170,501.1,82,90,930.0,12,32,280.0,6,45,51,61,22,5,11,3,-20,370,309,319,112,446.0,85.85537190082646,41.97107438016529,11.838842975206612,558.3305785123966,643.49173553719,333.06198347107437,155.60330578512398,10
112,Dean Wade,Cleveland Cavaliers,PF,46,178,15,35,260.2,5,7,216.7,11,31,233.4,4,27,31,7,8,3,1,9,-23,84,77,53,38,470.077097505669,34.98185941043084,6.219954648526077,30.90022675736962,718.8390022675737,715.1179138321996,467.0,48.0,10
113,Deandre Ayton,Portland Trail Blazers,C,187,321,89,144,595.1,9,9,400.0,0,1,0.0,30,88,118,21,18,12,14,11,-52,326,305,208,139,723.5325443786982,301.7514792899408,11.213017751479288,0.0,1706.7100591715978,1728.7159763313607,725.5621301775147,288.92899408284023,10
114,Dejounte Murray,Atlanta Hawks,SG,224,356,90,190,464.4,23,33,723.8,21,69,279.7,10,55,65,79,13,14,28,5,-20,368,289,303,144,611.7777777777778,56.47530864197531,64.5,27.444444444444443,687.8271604938271,754.104938271605,576.9444444444443,89.53086419753087,10
115,Delon Wright,Miami Heat,SG,40,119,14,28,466.6,7,8,183.3,5,11,350.0,4,9,13,18,3,7,0,3,9,71,53,58,31,105.33333333333331,5.395833333333334,30.25,4.395833333333333,231.8958333333333,128.3958333333333,191.58333333333337,52.89583333333333,9
116,Deni Avdija,Washington Wizards,SF,195,357,71,143,492.9,34,45,668.7,19,44,396.6,18,84,102,33,26,6,28,5,-21,330,297,228,135,950.5,162.17901234567898,19.0,28.08641975308642,1668.79012345679,1563.1234567901233,1024.5,212.84567901234567,10
117,Dennis Schroder,Brooklyn Nets,PG,159,312,60,125,461.1,13,21,346.4,26,51,511.6,5,22,27,58,19,5,24,3,-40,244,186,217,85,538.5510204081631,51.66213151927438,71.6734693877551,22.489795918367346,937.9002267573696,617.9818594104308,824.3469387755102,157.45804988662132,10
118,Dennis Smith Jr.,Brooklyn Nets,PG,54,186,20,56,360.5,8,13,383.3,6,22,191.5,5,20,25,31,20,12,12,2,4,110,79,85,56,119.625,28.1,49.125,2.4000000000000004,182.89999999999998,102.92499999999998,193.4,83.42500000000001,10
119,Dereck II Lively,Dallas Mavericks,C,78,213,34,43,715.7,10,22,319.4,0,0,0.0,18,25,43,6,23,9,4,16,28,127,121,84,49,315.7361111111111,68.5,2.4027777777777777,0.0,677.0,637.9027777777778,346.5,79.2361111111111,10
120,Derrick Jones Jr.,Dallas Mavericks,SF,49,151,17,33,355.8,8,14,350.0,7,16,175.0,7,17,24,6,6,5,6,4,13,79,73,55,30,409.6111111111111,56.27777777777778,2.9444444444444446,22.5,630.5,636.7777777777778,408.1111111111111,54.44444444444444,10
121,Derrick Rose,Memphis Grizzlies,PG,49,95,20,37,377.7,5,6,266.7,4,8,233.3,0,15,15,21,3,1,9,0,-9,85,64,70,36,70.0,14.857142857142858,12.0,3.7142857142857144,188.85714285714286,116.85714285714286,128.0,40.857142857142854,7
122,Derrick White,Boston Celtics,PG,137,320,51,92,530.4,12,12,600.0,23,53,340.0,7,38,45,62,15,10,15,14,163,244,182,199,107,632.2,28.724999999999998,34.099999999999994,40.725,503.0250000000001,566.225,536.5,95.32499999999999,10
123,Devin Booker,Phoenix Suns,SG,250,335,84,182,451.9,65,73,921.0,17,50,304.4,7,25,32,53,30,10,21,3,4,335,282,303,85,767.3469387755102,41.03061224489796,72.13265306122449,26.622448979591834,1227.0,1042.4183673469388,950.4591836734694,114.63265306122449,10
124,Devin Vassell,San Antonio Spurs,SG,223,352,87,178,483.3,22,30,760.0,27,61,442.1,9,42,51,59,10,12,23,9,-17,333,274,282,110,535.5152354570637,71.56509695290859,44.40720221606648,16.113573407202217,720.1468144044321,552.9695290858725,740.6648199445983,78.0,10
125,Devonte' Graham,San Antonio Spurs,PG,8,22,3,6,75.0,0,0,0.0,2,4,100.0,0,5,5,0,2,1,0,0,8,13,13,8,5,48.0,0.6875,0.0,3.0,54.6875,54.6875,48.0,0.6875,3
126,Dillon Brooks,Houston Rockets,SF,80,313,28,87,290.0,11,15,300.0,13,52,240.0,11,32,43,19,23,9,4,1,-34,142,123,99,62,352.1224489795918,75.40816326530613,4.981859410430839,16.696145124716555,548.3083900226758,526.0612244897959,378.4512471655329,76.30839002267572,10
127,Domantas Sabonis,Sacramento Kings,PF,207,367,87,157,559.4,30,43,622.6,3,10,250.0,53,101,154,92,30,13,29,8,12,453,361,299,246,460.8367346938776,119.11111111111111,66.12244897959184,2.265306122448979,858.6009070294784,708.9002267573696,612.9183673469388,182.85260770975057,10
128,Dominick Barlow,San Antonio Spurs,F,50,105,18,29,370.0,14,18,366.6,0,1,0.0,16,13,29,10,15,3,1,3,-4,89,79,60,39,155.62962962962962,53.074074074074076,25.407407407407412,0.0,388.1851851851852,323.0,224.66666666666669,74.62962962962963,6
129,Donovan Mitchell,Cleveland Cavaliers,SG,274,361,89,178,488.7,55,62,912.8,41,89,457.3,5,48,53,54,23,16,32,7,75,381,327,328,107,637.1715976331361,34.31360946745562,21.301775147928993,17.0,917.0,805.5325443786982,737.4674556213017,66.78698224852072,10
130,Donte DiVincenzo,New York Knicks,SG,185,372,68,177,386.7,6,9,250.0,43,123,352.2,11,32,43,35,21,17,24,7,-17,263,228,220,78,348.6049382716049,16.11111111111111,32.47530864197531,25.444444444444446,486.5,407.53086419753095,434.2777777777778,41.88271604938272,10
131,Dorian Finney-Smith,Brooklyn Nets,PF,98,296,38,75,487.4,5,6,175.0,17,47,400.0,20,32,52,21,23,9,16,4,47,171,150,119,73,246.0,66.0,35.800000000000004,12.644444444444444,573.8,478.0,319.4,124.2,10
132,Doug McDermott,Indiana Pacers,SF,38,119,14,43,275.0,1,4,50.0,9,35,206.6,1,6,7,7,7,1,2,0,-14,52,45,45,14,159.40277777777777,6.125,10.125,11.611111111111112,202.7361111111111,184.94444444444443,182.94444444444446,10.5,10
133,Draymond Green,Golden State Warriors,PF,75,253,28,60,505.5,10,13,325.0,9,19,403.3,13,68,81,55,24,6,25,11,13,211,156,130,136,70.26736111111109,96.94444444444444,77.5173611111111,5.0,352.56944444444446,140.2673611111111,238.625,218.40625,10
134,Drew Eubanks,Phoenix Suns,PF,45,155,17,31,457.5,11,12,375.0,0,0,0.0,16,28,44,5,11,5,8,10,-39,94,89,50,49,112.13832199546486,68.55328798185941,3.1859410430838997,0.0,312.6485260770975,307.6938775510204,122.44444444444446,66.38775510204081,10
135,Duncan Robinson,Miami Heat,F,151,327,53,107,500.9,9,10,466.7,36,78,458.5,1,27,28,41,26,12,13,5,72,220,179,192,69,348.72318339100343,21.10726643598616,87.72664359861591,33.3287197231834,394.72664359861596,341.9065743944637,355.68858131487895,154.68858131487892,10
136,Duop Reath,Portland Trail Blazers,C,113,218,43,95,410.40000000000003,13,21,377.4,14,44,253.3,20,19,39,8,28,5,11,10,-47,160,152,121,47,553.125,35.525000000000006,7.825,28.625000000000004,801.025,698.0,633.3,66.2,10
137,Dwight Powell,Dallas Mavericks,C,20,114,7,11,450.0,6,11,325.0,0,0,0.0,10,20,30,8,18,0,9,3,-11,58,50,28,38,23.877551020408166,70.6530612244898,8.367346938775512,0.0,156.93877551020404,128.6122448979592,33.183673469387756,98.04081632653062,8
138,Dylan Windler,Los Angeles Lakers,G,3,14,1,4,25.0,0,0,0.0,1,4,25.0,0,1,1,2,1,0,0,0,-7,6,4,5,3,4.591836734693878,0.510204081632653,0.16326530612244897,0.510204081632653,2.6530612244897966,2.163265306122449,5.0,0.7551020408163267,2
139,Dyson Daniels,New Orleans Pelicans,G,33,147,14,26,261.4,1,2,50.0,4,11,150.0,6,15,21,17,10,14,8,7,23,71,54,50,38,103.42857142857143,16.0,19.714285714285715,3.7142857142857144,128.85714285714286,105.42857142857143,110.85714285714286,51.714285714285715,7
140,Eric Gordon,Phoenix Suns,SG,107,281,37,89,376.9,14,17,516.7,19,52,325.6,2,13,15,20,7,10,9,5,-1,142,122,127,35,517.6111111111111,7.611111111111111,12.030864197530862,20.91975308641975,631.0679012345679,532.4444444444445,612.604938271605,23.271604938271604,10
141,Eugene Omoruyi,Washington Wizards,F,51,116,21,54,301.3,8,12,375.0,1,10,33.3,15,20,35,11,20,10,6,0,-91,97,86,62,46,216.5111111111111,73.4,15.800000000000002,0.9111111111111112,541.0444444444445,419.2444444444444,299.1111111111111,128.4,10
142,Evan Fournier,Detroit Pistons,SG,69,169,24,60,355.9,8,9,450.0,13,38,266.1,2,18,20,12,14,7,7,2,-35,101,89,81,32,294.8224852071006,18.236686390532544,17.62130177514793,14.313609467455622,453.9940828402367,355.71005917159766,401.2485207100592,27.715976331360945,10
143,Evan Mobley,Cleveland Cavaliers,PF,147,305,60,107,547.9,24,42,522.6,3,14,175.0,25,76,101,35,27,12,16,20,-29,283,248,182,136,371.84429065743944,105.37370242214533,75.2006920415225,2.6262975778546713,782.1418685121107,674.0,423.83391003460207,236.7266435986159,10
144,Frank Ntilikina,Charlotte Hornets,PG,0,21,0,5,0.0,0,0,0.0,0,4,0.0,1,4,5,3,3,0,0,0,-2,8,5,3,8,0.0,1.8888888888888888,5.0,0.0,11.555555555555557,1.8888888888888888,5.0,11.555555555555557,2
145,Franz Wagner,Orlando Magic,SF,165,323,64,131,501.9,30,37,774.2,7,40,126.19999999999999,4,44,48,34,22,9,26,8,59,247,213,199,82,376.5041322314049,32.731404958677686,40.611570247933884,15.12809917355372,560.0206611570248,460.5,489.44628099173565,59.921487603305785,10
146,Fred VanVleet,Houston Rockets,PG,165,365,54,134,388.4,21,25,641.7,36,88,393.3,6,29,35,64,24,16,19,5,-25,264,200,229,99,422.6015625,25.90625,104.7265625,29.625,820.625,586.4140625,657.65625,129.7890625,10
147,Furkan Korkmaz,Philadelphia 76ers,SG,36,94,11,25,178.6,7,9,241.7,7,15,208.3,3,10,13,7,6,1,2,2,2,56,49,43,20,274.0,12.833333333333332,6.833333333333333,18.833333333333332,385.3333333333333,306.8333333333333,354.8333333333333,17.333333333333332,6
148,GG Jackson,Memphis Grizzlies,F,135,254,48,117,414.5,21,30,563.3,18,53,335.0,12,24,36,6,13,4,16,6,-30,177,171,141,42,410.5,74.62345679012346,5.234567901234568,27.611111111111114,459.71604938271605,473.1234567901235,399.7345679012346,77.21604938271605,10
149,Garrett Temple,Toronto Raptors,SF,5,12,2,4,50.0,1,2,50.0,0,2,0.0,1,0,1,0,2,1,1,0,-4,6,6,5,1,14.0625,0.25,0.0,0.0,18.0625,18.0625,14.0625,0.25,1
150,Garrison Mathews,Atlanta Hawks,SG,27,143,8,25,375.0,3,3,100.0,8,22,408.4,5,14,19,3,15,2,0,0,-2,49,46,30,22,46.70637119113574,25.365650969529085,2.1800554016620497,5.617728531855955,123.3213296398892,111.26869806094183,49.772853185595565,36.53185595567867,10
151,Gary Harris,Orlando Magic,SG,76,240,27,51,530.9,3,5,150.0,19,34,563.3,3,13,16,16,16,13,4,5,28,108,92,92,32,102.0,16.8,22.8,12.244444444444445,161.6,160.0,116.0,27.200000000000003,10
152,Gary Payton II,Golden State Warriors,SG,50,144,23,39,449.2,1,3,50.0,3,6,250.0,15,14,29,10,13,11,6,4,16,89,79,60,39,222.1734693877551,18.918367346938776,8.051020408163266,2.265306122448979,217.53061224489795,220.41836734693877,215.34693877551018,30.908163265306122,10
153,Gary Trent Jr.,Toronto Raptors,SG,163,330,61,142,429.4,13,16,441.7,28,82,349.6,7,32,39,17,14,10,4,4,3,219,202,180,56,511.48979591836735,23.281179138321995,19.816326530612244,19.632653061224488,446.7777777777777,456.6893424036282,488.6938775510205,55.98185941043084,10
154,Georges Niang,Cleveland Cavaliers,SF,78,210,28,60,473.5,4,5,175.0,18,39,440.5,1,30,31,14,16,6,9,2,15,123,109,92,45,233.72400756143668,37.03780718336484,24.83553875236295,17.637051039697543,454.2930056710775,350.2438563327032,322.08317580340264,77.5633270321361,10
155,Giannis Antetokounmpo,Milwaukee Bucks,PF,291,338,107,168,632.4,67,95,634.6,10,19,533.3,21,79,100,72,19,4,25,7,18,463,391,363,172,591.3099173553719,140.5165289256198,101.60330578512396,4.330578512396693,1289.0,1078.0578512396694,816.3347107438017,228.03719008264466,10
156,Goga Bitadze,Orlando Magic,C,18,85,7,14,320.0,4,7,183.3,0,2,0.0,7,12,19,6,10,2,7,8,14,43,37,24,25,37.984375,53.12109375,7.05859375,0.0,203.359375,155.33984375,56.43359375,89.75,7
157,Gordon Hayward,Oklahoma City Thunder,SF,30,138,11,34,269.5,6,8,260.0,2,4,150.0,6,21,27,11,6,3,3,0,-22,68,57,41,38,108.25,22.5625,14.729166666666668,1.8958333333333333,137.58333333333331,152.5625,104.89583333333334,25.666666666666664,9
158,Gradey Dick,Toronto Raptors,G,102,250,41,88,462.4,0,0,0.0,20,52,393.5,7,23,30,9,15,5,5,0,-55,141,132,111,39,231.7097505668934,18.20408163265306,11.7437641723356,16.090702947845806,330.9183673469388,274.21315192743765,285.2448979591837,33.11791383219955,10
159,Grant Williams,Charlotte Hornets,PF,114,311,39,83,487.2,22,31,502.4,14,39,377.8,16,31,47,26,34,7,20,5,-35,187,161,140,73,390.3347107438016,116.53719008264461,18.958677685950413,30.611570247933887,622.3842975206611,528.6487603305785,435.4586776859504,184.1074380165289,10
160,Grayson Allen,Phoenix Suns,SG,135,364,41,100,390.5,21,24,716.7,32,78,387.5,5,30,35,29,24,10,10,7,-1,199,170,164,64,792.1,26.525000000000002,40.925,87.825,906.9000000000001,863.025,833.4250000000001,70.0,10
161,Gui Santos,Golden State Warriors,F,38,103,13,24,372.5,8,9,350.0,4,8,250.0,9,21,30,9,14,2,5,2,22,77,68,47,39,142.41420118343194,83.24260355029585,11.887573964497042,4.011834319526627,426.680473372781,395.12426035502955,148.57396449704143,120.52662721893495,8
162,Harrison Barnes,Sacramento Kings,SF,125,274,45,82,530.6,20,26,575.0,15,39,322.1,7,19,26,7,14,5,5,2,-42,158,151,132,33,289.44444444444446,28.408163265306122,10.736961451247165,14.959183673469386,302.7755102040816,291.3764172335601,303.38775510204084,36.600907029478456,10
163,Harry III Giles,Brooklyn Nets,F,8,8,3,6,50.0,1,2,50.0,1,1,100.0,2,2,4,2,3,0,0,0,-12,14,12,10,6,41.3265306122449,8.16326530612245,2.4693877551020407,0.5102040816326531,117.87755102040818,86.22448979591834,64.0,19.612244897959187,1
164,Haywood Highsmith,Miami Heat,F,49,179,19,45,400.2,2,2,100.0,9,28,250.0,10,15,25,5,15,9,2,7,9,79,74,54,30,308.77160493827165,19.0,2.5,20.086419753086425,387.0493827160494,384.5493827160494,314.27160493827165,18.5,10
165,Herbert Jones,New Orleans Pelicans,SF,130,330,45,77,567.9,19,22,691.7,21,38,480.8,7,32,39,23,34,19,11,4,106,192,169,153,62,301.66049382716045,57.51234567901234,26.308641975308642,27.141975308641975,481.2345679012346,436.7777777777778,358.9938271604938,70.94444444444446,10
166,Ibou Badji,Portland Trail Blazers,C,7,32,3,4,150.0,1,2,50.0,0,0,0.0,1,2,3,4,6,0,5,3,-17,14,10,11,7,11.666666666666668,2.333333333333334,1.4166666666666663,0.0,20.75,22.0,11.416666666666668,2.75,3
167,Immanuel Quickley,Toronto Raptors,SG,210,367,75,162,459.1,25,32,579.7,35,84,407.0,2,59,61,80,18,11,24,2,10,351,271,290,141,305.29639889196676,40.074792243767305,195.35180055401662,23.670360110803326,573.5761772853184,341.376731301939,466.3213296398892,306.60110803324096,10
168,Isaac Okoro,Cleveland Cavaliers,SF,128,295,48,90,536.6,12,17,566.7,20,47,465.8,4,24,28,27,19,10,7,10,1,183,156,155,55,144.8468809073724,47.84499054820415,21.344045368620037,10.926275992438564,195.25330812854446,180.02646502835537,149.0567107750473,80.20604914933836,10
169,Isaiah Hartenstein,New York Knicks,C,69,228,26,49,526.8,17,19,725.0,0,0,0.0,29,40,69,29,24,8,13,13,-28,167,138,98,98,176.77777777777777,109.84444444444445,41.0,0.0,482.6,363.20000000000005,270.0444444444444,176.97777777777776,10
170,Isaiah Jackson,Indiana Pacers,SF,85,163,33,52,624.7,19,24,683.3,0,2,0.0,21,29,50,9,23,7,9,8,-12,144,135,94,59,187.60946745562129,173.89940828402368,4.479289940828402,0.0,652.698224852071,617.8402366863905,194.32544378698228,206.52071005917162,9
171,Isaiah Joe,Oklahoma City Thunder,SG,67,172,26,56,422.5,2,2,200.0,13,38,272.0,4,15,19,11,10,5,8,4,73,97,86,78,30,216.84083044982702,9.664359861591695,20.916955017301042,14.141868512110728,236.93079584775086,221.01038062283737,232.78892733564012,30.55363321799308,10
172,Isaiah Stewart,Detroit Pistons,C,74,221,29,57,365.4,6,8,300.0,10,29,198.7,7,36,43,7,8,4,9,5,1,124,117,81,50,79.44444444444446,67.11111111111111,10.34567901234568,10.012345679012347,239.56790123456787,179.0,132.60493827160494,84.8641975308642,7
173,Ish Smith,Charlotte Hornets,PG,16,148,7,30,136.0,0,0,0.0,2,2,200.0,0,11,11,34,13,5,5,0,-82,61,27,50,45,50.0,9.984375,71.4375,1.4375,163.734375,64.484375,112.4375,118.234375,7
174,Ivica Zubac,LA Clippers,C,97,241,42,66,601.9,13,16,500.0,0,0,0.0,23,57,80,19,29,4,16,8,-3,196,177,116,99,238.15625,111.1640625,9.65625,0.0,504.7265625,448.1640625,257.625,157.9140625,10
175,JT Thor,Charlotte Hornets,F,24,90,10,16,466.7,0,0,0.0,4,7,300.0,1,15,16,4,7,0,3,3,29,44,40,28,20,52.90625,12.90625,2.40625,4.6640625,60.40625,62.0,52.0,14.625,10
176,JaVale McGee,Sacramento Kings,C,20,39,10,17,255.0,0,3,0.0,0,1,0.0,5,8,13,0,5,1,0,0,-1,33,33,20,13,42.222222222222214,7.555555555555555,0.0,0.0,71.55555555555556,71.55555555555556,42.222222222222214,7.555555555555555,5
177,Jabari Smith Jr.,Houston Rockets,PF,136,344,45,117,389.7,26,32,637.5,20,62,346.0,21,75,96,18,26,9,9,9,-48,250,232,154,114,383.70975056689343,331.54648526077096,17.60090702947846,20.0,1194.0,1021.9818594104308,495.6417233560091,409.23356009070295,10
178,Jabari Walker,Portland Trail Blazers,F,83,221,35,74,464.6,12,13,475.0,1,10,100.0,24,40,64,10,27,5,8,1,-50,157,147,93,74,298.2249134948097,84.0,8.034602076124568,1.0830449826989619,678.363321799308,585.166089965398,376.1280276816609,107.3287197231834,10
179,Jacob Gilyard,Memphis Grizzlies,G,67,192,23,49,431.8,1,1,100.0,20,42,431.8,1,13,14,39,10,9,12,2,-59,120,81,106,53,224.22222222222223,10.222222222222221,26.0,19.555555555555557,358.0,274.0,295.55555555555554,48.88888888888889,9
180,Jacob Toppin,New York Knicks,F,13,29,5,9,107.1,2,2,100.0,1,4,33.3,3,3,6,1,3,0,1,0,-18,20,19,14,7,88.03125,11.03125,0.625,0.78125,155.125,158.5,84.53125,11.78125,2
181,Jaden Hardy,Dallas Mavericks,G,89,135,35,71,517.3,7,8,350.0,12,30,370.0,1,12,13,10,7,3,9,1,-11,112,102,99,23,245.78892733564012,8.141868512110726,10.802768166089965,10.0,270.0968858131488,266.0,256.57093425605535,12.259515570934255,10
182,Jaden Ivey,Detroit Pistons,PG,148,299,47,129,348.7,40,46,763.3,14,57,224.89999999999998,10,11,21,32,28,8,23,5,-28,201,169,180,53,791.8249999999999,39.00000000000001,43.2,37.425000000000004,1194.125,1072.5249999999999,895.025,100.6,10
183,Jaden McDaniels,Minnesota Timberwolves,PF,105,315,39,77,476.5,15,21,441.7,12,33,321.4,6,35,41,20,34,7,12,7,-1,166,146,125,61,472.56611570247935,50.64876033057852,24.0,21.640495867768593,728.0165289256199,702.0165289256198,478.56611570247935,94.64876033057853,10
184,Jaden Springer,Boston Celtics,G,50,130,18,42,290.4,11,12,475.0,3,13,183.3,8,16,24,13,13,12,7,1,-20,87,74,63,37,138.0,32.0,16.0,1.9881656804733725,394.0,290.0,208.0,82.0,7
185,Jae Crowder,Milwaukee Bucks,PF,39,223,16,44,368.3,2,2,100.0,5,23,200.0,9,36,45,9,20,11,5,2,66,93,84,48,54,75.12854442344045,55.04158790170132,11.313799621928165,4.7315689981096405,150.00945179584122,108.0,94.75992438563327,88.73345935727788,10
186,Jae'Sean Tate,Houston Rockets,SF,28,117,12,28,420.3,2,4,50.0,2,4,200.0,10,19,29,10,16,10,8,0,-2,67,57,38,39,31.71597633136095,37.556213017751475,10.236686390532544,1.6094674556213018,138.1360946745562,121.98224852071007,48.28402366863905,47.37869822485207,10
187,Jahmi'us Ramsey,Toronto Raptors,SG,2,5,1,3,33.3,0,0,0.0,0,1,0.0,1,1,2,1,0,0,0,0,-7,5,4,3,3,0.0,0.0,0.0,0.0,0.0,0.0,0.0,0.0,1
188,Jaime Jr. Jaquez,Miami Heat,G,129,296,51,96,488.4,19,25,683.4,8,24,291.6,13,34,47,27,19,13,11,0,23,203,176,156,74,485.125,33.7,17.700000000000003,7.600000000000001,487.125,523.425,455.42499999999995,44.800000000000004,10
189,Jake LaRavia,Memphis Grizzlies,F,92,191,27,75,241.3,29,36,655.0,9,34,179.8,17,27,44,14,16,9,11,6,-25,150,136,106,58,316.3305785123967,110.41322314049586,9.537190082644628,9.330578512396695,559.900826446281,558.8760330578513,329.10743801652893,108.19834710743802,8
190,Jakob Poeltl,Toronto Raptors,C,122,251,55,101,543.9,12,20,491.7,0,0,0.0,39,53,92,31,28,10,11,19,35,245,214,153,123,161.8469387755102,127.67346938775509,30.387755102040813,0.0,516.704081632653,398.98979591836735,256.6224489795918,181.0,10
191,Jalen Brunson,New York Knicks,PG,305,370,111,236,469.2,58,65,802.4,25,67,343.4,5,26,31,75,19,11,35,1,2,411,336,380,106,323.65625,22.9140625,123.0,26.65625,507.3515625,350.9765625,495.90625,130.0390625,10
192,Jalen Duren,Detroit Pistons,C,120,282,44,77,576.1,32,37,802.4,0,0,0.0,28,77,105,33,37,8,22,9,-45,258,225,153,138,111.025,120.10000000000001,13.700000000000001,0.0,311.62500000000006,320.525,94.32499999999999,141.60000000000002,10
193,Jalen Green,Houston Rockets,SG,188,310,71,171,398.8,18,20,600.0,28,83,307.2,5,40,45,32,15,10,21,4,8,265,233,220,77,967.6326530612245,45.1859410430839,13.918367346938776,46.36281179138322,1233.6621315192745,1157.8526077097506,1032.0,70.54648526077096,10
194,Jalen HoodSchifino,Los Angeles Lakers,G,5,11,1,6,33.3,2,4,100.0,1,3,50.0,0,2,2,0,1,0,1,0,-13,7,7,5,2,9.0,0.9799999999999999,0.020000000000000004,0.8200000000000001,13.32,14.180000000000001,8.42,0.72,2
195,Jalen Johnson,Atlanta Hawks,SF,162,349,69,130,533.5,15,22,550.0,9,33,281.7,17,71,88,34,22,6,15,12,20,284,250,196,122,389.0679012345679,88.44444444444444,68.69753086419753,7.34567901234568,876.0,606.030864197531,614.4444444444445,201.73456790123458,10
196,Jalen McDaniels,Toronto Raptors,PF,17,71,7,18,170.0,0,0,0.0,3,8,116.7,3,15,18,6,8,3,10,1,-14,41,35,23,24,40.888888888888886,55.91358024691358,7.0,3.555555555555556,180.320987654321,124.4320987654321,65.22222222222221,94.46913580246914,5
197,Jalen Smith,Indiana Pacers,PF,91,158,37,64,586.4,9,15,390.0,8,23,433.3,18,30,48,12,13,1,7,6,16,151,139,103,60,157.31632653061226,27.316326530612248,16.122448979591837,4.0,155.12244897959178,135.0,194.74489795918365,26.132653061224495,10
198,Jalen Suggs,Orlando Magic,SG,123,258,46,84,562.3,8,11,325.0,23,52,425.4,6,25,31,33,29,13,22,5,63,187,154,156,64,191.79012345679013,45.73456790123456,20.160493827160494,24.179012345679013,386.5,310.5493827160494,250.79012345679013,82.84567901234567,10
199,Jalen Williams,Oklahoma City Thunder,F,209,316,81,152,530.8,29,34,725.7,18,40,449.9,4,34,38,39,29,13,16,8,24,286,247,248,77,620.9197530864197,17.808641975308642,16.32716049382716,10.0,665.6111111111111,700.4567901234568,583.3827160493827,36.82716049382715,10
200,Jalen Wilson,Brooklyn Nets,F,41,177,15,46,397.4,4,4,200.0,7,24,325.0,13,20,33,12,12,2,5,0,-34,86,74,53,45,52.95847750865052,37.0,5.612456747404845,8.141868512110726,156.75432525951558,114.89965397923876,78.2249134948097,59.200692041522494,10
201,Jamal Cain,Miami Heat,F,4,16,0,3,0.0,4,4,200.0,0,1,0.0,1,2,3,1,1,1,1,0,-4,8,7,5,4,0.0,0.5,0.5,0.0,0.0,0.5,0.5,0.0,2
202,Jamal Murray,Denver Nuggets,PG,206,312,81,156,485.8,21,25,588.1,23,49,428.3,5,32,37,58,12,11,30,3,30,301,243,264,95,1135.4325259515572,42.965397923875436,112.77508650519032,32.930795847750865,2057.0,1400.2456747404844,1680.318339100346,267.60899653979243,10
203,James Bouknight,Charlotte Hornets,SG,5,6,2,4,50.0,0,0,0.0,1,3,33.3,0,0,0,0,0,1,1,0,10,5,5,5,0,14.0625,0.0,0.0,0.5625,14.0625,14.0625,14.0625,0.0,1
204,James Harden,LA Clippers,SG,176,336,50,119,397.0,51,56,935.7,25,72,327.2,7,46,53,75,16,5,27,8,-27,304,229,251,128,600.6729678638942,72.00945179584122,52.882797731569,35.86578449905482,614.9829867674857,547.4763705103969,634.9092627599244,158.16257088846882,10
205,James Johnson,Indiana Pacers,PF,2,7,0,1,0.0,2,2,100.0,0,0,0.0,0,0,0,1,3,0,0,1,1,3,2,3,1,0.0,0.0,0.0,0.0,0.0,0.0,0.0,0.0,1
206,James Wiseman,Detroit Pistons,C,65,164,28,43,601.7,9,15,365.0,0,0,0.0,17,36,53,10,30,4,9,4,-68,128,118,75,63,178.80622837370242,72.68166089965398,16.03460207612457,0.0,525.3425605536331,386.6574394463669,265.7750865051903,140.4325259515571,10
207,Jarace Walker,Indiana Pacers,F,11,55,4,15,72.2,0,0,0.0,3,8,100.0,1,14,15,8,5,4,4,4,5,34,26,19,23,33.0,29.0,25.0625,3.0,236.0625,121.0,101.3125,100.8125,4
208,Jared Butler,Washington Wizards,SG,16,48,7,14,241.7,2,2,100.0,0,4,0.0,2,2,4,12,5,1,5,0,-15,32,20,28,16,26.56,2.16,23.439999999999998,0.0,120.24000000000001,42.0,93.84,36.56,4
209,Jared Rhoden,Detroit Pistons,G,2,13,1,2,50.0,0,0,0.0,0,0,0.0,0,1,1,1,0,0,1,2,2,4,3,3,2,0.0,0.0,0.0,0.0,0.0,0.0,0.0,0.0,1
210,Jaren Jackson Jr.,Memphis Grizzlies,PF,252,333,88,201,431.3,52,71,622.6,24,70,330.0,13,46,59,26,35,16,31,16,-56,337,311,278,85,309.625,134.6015625,16.625,22.625,576.2265625,606.9140625,332.5,97.6640625,10
211,Jarred Vanderbilt,Los Angeles Lakers,PF,39,90,14,21,300.0,9,12,275.0,2,3,66.7,6,14,20,10,3,10,7,0,32,69,59,49,30,68.75,46.0,13.0,3.0,324.75,212.75,138.75,101.0,4
212,Jarrett Allen,Cleveland Cavaliers,C,193,363,73,131,546.2,47,67,647.2,0,0,0.0,29,86,115,26,13,7,12,11,2,334,308,219,141,400.41776937618147,209.6880907372401,36.83553875236295,0.0,825.0812854442345,822.1285444234404,418.9092627599244,230.98487712665406,10
213,Javon Freeman-Liberty,Toronto Raptors,G,24,54,7,14,148.8,8,9,280.0,2,6,83.3,1,9,10,5,4,0,3,1,-5,39,34,29,15,52.083333333333336,1.416666666666666,0.75,0.75,50.08333333333334,56.00000000000001,45.00000000000001,3.3333333333333344,3
214,Jaxson Hayes,Los Angeles Lakers,C,44,134,19,28,588.4,6,12,141.7,0,2,0.0,13,21,34,4,16,5,4,4,-7,82,78,48,38,88.44444444444446,60.0,4.6938775510204085,0.0,217.13832199546482,192.44444444444443,100.281179138322,77.55102040816327,10
215,Jaylen Brown,Boston Celtics,SG,264,342,102,194,533.6,34,55,678.8,26,66,401.9,16,43,59,34,27,10,22,1,142,357,323,298,93,479.1604938271605,136.77777777777777,15.82716049382716,19.160493827160494,847.9382716049383,880.530864197531,445.97530864197523,153.19753086419755,10
216,Jaylin Williams,Oklahoma City Thunder,F,52,159,16,40,453.4,9,11,333.3,11,25,491.6,10,33,43,15,14,3,3,5,59,110,95,67,58,20.2265625,66.125,12.8515625,3.40625,99.625,107.6640625,25.0,66.1640625,10
217,Jayson Tatum,Boston Celtics,SF,263,361,88,188,474.1,51,58,870.9,36,80,450.2,8,75,83,58,21,11,26,4,155,404,346,321,141,486.2,120.325,46.825,24.625,810.0,934.425,405.52500000000003,123.4,10
218,Jeenathan Williams,Houston Rockets,G,8,17,4,7,66.7,0,2,0.0,0,0,0.0,2,1,3,0,4,0,0,0,17,11,11,8,3,48.32653061224491,0.5102040816326531,0.36734693877551017,0.0,53.0,57.6530612244898,43.79591836734694,0.7551020408163267,2
219,Jeff Dowtin,Philadelphia 76ers,G,16,49,6,10,123.80000000000001,0,0,0.0,4,7,116.7,0,3,3,8,0,3,3,1,14,27,19,24,11,53.666666666666664,6.0,16.666666666666668,3.0000000000000004,171.0,87.66666666666666,117.0,42.66666666666667,3
220,Jeff Green,Houston Rockets,PF,51,147,16,42,294.5,10,15,310.0,9,22,323.8,5,15,20,11,10,1,7,4,-47,82,71,62,31,312.90625,32.3515625,13.125,15.3515625,588.9140625,519.3515625,377.90625,50.0390625,10
221,Jerami Grant,Portland Trail Blazers,SF,204,351,65,157,399.2,53,63,701.3,21,51,427.0,8,23,31,39,23,12,30,2,-68,274,235,243,70,1313.1938775510205,63.97959183673469,35.244897959183675,5.887755102040816,2142.9081632653065,1859.84693877551,1539.2755102040817,156.20408163265307,10
222,Jeremiah Robinson-Earl,New Orleans Pelicans,F,16,49,5,11,166.7,4,7,80.0,2,5,100.0,5,6,11,1,2,2,2,1,5,28,27,17,12,41.111111111111114,24.456790123456795,0.7530864197530864,1.0123456790123457,108.12345679012346,98.30864197530865,44.16049382716049,31.975308641975307,4
223,Jeremy Sochan,San Antonio Spurs,F,119,300,47,108,378.3,16,21,516.7,9,30,283.4,20,48,68,22,27,9,16,5,-34,209,187,141,90,460.67346938775506,119.70975056689342,22.0,9.689342403628117,941.9342403628118,890.6961451247165,463.53061224489795,190.09070294784578,10
224,Jericho Sims,New York Knicks,C,41,247,16,21,626.7,9,13,280.0,0,0,0.0,30,36,66,14,14,3,5,6,10,121,107,55,80,103.7890625,48.0,10.8515625,0.0,263.125,199.0390625,156.125,70.6015625,10
225,Jerome Robinson,Golden State Warriors,SG,10,17,4,10,40.0,1,2,50.0,1,6,16.7,0,0,0,1,1,0,0,1,-2,11,10,11,1,73.02479338842974,0.0,0.29752066115702475,0.6694214876033057,82.64462809917353,73.02479338842974,82.64462809917353,0.29752066115702475,1
226,Jett Howard,Orlando Magic,G,0,5,0,1,0.0,0,0,0.0,0,1,0.0,0,0,0,0,1,0,0,0,-5,0,0,0,0,2.25,0.0,0.0,0.25,2.25,2.25,2.25,0.0,1
227,Jevon Carter,Chicago Bulls,PG,42,146,17,41,326.7,0,0,0.0,8,24,183.3,2,9,11,13,10,7,3,1,40,66,53,55,24,177.70975056689343,8.777777777777779,6.519274376417233,11.61451247165533,261.91836734693874,218.99546485260768,213.45804988662132,22.471655328798185,10
228,Jimmy Butler,Miami Heat,SF,224,352,73,141,525.3,65,82,785.5,13,30,481.6,15,51,66,68,10,21,21,5,71,358,290,292,134,336.4140625,75.15625,61.40625,6.2265625,421.7890625,295.1640625,411.1015625,188.5,10
229,Jock Landale,Houston Rockets,C,27,83,9,23,325.0,8,9,280.0,1,3,100.0,15,17,32,9,10,2,2,4,12,68,59,36,41,42.26627218934912,84.0,12.881656804733728,0.9644970414201184,133.37278106508876,127.80473372781064,44.29585798816568,100.42011834319526,8
230,Joe Harris,Detroit Pistons,SF,2,12,1,3,33.3,0,0,0.0,0,1,0.0,0,0,0,0,1,0,0,0,-5,2,2,2,0,0.0,0.0,0.0,0.0,0.0,0.0,0.0,0.0,1
231,Joe Ingles,Orlando Magic,SG,29,169,10,23,291.7,2,3,150.0,7,16,266.7,2,10,12,27,9,8,8,1,30,68,41,56,39,135.0,6.037190082644628,49.27685950413223,10.239669421487603,196.2479338842975,133.85537190082644,182.5495867768595,70.15702479338844,10
232,Joel Embiid,Philadelphia 76ers,C,14,30,5,18,27.8,2,2,100.0,2,6,33.3,1,6,7,2,5,2,8,0,-21,23,21,16,9,0.0,0.0,0.0,0.0,0.0,0.0,0.0,0.0,1
233,John Collins,Utah Jazz,PF,161,308,65,117,546.7,20,28,670.8,11,34,305.5,29,81,110,15,31,6,19,15,12,286,271,176,125,323.125,130.22500000000002,6.525,9.125,300.42499999999995,356.9,276.0,127.4,10
234,John Konchar,Memphis Grizzlies,SG,54,253,20,42,485.0,6,6,200.0,8,24,391.6,15,33,48,24,17,12,11,11,-9,126,102,78,72,54.4140625,53.6640625,16.5,3.6015625,230.40625,172.15625,97.7890625,85.0390625,10
235,Johnny Davis,Washington Wizards,G,22,153,8,38,238.7,2,4,100.0,4,14,183.3,5,17,22,7,14,3,3,1,-55,51,44,29,29,49.644444444444446,32.31111111111111,4.2,4.4,99.8,78.8,66.91111111111111,40.24444444444445,10
236,Johnny Juzang,Utah Jazz,G,14,46,6,16,103.3,0,0,0.0,2,10,40.0,2,5,7,3,1,0,1,0,9,24,21,17,10,55.83673469387755,11.122448979591836,0.24489795918367346,3.1020408163265314,110.38775510204079,105.0,59.673469387755105,12.918367346938776,3
237,Jonas Valanciunas,New Orleans Pelicans,C,100,208,42,81,451.7,11,14,341.7,5,12,300.0,25,68,93,16,20,2,13,8,60,209,193,116,109,299.225,152.1,18.425,6.8999999999999995,812.5,755.325,372.0,154.92499999999998,10
238,Jonathan Isaac,Orlando Magic,PF,73,170,30,52,609.8,7,11,316.7,6,13,350.0,18,36,54,7,7,7,8,12,-5,134,127,80,61,120.82716049382717,87.01234567901234,4.753086419753087,4.5,289.01234567901236,318.7777777777778,106.04938271604938,76.77777777777779,10
239,Jonathan Kuminga,Golden State Warriors,PF,178,270,69,133,492.2,37,47,684.2,3,17,83.3,15,40,55,30,21,9,14,8,31,263,233,208,85,507.4340277777777,56.77777777777778,18.01736111111111,4.350694444444445,567.6111111111111,654.90625,416.2777777777778,78.65625,10
240,Jontay Porter,Toronto Raptors,C,26,65,9,20,190.0,3,4,75.0,5,11,158.3,5,13,18,9,8,4,6,1,-22,53,44,35,27,121.85185185185185,28.0,7.0,7.296296296296298,310.85185185185185,259.18518518518516,155.5185185185185,53.0,6
241,Jordan Clarkson,Utah Jazz,PG,175,326,61,150,382.2,33,36,857.9,20,62,276.2,9,30,39,59,19,9,22,1,-63,273,214,234,98,826.6066481994461,95.97506925207756,82.09141274238227,25.77285318559557,1269.060941828255,1243.163434903047,864.5484764542934,166.02216066481992,10
242,Jordan Goodwin,Memphis Grizzlies,G,49,181,20,58,260.0,4,10,175.0,5,18,169.89999999999998,10,16,26,29,10,12,10,8,-51,104,75,78,55,77.5486111111111,74.4375,54.715277777777764,1.5486111111111112,330.9375,214.44444444444443,107.75,215.44444444444449,7
243,Jordan Hawkins,New Orleans Pelicans,G,49,139,18,60,333.2,3,3,100.0,10,41,210.0,3,13,16,5,8,1,2,2,-9,70,65,54,21,148.24444444444444,21.244444444444444,6.511111111111112,10.0,208.40000000000003,164.77777777777777,189.51111111111112,30.11111111111111,10
244,Jordan McLaughlin,Minnesota Timberwolves,PG,38,111,13,25,400.0,3,4,150.0,9,17,375.0,3,10,13,23,10,8,5,1,3,74,51,61,36,127.3515625,16.6640625,22.6640625,11.65625,163.7890625,135.90625,135.90625,58.65625,10
245,Jordan Miller,LA Clippers,G,4,5,1,1,100.0,2,2,100.0,0,0,0.0,0,1,1,0,0,0,0,0,3,5,5,4,1,9.0,0.5625,0.0,0.0,14.0625,14.0625,9.0,0.5625,1
246,Jordan Nwora,Toronto Raptors,SF,65,142,24,58,330.2,9,10,375.0,8,24,230.0,5,22,27,11,10,6,5,3,-72,103,92,76,38,291.5467128027682,26.259515570934255,20.958477508650518,13.688581314878892,331.16608996539793,329.8131487889273,283.0103806228374,57.107266435986155,10
247,Jordan Poole,Washington Wizards,SG,224,309,80,184,429.3,28,32,702.8,36,96,359.5,5,29,34,45,37,13,31,5,-50,303,258,269,79,810.4999999999999,20.8,39.525,39.425000000000004,809.325,775.7000000000002,799.9249999999998,104.525,10
248,Jordan Walsh,Boston Celtics,G,2,27,1,4,100.0,0,0,0.0,0,2,0.0,2,4,6,1,5,2,2,1,24,9,8,3,7,2.0,8.0,0.5,0.0,0.5,2.0,4.5,4.5,2
249,Jose Alvarado,New Orleans Pelicans,PG,70,199,27,68,413.9,6,7,350.0,10,36,266.6,4,19,23,26,14,14,10,4,63,119,93,96,49,62.15625,6.6640625,46.6640625,4.0390625,131.65625,74.2265625,120.4140625,52.5,10
250,Josh Giddey,Oklahoma City Thunder,SG,105,236,45,84,508.40000000000003,7,9,300.0,8,25,299.9,11,45,56,40,15,8,22,7,30,201,161,145,96,245.26757369614515,63.64172335600907,28.816326530612244,4.213151927437642,492.5510204081632,341.7755102040816,340.0294784580499,148.4716553287982,10
251,Josh Green,Dallas Mavericks,SG,68,255,27,57,466.6,4,5,80.0,10,26,330.0,11,21,32,17,18,13,10,2,-36,117,100,85,49,171.38775510204084,39.92743764172336,18.06122448979592,10.816326530612246,268.7913832199547,237.1111111111111,216.265306122449,44.791383219954646,10
252,Josh Hart,New York Knicks,SG,153,417,58,127,463.1,14,24,382.1,23,55,411.2,20,84,104,54,21,13,19,6,-27,311,257,207,158,241.35457063711908,218.98614958448755,44.93628808864266,12.196675900277008,746.4626038781164,527.0,315.1385041551247,409.601108033241,10
253,Josh Minott,Minnesota Timberwolves,F,0,5,0,0,0.0,0,0,0.0,0,0,0.0,0,4,4,0,0,0,0,0,6,4,4,0,4,1.3611111111111114,6.25,0.0,0.027777777777777776,1.7777777777777781,1.7777777777777781,1.3611111111111114,6.25,1
254,Josh Okogie,Phoenix Suns,SF,46,141,15,32,423.8,10,11,350.0,6,14,300.0,16,6,22,10,4,8,10,2,6,78,68,56,32,116.57777777777777,12.71111111111111,8.71111111111111,6.444444444444445,170.0,161.77777777777777,120.57777777777778,25.644444444444446,10
255,Josh Richardson,Miami Heat,SG,81,169,30,60,331.7,6,6,200.0,15,37,276.7,3,22,25,14,13,4,2,1,5,120,106,95,39,281.71428571428567,17.714285714285715,10.0,22.857142857142858,446.85714285714283,398.8571428571429,333.71428571428567,23.714285714285715,7
256,Joshua Primo,LA Clippers,G,0,5,0,1,0.0,0,0,0.0,0,0,0.0,1,0,1,0,0,0,1,0,1,1,1,0,1,0.0,0.0,0.0,0.0,0.0,0.0,0.0,0.0,1
257,Jrue Holiday,Boston Celtics,PG,108,318,43,75,564.9,3,4,150.0,19,39,559.9,8,31,39,57,17,13,18,7,128,204,147,165,96,131.29085872576178,29.132963988919666,65.6371191135734,5.132963988919668,240.96952908587255,155.84764542936284,230.82825484764544,80.35457063711912,10
258,Jules Bernard,Washington Wizards,G,9,19,3,4,250.0,1,2,50.0,2,2,200.0,2,3,5,4,1,1,1,1,15,18,14,13,9,3.6875,3.1875,5.0,0.75,8.75,4.75,8.1875,7.6875,3
259,Julian Champagnie,San Antonio Spurs,F,60,188,19,49,341.1,11,13,350.0,11,34,249.1,9,24,33,20,6,5,6,4,26,113,93,80,53,212.225,40.5,34.1,20.9,568.125,372.125,346.625,136.2,10
260,Julian Phillips,Chicago Bulls,F,30,110,11,26,255.0,4,5,166.7,4,10,216.7,5,11,16,5,12,3,3,1,6,51,46,35,21,118.025,27.625,6.899999999999999,4.8,255.0,220.5,139.125,47.925000000000004,10
261,Julian Strawther,Denver Nuggets,G,9,27,3,11,37.5,2,2,100.0,1,8,20.0,0,3,3,4,1,1,2,0,-15,16,12,13,7,32.03125,7.03125,2.53125,0.78125,89.78125,68.125,48.625,14.625,2
262,Justin Champagnie,Washington Wizards,SF,4,13,2,7,50.0,0,0,0.0,0,4,0.0,0,1,1,1,0,1,1,1,-1,6,5,5,2,13.555555555555554,0.5555555555555556,0.5555555555555556,0.2222222222222222,5.555555555555554,9.0,9.0,2.2222222222222223,2
263,Justin Holiday,Denver Nuggets,SF,57,202,20,46,469.7,3,4,150.0,14,35,370.0,1,16,17,19,10,7,3,3,-27,93,74,76,36,169.3515625,15.6015625,36.9765625,14.0,342.7890625,253.90625,242.15625,68.65625,10
264,Justin Minaya,Portland Trail Blazers,F,3,37,1,6,33.3,0,0,0.0,1,5,33.3,3,3,6,2,2,1,1,0,-24,11,9,5,8,7.66115702479339,3.3884297520661155,1.2066115702479339,0.8512396694214875,13.479338842975208,11.0,6.735537190082645,8.0,4
265,Jusuf Nurkic,Phoenix Suns,C,104,264,39,72,603.7,26,46,498.3,0,3,0.0,40,100,140,45,35,10,35,16,64,289,244,149,185,182.29916897506925,525.9002770083104,30.562326869806093,0.0,1155.2160664819946,1045.5235457063711,221.0,627.4542936288088,10
266,Karl-Anthony Towns,Minnesota Timberwolves,C,193,306,66,146,451.8,41,47,734.2,20,56,341.5,20,55,75,29,33,8,24,8,98,297,268,222,104,242.5,98.8515625,46.9140625,18.9765625,525.125,391.8515625,338.9140625,182.625,10
267,Kawhi Leonard,LA Clippers,SF,230,353,91,182,511.7,36,40,889.9,12,45,216.6,16,47,63,37,14,19,21,6,-24,330,293,267,100,264.6938775510205,44.83673469387755,36.519274376417236,12.75736961451247,457.9274376417235,364.0612244897959,329.6485260770975,110.26757369614513,10
268,Keegan Murray,Sacramento Kings,SF,126,354,48,104,425.7,12,12,500.0,18,48,324.79999999999995,12,36,48,12,33,9,10,10,6,186,174,138,60,569.2607709750567,21.77777777777778,18.24489795918367,29.777777777777775,598.1224489795918,626.8163265306123,538.5668934240363,42.022675736961446,10
269,Keita Bates-Diop,Brooklyn Nets,SF,38,100,14,26,648.3,5,6,250.0,5,12,350.0,3,10,13,4,2,1,6,5,-18,55,51,42,17,39.111111111111114,16.2,4.4,4.777777777777779,69.84444444444445,66.24444444444444,35.11111111111111,28.200000000000003,10
270,Keldon Johnson,San Antonio Spurs,SF,156,294,57,127,442.6,17,21,488.3,25,67,353.6,12,32,44,29,17,6,12,2,-20,229,200,185,73,325.37396121883654,69.20775623268699,32.40720221606648,23.060941828254848,622.4293628808864,573.7728531855956,399.4487534626038,76.19667590027701,10
271,Kelly Olynyk,Toronto Raptors,PF,96,230,32,71,383.3,24,30,557.1,8,26,258.3,14,29,43,38,34,14,16,8,-56,177,139,134,81,246.425,70.6,65.2,7.624999999999999,715.325,458.92499999999995,449.625,189.0,10
272,Kelly Oubre Jr.,Philadelphia 76ers,SG,168,316,62,145,413.5,33,43,717.8,11,45,236.2,15,32,47,18,36,12,19,3,-56,233,215,186,65,665.1655328798186,50.73696145124717,16.648526077097504,7.090702947845805,951.8526077097506,835.6938775510204,764.9342403628118,83.77551020408163,10
273,Kendall Brown,Indiana Pacers,SG,0,7,0,0,0.0,0,0,0.0,0,0,0.0,0,0,0,0,0,0,0,0,4,0,0,0,0,0.25,0.0,0.0625,0.0,0.5625,0.25,0.5625,0.0625,1
274,Kenneth Lofton Jr.,Philadelphia 76ers,F,2,5,1,4,25.0,0,0,0.0,0,2,0.0,0,1,1,0,0,0,0,0,-4,3,3,2,1,0.0,0.0,0.0,0.0,0.0,0.0,0.0,0.0,1
275,Kenrich Williams,Oklahoma City Thunder,SF,29,105,11,27,301.3,0,0,0.0,7,18,200.0,4,20,24,10,7,0,4,0,36,63,53,39,34,152.9012345679012,22.401234567901234,10.277777777777777,16.111111111111114,160.45679012345678,174.1049382716049,149.21604938271605,22.71604938271605,10
276,Kentavious Caldwell-Pope,Denver Nuggets,SG,103,289,34,74,420.7,15,16,580.0,20,43,415.0,4,22,26,22,16,13,8,5,81,151,129,125,48,307.97777777777776,12.444444444444446,15.644444444444444,20.177777777777777,376.9111111111111,315.8,363.4,33.77777777777777,10
277,Kenyon Martin Jr.,Philadelphia 76ers,F,68,211,30,48,628.8,4,6,250.0,4,8,216.7,14,34,48,12,29,4,9,4,-26,128,116,80,60,166.86426592797787,56.61495844875346,13.689750692520775,4.470914127423822,419.42936288088646,338.51523545706374,232.3656509695291,85.71745152354572,10
278,Keon Ellis,Sacramento Kings,G,23,88,9,18,216.7,0,0,0.0,5,12,143.3,7,7,14,11,13,7,3,2,25,48,37,34,25,99.900826446281,4.231404958677686,40.0,7.504132231404958,124.56198347107438,125.47107438016529,103.53719008264463,39.68595041322314,7
279,Keon Johnson,Brooklyn Nets,G,12,26,3,8,73.3,4,4,100.0,2,4,133.3,2,1,3,2,2,2,2,0,-9,17,15,14,5,18.88888888888889,0.5555555555555556,2.2222222222222223,0.22222222222222227,27.222222222222225,13.888888888888888,34.0,1.0,2
280,Kessler Edwards,Sacramento Kings,SF,12,40,4,10,106.7,1,2,50.0,3,7,91.7,0,7,7,1,5,2,0,1,10,20,19,13,8,38.96,12.360000000000003,0.8400000000000001,3.5599999999999996,41.64000000000001,39.0,35.96000000000001,18.84,4
281,Kevin Durant,Phoenix Suns,PF,287,378,103,209,496.5,62,77,805.6,19,57,340.5,7,62,69,45,18,6,41,13,35,401,356,332,114,536.4104308390023,61.48979591836735,59.775510204081634,9.489795918367346,880.6961451247166,754.4444444444445,601.9274376417234,182.0,10
282,Kevin Huerter,Sacramento Kings,SG,94,246,37,86,413.9,2,4,100.0,18,49,330.0,7,26,33,25,18,5,11,4,-14,152,127,119,58,374.59410430839,27.308390022675734,12.777777777777777,21.632653061224488,567.7777777777778,495.0,437.53061224489795,49.92743764172336,10
283,Kevin Knox II,Detroit Pistons,SF,18,65,8,19,115.6,1,1,100.0,1,7,33.3,3,7,10,4,8,2,6,0,25,32,28,22,14,99.0,11.0,2.0,0.75,146.0,176.0,77.0,5.0,4
284,Kevin Love,Miami Heat,PF,88,158,30,62,483.6,10,14,208.3,18,45,387.4,10,55,65,19,20,3,10,3,31,172,153,107,84,341.77777777777777,48.94444444444445,12.944444444444446,15.777777777777775,500.0,468.94444444444446,378.94444444444446,55.77777777777777,10
285,Kevon Looney,Golden State Warriors,F,21,97,8,18,483.3,5,8,175.0,0,0,0.0,7,22,29,13,12,1,5,4,38,63,50,34,42,26.5,19.4,6.125,0.0,19.325000000000006,32.10000000000001,15.625,23.625000000000004,10
286,Keyontae Johnson,Oklahoma City Thunder,F,5,29,2,6,66.7,0,0,0.0,1,2,100.0,1,4,5,0,3,0,1,0,-7,10,10,5,5,16.6875,4.75,0.0,0.6875,24.6875,24.6875,16.6875,4.75,3
287,Keyonte George,Utah Jazz,G,167,316,60,137,384.7,14,17,296.7,33,74,382.8,0,28,28,54,15,7,28,1,-46,249,195,221,82,1158.179012345679,22.0,48.5,69.3641975308642,1571.1234567901233,1334.6234567901236,1372.679012345679,92.5,10
288,Khris Middleton,Milwaukee Bucks,SF,54,110,22,41,229.2,3,4,150.0,7,16,218.3,1,15,16,20,14,2,8,2,32,90,70,74,36,113.0,22.0,38.0,2.75,237.0,125.0,251.0,34.0,4
289,Killian Hayes,Detroit Pistons,PG,10,42,4,9,92.9,0,0,0.0,2,4,50.0,0,7,7,12,2,0,2,0,-10,29,17,22,19,18.0,0.5,18.0,2.0,84.5,24.5,72.0,24.5,2
290,Klay Thompson,Golden State Warriors,SG,162,250,56,128,435.6,14,15,466.7,36,85,404.9,2,27,29,19,18,7,15,1,-15,210,191,181,48,657.5371900826447,23.694214876033058,28.90082644628099,28.958677685950413,575.9669421487604,614.6528925619835,621.0,50.446280991735534,10
291,Kobe Brown,LA Clippers,G,2,27,1,5,100.0,0,0,0.0,0,2,0.0,4,5,9,2,4,0,3,0,-23,13,11,4,11,3.0,9.0,1.3600000000000003,0.04000000000000001,12.36,7.0,2.3600000000000003,16.36,4
292,Kobe Bufkin,Atlanta Hawks,G,27,81,11,31,158.4,1,2,50.0,4,14,115.0,1,10,11,14,6,3,4,1,21,52,38,41,25,72.63265306122449,3.9795918367346945,14.959183673469388,2.836734693877551,134.6326530612245,95.83673469387756,113.83673469387753,16.53061224489796,5
293,Kris Dunn,Utah Jazz,G,60,203,25,43,493.29999999999995,4,5,250.0,6,18,341.7,8,15,23,25,24,12,13,1,-70,108,83,85,48,166.22500000000002,22.5,22.9,4.800000000000001,264.825,202.125,220.725,53.599999999999994,10
294,Kris Murray,Portland Trail Blazers,F,80,289,31,79,386.2,11,19,450.0,7,39,256.7,20,34,54,25,23,10,12,2,-7,159,134,105,79,228.39999999999998,82.0,32.5,4.1,484.5,348.0,286.90000000000003,192.49999999999997,10
295,Kristaps Porzingis,Boston Celtics,C,236,301,79,154,525.0,53,57,827.8,25,55,502.2,15,60,75,18,23,5,14,16,102,329,311,254,93,339.9183673469388,114.63265306122449,13.76530612244898,6.704081632653061,556.9081632653061,575.0,330.1734693877551,120.05102040816325,10
296,Kyle Anderson,Minnesota Timberwolves,SF,67,244,26,58,429.7,13,15,350.0,2,6,150.0,4,33,37,47,17,8,11,3,71,151,104,114,84,112.60000000000001,51.325,26.125,1.6249999999999998,215.79999999999998,203.625,159.425,42.800000000000004,10
297,Kyle Kuzma,Washington Wizards,SF,250,339,98,198,495.7,30,43,706.7,24,65,339.0,10,68,78,38,21,9,25,8,-119,366,328,288,116,267.0803324099723,84.04986149584488,76.53185595567868,39.26869806094183,551.1135734072022,500.6204986149585,353.185595567867,124.96952908587258,10
298,Kyle Lowry,Philadelphia 76ers,PG,60,205,19,44,297.0,11,12,375.0,11,27,252.1,5,18,23,41,15,7,10,1,-20,124,83,101,64,148.0,13.45679012345679,33.30864197530864,11.827160493827158,368.44444444444446,215.679012345679,264.41975308641975,83.11111111111111,7
299,Kyrie Irving,Dallas Mavericks,PG,265,352,104,205,508.4,23,23,700.0,34,78,432.1,8,42,50,36,14,9,18,4,-22,351,315,301,86,208.8131487889273,44.31141868512111,27.979238754325262,16.899653979238757,413.37370242214536,338.34256055363323,264.916955017301,91.21799307958479,10
300,Lamar Stevens,Memphis Grizzlies,PF,116,205,46,93,512.2,18,24,416.6,6,14,475.0,12,37,49,8,17,6,9,9,-11,173,165,124,57,206.6015625,56.9140625,6.1640625,2.4140625,349.8515625,282.125,270.90625,66.5,10
301,Landry Shamet,Washington Wizards,SG,61,191,22,60,313.1,7,7,300.0,10,39,154.1,4,11,15,8,13,6,9,3,-56,84,76,69,23,297.0,20.508650519031143,6.0,16.034602076124564,398.4498269896194,360.56747404844293,329.0,32.391003460207614,10
302,Larry Nance Jr.,New Orleans Pelicans,PF,51,198,21,34,563.6,6,9,300.0,3,8,200.0,22,33,55,18,22,7,14,5,38,124,106,69,73,78.21883656509696,50.16343490304709,11.617728531855956,2.2465373961218837,258.9806094182826,227.77839335180056,95.93074792243769,75.27146814404432,10
303,Lauri Markkanen,Utah Jazz,PF,211,342,70,163,428.6,40,43,856.7,31,77,398.8,18,52,70,23,15,7,17,3,-46,304,281,234,93,325.44444444444446,112.71111111111112,50.111111111111114,23.444444444444446,786.5777777777778,575.4000000000001,492.8,206.64444444444445,10
304,LeBron James,Los Angeles Lakers,SF,270,355,103,184,557.9,39,48,763.9,25,52,496.6,6,52,58,97,10,11,29,6,47,425,328,367,155,200.15625,81.4765625,52.5,27.90625,229.6640625,219.4140625,245.15625,99.2265625,10
305,Leaky Black,Charlotte Hornets,F,26,138,8,22,232.1,6,8,225.0,4,9,150.0,3,19,22,13,8,2,3,2,-25,61,48,39,35,83.5,29.5,5.875,8.0,111.875,84.0,96.875,49.875,8
306,Leonard Miller,Minnesota Timberwolves,F,0,5,0,1,0.0,0,0,0.0,0,0,0.0,0,0,0,2,0,0,0,0,8,2,0,2,2,1.0,0.25,1.0,0.0,0.25,2.25,0.0,0.25,1
307,Lester Quinones,Golden State Warriors,G,58,162,20,53,357.0,9,13,325.0,9,31,250.0,8,18,26,11,17,2,5,0,-34,95,84,69,37,188.08317580340267,18.400756143667294,14.931947069943288,10.931947069943291,245.64650283553874,276.76748582230624,174.17202268431,16.12287334593573,10
308,Lindy Waters III,Oklahoma City Thunder,F,23,57,8,17,273.3,0,0,0.0,7,15,233.3,1,13,14,4,6,1,2,2,-30,41,37,27,18,64.94,20.560000000000002,3.5,8.139999999999999,164.44000000000003,135.34,82.84,35.26,6
309,Lonnie Walker IV,Brooklyn Nets,G,101,184,37,102,335.0,4,5,250.0,23,59,341.1,1,25,26,8,23,5,8,2,6,135,127,109,34,430.833910034602,29.01038062283737,10.920415224913494,26.391003460207614,649.6851211072665,595.0,480.72318339100343,44.726643598615915,10
310,Luguentz Dort,Oklahoma City Thunder,G,106,290,39,86,454.2,3,3,200.0,25,54,476.1,5,29,34,13,28,12,5,5,53,153,140,119,47,227.91836734693877,39.709750566893426,14.165532879818594,17.775510204081634,321.0,289.4512471655329,245.281179138322,68.06122448979592,10
311,Luka Doncic,Dallas Mavericks,PG,364,376,131,250,523.0,62,71,901.1,40,104,372.7,7,91,98,108,26,16,41,5,40,570,462,472,206,271.29999999999995,26.0,69.825,36.0,485.02500000000003,301.7,406.82500000000005,143.625,10
312,Luka Garza,Minnesota Timberwolves,C,8,5,3,5,60.0,1,2,50.0,1,1,100.0,1,0,1,0,1,0,0,0,8,9,9,8,1,19.360000000000003,0.16000000000000003,0.0,0.16000000000000003,23.04,23.04,19.360000000000003,0.16000000000000003,1
313,Luka Samanic,Utah Jazz,F,35,88,11,34,238.8,10,12,350.0,3,17,78.3,4,13,17,4,9,1,5,4,-44,56,52,39,21,53.0,18.57988165680473,3.7988165680473367,1.7278106508875741,142.9526627218935,124.50295857988166,66.33727810650888,27.49112426035503,7
314,Luke Kennard,Memphis Grizzlies,SG,128,265,39,74,531.2,21,24,621.4,29,56,521.2,0,20,20,29,12,5,16,0,-69,177,148,157,49,299.06944444444446,6.0,39.125,20.944444444444443,416.94444444444446,309.06944444444446,412.9444444444445,39.125,10
315,Luke Kornet,Boston Celtics,C,51,148,23,29,649.0,5,6,250.0,0,0,0.0,15,23,38,7,18,2,1,10,67,96,89,58,45,171.12244897959184,56.336734693877546,10.26530612244898,0.0,434.17346938775506,364.4183673469388,214.77551020408163,92.70408163265307,10
316,Malachi Flynn,Detroit Pistons,PG,36,83,13,39,232.5,4,6,200.0,6,18,241.7,0,10,10,11,5,3,6,0,-20,57,46,47,21,90.78125,7.5,12.40625,4.625,199.375,139.78125,141.375,28.90625,8
317,Malaki Branham,San Antonio Spurs,G,154,237,55,108,516.5,18,19,675.0,26,46,530.4,5,18,23,22,14,4,15,1,-34,199,177,176,45,444.4487534626039,8.71191135734072,25.6398891966759,24.0,535.6204986149585,451.32132963988926,520.2603878116344,42.83933518005541,10
318,Malcolm Brogdon,Portland Trail Blazers,PG,65,142,24,52,182.4,11,13,333.3,6,19,110.0,6,19,25,27,9,4,8,1,10,117,90,92,52,92.75,4.75,6.75,5.0,106.75,61.0,146.0,4.0,4
319,Malik Beasley,Milwaukee Bucks,SG,105,292,38,96,392.4,1,2,50.0,28,75,362.0,3,27,30,16,22,12,6,1,102,151,135,121,46,327.0,22.287334593572776,14.41209829867675,33.648393194707,249.80151228733462,264.06994328922497,297.0642722117202,52.36672967863894,10
320,Malik Monk,Sacramento Kings,SG,177,289,69,156,418.1,22,26,750.0,17,55,273.0,3,36,39,55,20,10,25,4,-1,271,216,232,94,874.2199546485261,20.918367346938776,42.55102040816327,22.346938775510203,1052.9002267573696,984.4444444444445,909.6145124716553,96.53061224489795,10
321,MarJon Beauchamp,Milwaukee Bucks,F,30,42,10,16,350.0,7,8,175.0,3,7,200.0,2,9,11,1,4,1,3,0,-17,42,41,31,12,65.5,11.0,0.8749999999999999,1.875,116.04166666666664,105.5,72.87499999999999,15.04166666666667,6
322,Marcus Morris Sr.,Philadelphia 76ers,SF,23,65,9,22,122.9,2,2,100.0,3,8,83.3,0,10,10,1,3,2,5,1,-14,34,33,24,11,20.666666666666664,4.666666666666666,0.6666666666666667,2.0,24.666666666666664,32.0,14.0,4.666666666666666,3
323,Marcus Sasser,Detroit Pistons,G,71,200,27,77,322.3,6,9,300.0,11,39,299.5,1,19,20,42,19,10,15,0,-27,133,91,113,62,357.9765625,14.9765625,74.2265625,12.0390625,620.2265625,422.5,552.5,92.40625,10
324,Markelle Fultz,Orlando Magic,PG,70,187,30,67,401.1,9,12,333.3,1,7,50.0,15,20,35,22,11,7,13,3,-17,127,105,92,57,222.55363321799308,37.200692041522494,21.612456747404842,0.9169550173010381,232.10034602076126,192.50865051903116,234.33217993079586,86.62629757785467,10
325,Markieff Morris,Dallas Mavericks,PF,3,6,1,2,50.0,0,0,0.0,1,2,50.0,0,2,2,0,0,0,0,0,-1,5,5,3,2,0.5625,2.25,0.0,0.0625,0.5625,0.5625,0.5625,2.25,1
326,Marques Bolden,Charlotte Hornets,C,0,13,0,1,0.0,0,0,0.0,0,0,0.0,0,1,1,0,1,0,1,0,2,1,1,0,1,0.0,0.7222222222222223,0.0,0.0,0.7222222222222223,0.7222222222222223,0.0,0.7222222222222223,2
327,Marvin Bagley III,Washington Wizards,PF,119,262,53,102,492.7,10,14,383.3,3,8,250.0,40,46,86,16,13,7,8,11,-40,221,205,135,102,363.0,137.06944444444443,12.402777777777779,2.125,626.7777777777778,594.2361111111111,370.56944444444446,174.44444444444446,10
328,Mason Jones,Sacramento Kings,G,1,13,0,3,0.0,1,2,50.0,0,2,0.0,1,3,4,4,0,0,0,0,10,9,5,5,8,0.0,0.0,0.0,0.0,0.0,0.0,0.0,0.0,1
329,Mason Plumlee,LA Clippers,C,63,145,22,34,630.0,19,26,466.7,0,0,0.0,13,43,56,13,21,4,11,6,-6,132,119,76,69,76.14186851211073,107.97923875432525,12.681660899653979,0.0,224.78892733564015,203.39446366782005,95.33564013840831,122.86159169550173,10
330,Matisse Thybulle,Portland Trail Blazers,SG,60,233,22,58,318.9,6,9,250.0,10,30,293.3,8,21,29,16,19,26,10,5,-70,105,89,76,45,337.11111111111114,27.444444444444446,18.53061224489796,12.36281179138322,618.9591836734694,463.0,480.40362811791385,58.64172335600907,10
331,Matt Ryan,New Orleans Pelicans,F,26,49,9,21,200.0,0,0,0.0,8,17,194.4,1,8,9,2,5,0,2,0,-9,37,35,28,11,136.55555555555557,7.25,1.2222222222222223,11.555555555555557,204.80555555555554,200.80555555555557,141.55555555555554,7.472222222222223,5
332,Matthew Hurt,Memphis Grizzlies,F,32,110,12,33,215.9,3,3,200.0,5,19,233.4,9,7,16,4,8,3,2,3,-7,52,48,36,20,122.28571428571429,23.46428571428571,4.2857142857142865,4.321428571428571,246.60714285714292,199.75,161.14285714285717,35.75,7
333,Max Christie,Los Angeles Lakers,G,52,154,17,35,625.7,9,12,500.0,9,19,420.0,3,15,18,13,4,3,1,5,-8,83,70,65,31,76.27777777777777,16.5,30.27777777777778,5.4444444444444455,259.61111111111103,145.7777777777778,172.1111111111111,64.77777777777777,10
334,Max Strus,Cleveland Cavaliers,SG,118,312,42,93,422.4,12,15,316.7,22,62,318.5,11,20,31,48,25,6,16,4,-32,197,149,166,79,288.89273356401384,29.78892733564014,24.9757785467128,31.79930795847751,403.7820069204152,330.9031141868512,380.8719723183391,35.66435986159169,10
335,Maxi Kleber,Dallas Mavericks,PF,37,227,11,35,232.79999999999998,8,11,300.0,7,24,266.6,6,39,45,11,16,3,3,6,48,93,82,48,56,134.37396121883654,106.82825484764544,9.620498614958448,4.479224376731302,446.584487534626,368.4819944598338,187.0083102493075,141.9168975069252,10
336,Michael Porter Jr.,Denver Nuggets,SF,201,325,80,149,540.6,11,11,500.0,30,72,429.8,13,60,73,17,19,7,13,6,65,291,274,218,90,658.8271604938271,117.64197530864199,12.160493827160494,20.771604938271604,1324.2345679012346,1222.4444444444446,735.9753086419752,154.44444444444443,10
337,Mikal Bridges,Brooklyn Nets,SF,165,365,58,155,360.79999999999995,24,35,519.4,25,83,317.7,7,34,41,40,12,11,15,2,-18,246,206,205,81,747.4444444444445,39.69387755102041,48.0,27.947845804988663,833.2335600907029,853.2335600907029,713.4444444444445,101.6938775510204,10
338,Mike Conley,Minnesota Timberwolves,PG,102,283,35,83,389.8,16,18,433.3,16,47,325.0,10,24,34,45,12,12,17,0,-16,181,136,147,79,323.7,34.5,58.5,18.4,237.3,182.8,346.2,125.0,10
339,Mike Muscala,Oklahoma City Thunder,C,26,108,9,29,234.2,1,2,50.0,7,20,250.0,5,12,17,4,4,2,1,1,40,47,43,30,21,75.50617283950618,11.0,6.0246913580246915,8.876543209876543,155.22222222222223,132.06172839506172,91.55555555555556,24.1358024691358,8
340,Miles Bridges,Charlotte Hornets,SF,205,393,83,184,448.7,18,25,556.7,21,66,317.5,14,79,93,28,17,9,23,3,-80,326,298,233,121,513.0,121.2361111111111,29.15625,21.444444444444446,1110.1006944444446,937.4027777777777,653.90625,182.18402777777777,10
341,Miles McBride,New York Knicks,PG,94,254,36,82,530.0,5,6,266.7,17,43,353.0,6,11,17,27,19,10,4,2,-35,138,111,121,44,216.82548476454292,12.711911357340721,105.63711911357342,18.18005540166205,516.1385041551247,288.98891966759004,422.7174515235457,139.60664819944597,10
342,Mo Bamba,Philadelphia 76ers,C,36,142,14,36,301.7,5,8,125.0,3,9,116.7,13,34,47,9,19,1,10,11,-8,92,83,45,56,115.425,48.5,9.000000000000002,4.2,223.625,237.32500000000002,106.72500000000002,52.5,10
343,Monte Morris,Minnesota Timberwolves,PG,53,154,20,52,431.1,5,7,275.0,8,21,341.6,3,12,15,30,4,6,2,1,20,98,68,83,45,93.4140625,18.65625,41.1640625,3.90625,212.0,126.1640625,154.65625,84.4140625,10
344,Moritz Wagner,Orlando Magic,C,115,178,43,64,656.0,26,29,643.1,3,9,233.3,15,35,50,11,18,7,13,2,57,176,165,126,61,352.5,67.49173553719008,5.1115702479338845,2.103305785123967,574.5495867768595,609.8099173553719,327.5206611570248,62.32231404958678,10
345,Moses Brown,Portland Trail Blazers,C,13,28,6,10,233.3,1,3,33.3,0,0,0.0,4,5,9,2,4,0,2,1,7,24,22,15,11,14.75,8.083333333333332,3.0000000000000004,0.0,5.0,9.999999999999998,10.083333333333332,10.75,3
346,Moses Moody,Golden State Warriors,SG,88,206,34,77,472.0,11,14,333.3,9,35,242.1,12,30,42,5,12,8,8,6,29,135,130,93,47,162.49382716049382,52.5679012345679,2.5308641975308643,19.444444444444446,278.11111111111114,269.67901234567904,169.2716049382716,56.75308641975308,10
347,Mouhamadou Gueye,Toronto Raptors,F,2,6,1,3,33.3,0,0,0.0,0,0,0.0,2,1,3,0,1,0,0,2,4,5,5,2,3,1.0,0.25,0.0,0.0,2.25,2.25,1.0,0.25,1
348,Moussa Diabate,LA Clippers,F,2,7,1,1,100.0,0,2,0.0,0,0,0.0,1,3,4,0,0,1,0,1,1,6,6,2,4,0.0,0.0,0.0,0.0,0.0,0.0,0.0,0.0,1
349,Myles Turner,Indiana Pacers,C,181,271,64,114,577.1,40,49,726.7,13,40,313.0,16,63,79,11,28,6,17,16,2,271,260,192,90,410.8515625,65.9765625,12.9765625,14.125,496.4140625,439.15625,479.15625,67.90625,10
350,Naji Marshall,New Orleans Pelicans,SF,68,204,27,49,407.5,2,3,150.0,12,25,391.6,8,33,41,20,11,9,12,4,60,129,109,88,61,376.9619377162629,53.66435986159169,18.034602076124568,13.612456747404845,403.0,407.74048442906576,352.5467128027682,91.37370242214533,10
351,Nassir Little,Phoenix Suns,SF,9,50,3,12,133.3,0,0,0.0,3,8,200.0,0,10,10,3,6,0,1,2,-8,22,19,12,13,13.078125,5.953125,3.453125,1.453125,22.828125,23.25,13.25,8.8125,5
352,Nate Hinton,Houston Rockets,G,10,15,3,5,60.0,2,3,66.7,2,3,66.7,1,2,3,2,2,1,0,1,13,15,13,12,5,43.559999999999995,4.840000000000001,1.44,1.9599999999999997,100.0,77.44000000000001,60.839999999999996,11.559999999999999,1
353,Nathan Mensah,Charlotte Hornets,C,4,45,2,5,66.7,0,0,0.0,0,0,0.0,4,4,8,0,8,1,1,2,-10,12,12,4,8,12.88888888888889,7.555555555555557,0.0,0.0,40.0,40.0,12.88888888888889,7.555555555555557,5
354,Naz Reid,Minnesota Timberwolves,C,145,269,50,111,446.7,24,31,587.5,21,49,438.7,16,48,64,14,24,6,13,11,16,223,209,159,78,747.0,56.925619834710744,8.466942148760332,45.59504132231405,730.7479338842975,651.198347107438,804.6487603305785,87.29338842975206,10
355,Neemias Queta,Boston Celtics,C,39,72,19,26,443.4,1,2,100.0,0,0,0.0,12,15,27,4,7,3,3,6,61,70,66,43,31,19.5,37.5,1.3333333333333335,0.0,89.33333333333333,100.0,14.833333333333332,32.833333333333336,6
356,Nic Claxton,Brooklyn Nets,C,122,306,50,79,637.6,22,34,408.9,0,0,0.0,16,67,83,26,24,6,15,17,-17,231,205,148,109,212.0,73.75736961451248,8.879818594104307,0.0,315.2448979591837,290.1383219954649,215.35600907029476,104.38775510204083,10
357,Nick Jr. Smith,Charlotte Hornets,G,59,179,19,63,331.1,8,9,187.5,13,36,324.9,3,8,11,20,19,5,4,0,4,90,70,79,31,189.8,11.177777777777777,20.400000000000002,13.977777777777778,216.71111111111108,210.84444444444446,183.0,44.24444444444445,10
358,Nick Richards,Charlotte Hornets,C,113,284,46,65,699.5,21,28,538.1,0,1,0.0,31,56,87,5,26,8,12,11,-41,205,200,118,92,300.1001890359168,99.75236294896031,8.73156899810964,0.0,466.28922495274105,453.70510396975425,303.8449905482041,117.32325141776938,10
359,Nickeil Alexander-Walker,Minnesota Timberwolves,SG,77,231,29,77,371.3,8,9,450.0,11,39,310.0,4,17,21,24,14,4,8,7,44,122,98,101,45,189.38016528925618,27.198347107438018,28.764462809917354,15.37603305785124,192.36776859504133,127.15702479338842,236.73140495867767,73.82231404958678,10
360,Nicolas Batum,Philadelphia 76ers,PF,39,200,13,41,219.6,5,5,200.0,8,28,201.6,13,26,39,13,17,6,5,5,-49,91,78,52,52,80.88,68.0,12.280000000000001,4.08,240.51999999999998,188.48000000000002,88.32000000000001,124.88000000000001,8
361,Nikola Jokic,Denver Nuggets,C,247,366,99,168,607.7,41,46,876.4,8,30,143.7,21,103,124,102,26,14,26,9,130,473,371,349,226,509.44444444444446,182.54938271604937,131.3827160493827,15.679012345679013,1159.8827160493827,774.0308641975308,719.8641975308642,489.3641975308642,10
362,Nikola Jovic,Miami Heat,F,72,191,26,53,425.6,6,10,225.0,14,32,410.8,1,37,38,19,14,6,9,3,24,129,110,91,57,334.4378698224852,39.62130177514793,13.0,17.171597633136095,552.9408284023668,492.40236686390534,379.59171597633133,68.00591715976331,9
363,Nikola Vucevic,Chicago Bulls,C,207,352,92,194,464.0,8,11,350.0,15,47,314.2,38,76,114,27,30,4,23,4,-84,348,321,234,141,464.0371900826446,35.65702479338844,16.367768595041323,6.520661157024794,700.5,557.7768595041322,595.5206611570247,63.26446280991736,10
364,Noah Clowney,Brooklyn Nets,F,8,41,3,6,50.0,0,0,0.0,0,2,0.0,3,4,7,5,2,2,1,0,-7,20,15,13,12,43.489795918367356,5.816326530612244,1.4897959183673473,0.061224489795918366,69.0,77.91836734693877,35.95918367346939,5.9183673469387745,3
365,Norman Powell,LA Clippers,G,155,280,58,121,471.2,9,14,316.7,30,71,417.5,4,25,29,14,17,9,10,2,-1,198,184,169,43,339.6570247933885,6.929752066115703,19.355371900826448,34.5,244.80991735537194,316.0,264.0041322314049,30.747933884297517,10
366,Obi Toppin,Indiana Pacers,PF,81,183,31,59,498.3,6,8,300.0,13,33,356.7,9,26,35,10,13,6,8,7,42,126,116,91,45,261.8698060941828,25.337950138504155,20.997229916897506,8.479224376731302,434.8254847645429,376.2714681440443,308.25207756232686,58.50692520775623,10
367,Ochai Agbaji,Toronto Raptors,G,60,169,22,57,424.0,7,9,250.0,9,27,302.6,9,16,25,9,14,4,8,4,-28,94,85,69,34,268.0,67.33795013850414,4.922437673130194,13.365650969529087,499.8282548476455,499.1274238227147,275.97506925207756,64.98614958448753,10
368,Olivier Sarr,Oklahoma City Thunder,C,11,22,4,7,125.0,3,5,116.7,0,1,0.0,4,4,8,0,3,0,1,1,-14,19,19,11,8,34.92,6.920000000000002,0.0,0.0,59.68000000000001,59.68000000000001,34.92,6.920000000000002,3
369,OlivierMaxence Prosper,Dallas Mavericks,F,10,31,3,6,150.0,4,7,57.1,0,2,0.0,2,6,8,0,1,1,1,1,-14,18,18,10,8,22.66666666666667,9.925925925925926,0.0,0.0,61.925925925925924,61.925925925925924,22.66666666666667,9.925925925925926,3
370,Omer Yurtseven,Utah Jazz,C,19,47,9,14,183.3,1,3,50.0,0,1,0.0,9,8,17,3,5,1,2,3,-5,39,36,22,20,76.19444444444446,29.444444444444443,7.0,0.027777777777777776,196.75,146.25,118.36111111111111,44.77777777777777,4
371,Onuralp Bitim,Chicago Bulls,SF,29,90,9,22,220.3,3,4,150.0,8,17,256.7,2,10,12,3,6,1,3,1,11,44,41,32,15,70.71900826446281,33.17355371900827,1.6115702479338843,5.355371900826446,173.50413223140495,174.7851239669421,70.24793388429752,33.97520661157024,6
372,Onyeka Okongwu,Atlanta Hawks,PF,138,278,57,82,646.7,16,21,492.9,8,16,433.3,32,40,72,9,27,4,5,15,24,219,210,147,81,182.0,136.0,8.0,4.888888888888889,502.0,486.0,198.0,144.0,9
373,Orlando Robinson,Miami Heat,C,2,34,1,5,33.3,0,0,0.0,0,1,0.0,4,8,12,2,4,1,3,0,3,16,14,4,14,3.3469387755102042,10.816326530612248,1.1020408163265305,0.0,18.530612244897956,13.26530612244898,4.6938775510204085,15.836734693877549,3
374,Oscar Tshiebwe,Indiana Pacers,C,3,5,1,3,33.3,1,2,50.0,0,0,0.0,2,0,2,0,1,0,0,1,8,5,5,3,2,0.25,0.0,0.0,0.0,0.25,0.25,0.25,0.0,1
375,Oshae Brissett,Boston Celtics,SF,31,98,10,24,182.9,9,16,355.0,2,8,133.3,5,22,27,13,8,4,4,1,14,71,58,44,40,115.56804733727812,60.349112426035504,20.27810650887574,1.5739644970414202,390.58579881656806,261.72781065088753,222.1420118343195,102.9112426035503,8
376,Ousmane Dieng,Oklahoma City Thunder,F,28,78,10,23,324.4,4,4,200.0,4,12,220.0,1,7,8,12,3,3,6,3,19,48,36,40,20,94.0,4.857142857142858,17.428571428571427,3.714285714285714,188.85714285714283,126.85714285714286,151.4285714285714,26.857142857142858,7
377,P.J. Tucker,LA Clippers,PF,5,49,2,7,33.3,0,0,0.0,1,4,25.0,5,6,11,1,3,0,2,1,-17,17,16,6,12,18.75,18.75,0.75,0.75,84.75,70.0,27.0,26.0,4
378,P.J. Washington,Dallas Mavericks,PF,118,321,43,100,407.6,13,17,450.0,19,58,297.5,14,40,54,13,17,11,11,9,-2,185,172,131,67,463.9183673469388,38.40816326530613,8.83673469387755,23.24489795918367,560.0612244897959,563.1020408163265,467.1224489795918,41.0,10
379,Paolo Banchero,Orlando Magic,PF,233,351,86,170,499.6,44,57,728.0,17,43,350.0,9,58,67,56,17,5,37,9,27,356,300,289,123,447.325,20.1,75.025,26.125,666.0,533.225,586.5,88.72500000000001,10
380,Pascal Siakam,Indiana Pacers,PF,194,326,81,154,524.7,22,27,766.7,10,30,312.4,17,53,70,38,23,6,9,5,-61,302,264,232,108,279.9279778393352,113.77285318559558,39.61772853185596,8.443213296398891,520.4265927977839,382.6592797783934,370.0498614958449,201.0360110803324,10
381,Pat Connaughton,Milwaukee Bucks,SG,71,221,25,49,498.4,7,9,225.0,14,34,395.3,6,23,29,12,9,8,6,5,0,112,100,83,41,213.65028355387525,38.24385633270321,33.08506616257089,12.400756143667296,379.9395085066162,316.9262759924386,267.0,80.99243856332704,10
382,Patrick Baldwin Jr.,Washington Wizards,F,11,44,4,16,116.7,1,2,50.0,2,10,50.0,2,10,12,2,5,1,1,1,17,25,23,13,14,1.959999999999999,14.160000000000002,1.04,1.04,13.639999999999997,17.0,2.4399999999999995,11.36,4
383,Patrick Beverley,Milwaukee Bucks,PG,57,186,20,54,319.6,8,10,416.7,9,29,252.9,10,28,38,16,16,10,6,7,-65,111,95,73,54,202.4214876033058,82.74793388429751,21.702479338842977,8.900826446280991,535.3099173553719,435.8223140495868,295.9586776859504,110.40082644628099,10
384,Patty Mills,Atlanta Hawks,PG,2,42,1,8,25.0,0,0,0.0,0,6,0.0,2,5,7,2,1,3,1,0,-1,11,9,4,9,88.5625,4.8125,1.25,5.0625,83.0,89.75,78.5625,9.3125,4
385,Patty Mills,Miami Heat,PG,13,16,5,7,71.4,0,0,0.0,3,4,75.0,0,2,2,0,1,0,1,0,13,15,15,13,2,62.015625,0.140625,0.0625,3.515625,64.0,68.0625,58.140625,0.015625,1
386,Paul George,LA Clippers,F,212,351,76,164,456.0,30,39,657.1,30,83,358.8,3,52,55,36,26,13,19,6,24,303,267,248,91,401.1800554016621,9.670360110803324,58.127423822714675,21.77285318559557,409.72022160664824,402.46260387811634,406.6149584487534,69.62049861495845,10
387,Paul Reed,Philadelphia 76ers,SF,104,255,45,84,545.4,8,9,450.0,6,10,350.0,31,48,79,17,32,5,7,15,-21,200,183,121,96,374.0,120.9297520661157,12.107438016528926,4.429752066115702,963.0123966942149,829.2933884297521,480.2892561983471,160.46694214876032,10
388,Payton Pritchard,Boston Celtics,PG,85,188,34,64,417.6,0,0,0.0,17,39,296.7,7,22,29,16,14,5,10,0,38,130,114,101,45,729.4,27.799999999999997,28.425000000000004,34.2,1179.0249999999999,908.4000000000001,958.525,97.72500000000001,10
389,Peyton Watson,Denver Nuggets,F,65,184,25,58,410.6,10,15,280.0,5,21,308.3,7,24,31,9,13,6,12,15,-15,105,96,74,40,157.0332409972299,30.313019390581715,12.922437673130194,2.673130193905817,297.9861495844875,292.3379501385042,153.92797783933517,51.98891966759003,10
390,Precious Achiuwa,New York Knicks,PF,123,339,49,93,529.7,20,33,424.4,5,17,250.0,45,56,101,18,24,9,17,19,20,242,224,141,119,369.0,149.0,23.6398891966759,4.839335180055402,738.4819944598338,546.0,520.95567867036,213.16620498614958,10
391,Quentin Grimes,Detroit Pistons,SG,40,130,14,49,153.4,5,5,200.0,7,31,120.0,0,16,16,12,6,5,5,4,-32,68,56,52,28,151.33333333333334,19.333333333333336,8.0,6.833333333333334,261.33333333333337,233.33333333333334,171.33333333333331,35.333333333333336,6
392,R. Rupert,Portland Trail Blazers,G,23,95,8,22,238.10000000000002,2,2,100.0,5,12,225.0,7,10,17,9,12,3,5,0,-7,49,40,32,26,133.61157024793388,17.884297520661157,10.289256198347108,7.628099173553719,212.92561983471074,231.0,122.01652892561984,21.694214876033058,7
393,RJ Barrett,Toronto Raptors,SG,196,323,80,146,545.2,19,45,363.2,17,36,391.7,9,42,51,38,21,6,26,4,-48,285,247,234,89,267.265306122449,56.90816326530613,38.775510204081634,18.622448979591837,367.5612244897959,272.5,388.12244897959187,69.88775510204081,10
394,Reggie Bullock,Houston Rockets,SF,15,51,5,12,191.6,0,0,0.0,5,11,199.89999999999998,1,8,9,1,3,1,0,0,20,25,24,16,10,24.328125,7.703125,0.828125,2.703125,37.203125,36.8125,26.0,7.25,5
395,Reggie Jackson,Denver Nuggets,PG,59,184,26,76,309.1,0,0,0.0,7,32,205.8,2,12,14,31,14,3,9,1,35,104,73,90,45,144.7229916897507,19.20775623268698,55.0,4.301939058171745,437.19667590027706,213.88088642659284,327.4072022160665,114.8393351800554,10
396,Richaun Holmes,Washington Wizards,F,59,147,24,39,479.7,10,11,350.0,1,1,100.0,14,25,39,6,18,5,4,4,-8,104,98,65,45,277.39446366782005,91.63667820069205,6.671280276816609,0.9169550173010381,631.916955017301,609.923875432526,295.9204152249135,101.7750865051903,10
397,Ricky IV Council,Philadelphia 76ers,G,71,132,24,56,394.0,22,31,592.5,1,14,25.0,7,22,29,5,8,0,3,0,-20,105,100,76,34,399.8698060941828,88.0803324099723,4.673130193905816,0.9335180055401661,901.5595567867036,819.9002770083102,462.29916897506916,111.98337950138504,10
398,Robin Lopez,Milwaukee Bucks,C,6,23,3,9,37.5,0,0,0.0,0,2,0.0,1,0,1,1,3,1,0,2,-16,8,7,7,2,20.0,0.5,0.625,0.0,21.125,26.5,15.625,0.125,2
399,Royce O'Neale,Phoenix Suns,PF,101,313,35,94,349.8,5,6,250.0,26,70,345.8,9,58,67,37,19,12,7,6,70,205,168,138,104,340.191135734072,68.66759002770084,41.637119113573405,24.559556786703602,736.9168975069252,638.3213296398892,431.2520775623269,117.8393351800554,10
400,Rudy Gobert,Minnesota Timberwolves,C,138,365,56,85,661.7,26,39,605.0,0,1,0.0,43,107,150,12,38,5,17,25,31,300,288,150,162,250.9750566893424,95.0702947845805,9.614512471655328,0.0,389.1111111111111,402.9795918367347,215.83219954648527,125.95918367346937,10
401,Rui Hachimura,Los Angeles Lakers,PF,170,318,71,129,526.8,7,12,280.0,21,43,480.0,6,31,37,8,17,8,6,5,-25,215,207,178,45,875.4256198347107,42.8801652892562,5.838842975206612,28.648760330578515,748.4008264462809,759.611570247934,861.7851239669421,51.14876033057851,10
402,Russell Westbrook,LA Clippers,PG,93,216,37,98,389.9,15,21,523.3,4,26,95.0,8,19,27,29,17,13,15,1,-10,149,120,122,56,174.6,24.2,34.77777777777777,4.444444444444445,319.5777777777778,275.6,197.64444444444445,79.91111111111111,10
403,Saben Lee,Phoenix Suns,G,35,98,9,28,194.29999999999998,15,20,416.7,2,9,83.3,3,15,18,17,6,4,2,0,11,70,53,52,35,199.22222222222223,25.5,5.222222222222221,1.5555555555555558,351.5,351.55555555555554,198.0,31.888888888888893,8
404,Saddiq Bey,Atlanta Hawks,SF,143,342,50,125,390.6,27,31,766.7,16,56,260.9,29,32,61,15,7,4,10,4,-24,219,204,158,76,395.325,72.89999999999999,10.525,16.425,417.29999999999995,484.625,338.0,73.42500000000001,10
405,Sam Hauser,Boston Celtics,SF,60,165,21,44,510.0,0,0,0.0,18,39,502.7,3,29,32,6,12,2,2,5,83,98,92,66,38,174.4,35.825,4.3999999999999995,16.0,259.825,231.825,200.8,41.825,10
406,Sam Merrill,Cleveland Cavaliers,SG,61,170,20,60,324.0,2,2,200.0,19,57,298.2,4,18,22,12,8,2,1,0,-23,95,83,73,34,351.3,16.625,13.625,42.925000000000004,442.9,407.725,378.72499999999997,38.0,10
407,Sandro Mamukelashvili,San Antonio Spurs,PF,10,31,5,10,130.0,0,1,0.0,0,1,0.0,4,1,5,2,3,2,0,0,14,17,15,12,7,49.02479338842976,0.7520661157024793,1.008264462809917,0.0,55.0,48.55371900826447,56.479338842975196,0.7520661157024793,4
408,Santi Aldama,Memphis Grizzlies,PF,108,299,42,93,479.4,7,11,266.7,17,47,413.1,14,40,54,29,14,6,16,13,-64,191,162,137,83,233.55102040816328,22.408163265306122,58.981859410430836,19.66213151927438,352.11111111111114,283.9183673469388,340.9954648526077,42.13832199546485,10
409,Sasha Vezenkov,Sacramento Kings,F,9,22,2,7,28.6,3,3,100.0,2,4,50.0,0,1,1,1,4,1,0,0,24,11,10,10,2,4.5,0.5,0.5,2.0,4.5,2.0,8.0,0.0,2
410,Scoot Henderson,Portland Trail Blazers,G,127,227,38,88,360.0,40,42,675.0,11,30,276.2,8,14,22,41,24,4,17,2,-23,190,149,168,63,395.69135802469134,51.80246913580247,44.87654320987654,9.88888888888889,445.7283950617284,477.9876543209877,340.8888888888889,119.2222222222222,8
411,Scottie Barnes,Toronto Raptors,SF,179,333,70,155,460.1,33,39,674.9,6,36,159.89999999999998,28,63,91,75,18,13,31,14,21,345,270,254,166,386.7777777777778,98.11111111111111,83.84444444444443,4.800000000000001,825.4444444444445,588.1777777777778,576.0,230.0,10
412,Scotty Pippen Jr.,Memphis Grizzlies,G,66,152,22,50,245.0,10,16,190.4,12,22,355.0,7,13,20,29,20,8,12,4,-25,115,86,95,49,156.0,11.333333333333334,4.833333333333334,2.0,196.83333333333331,203.33333333333331,158.83333333333334,6.833333333333334,6
413,Seth Curry,Charlotte Hornets,SG,81,181,29,67,372.5,14,15,566.7,9,31,256.6,4,15,19,17,7,5,7,3,-33,117,100,98,36,233.0,12.900826446280993,16.140495867768593,4.900826446280991,334.3388429752066,276.08264462809916,269.8677685950413,50.429752066115704,10
414,Shai Gilgeous-Alexander,Oklahoma City Thunder,PG,320,343,115,214,533.8,75,86,859.5,15,37,495.3,5,51,56,59,28,18,21,14,99,435,376,379,115,226.81632653061223,32.87981859410431,49.693877551020414,14.505668934240362,308.04308390022675,194.44444444444446,339.53061224489795,83.45804988662131,10
415,Shake Milton,New York Knicks,SG,38,86,16,34,301.1,2,3,66.7,4,10,150.0,7,12,19,8,5,2,4,1,-16,65,57,46,27,115.83999999999999,73.66000000000001,15.040000000000003,7.760000000000001,467.34000000000003,349.26000000000005,189.76000000000002,132.86,6
416,Simone Fontecchio,Detroit Pistons,F,153,281,56,115,472.7,15,16,466.7,26,59,412.5,6,25,31,18,17,10,9,2,-32,202,184,171,49,466.59999999999997,29.0,21.600000000000005,26.425,515.1999999999999,430.0,539.4000000000001,63.0,10
417,Skylar Mays,Los Angeles Lakers,SG,6,29,3,8,120.0,0,0,0.0,0,3,0.0,0,1,1,2,1,1,1,1,0,9,7,8,3,11.918367346938775,0.693877551020408,2.693877551020408,0.0,5.9183673469387745,11.959183673469388,7.265306122448978,2.0,3
418,Spencer Dinwiddie,Los Angeles Lakers,PG,53,241,18,48,380.0,7,10,316.7,10,29,316.7,1,9,10,29,18,3,7,4,46,92,63,82,39,110.58448753462605,10.770083102493075,26.81163434903047,6.027700831024931,204.93074792243763,117.83102493074793,186.3213296398892,48.94459833795014,10
419,Stanley Umude,Detroit Pistons,G,17,49,6,13,82.5,1,1,100.0,4,7,108.3,3,2,5,1,7,0,1,1,-15,23,22,18,6,110.0,0.6875,0.6875,4.6875,110.0,121.6875,99.6875,0.0,3
420,Stephen Curry,Golden State Warriors,PG,205,299,70,189,356.5,25,29,737.5,40,122,309.6,7,33,40,49,11,7,28,1,39,294,245,254,89,1082.289256198347,110.64876033057851,72.96694214876034,86.5,1644.5165289256197,1589.8553719008266,1200.0661157024795,120.5,10
421,Svi Mykhailiuk,Boston Celtics,SG,22,47,8,20,167.5,0,0,0.0,6,16,113.3,2,5,7,6,1,2,1,0,34,35,29,28,13,26.111111111111107,9.0,5.111111111111112,3.444444444444444,91.0,60.77777777777777,47.0,23.444444444444443,4
422,T.J. McConnell,Indiana Pacers,PG,113,181,54,92,560.3,1,1,100.0,4,5,200.0,7,20,27,49,10,11,14,1,15,189,140,162,76,335.8515625,30.125,55.40625,6.4765625,484.0390625,383.1640625,439.1015625,83.15625,10
423,T.J. Warren,Minnesota Timberwolves,SF,13,27,6,8,160.0,0,0,0.0,1,3,33.3,1,4,5,0,4,0,1,0,18,18,18,13,5,0.5199999999999999,4.68,0.0,0.52,2.0799999999999996,2.0799999999999996,0.5199999999999999,4.68,2
424,Taj Gibson,New York Knicks,F,2,68,0,9,0.0,2,2,100.0,0,2,0.0,4,6,10,4,8,1,3,0,2,16,12,6,14,3.2222222222222223,10.555555555555554,0.888888888888889,0.0,16.222222222222225,10.0,5.0,15.88888888888889,5
425,Talen Horton-Tucker,Utah Jazz,SG,71,137,21,58,379.3,20,25,555.6,9,26,414.9,8,16,24,25,13,3,4,4,-60,120,95,96,49,81.61111111111111,54.625,22.5,3.0,291.7361111111111,190.2361111111111,157.11111111111111,103.125,10
426,Taurean Prince,Los Angeles Lakers,PF,70,210,27,63,436.0,2,3,100.0,14,35,318.6,2,28,30,13,13,3,8,4,3,113,100,83,43,174.06611570247935,32.06611570247934,10.239669421487603,14.400826446280991,300.35537190082647,292.26446280991735,177.2314049586777,47.231404958677686,10
427,Taylor Hendricks,Utah Jazz,F,70,220,28,58,514.6,3,3,200.0,11,33,406.7,16,46,62,7,28,5,8,6,-34,139,132,77,69,126.0,105.6,2.1,4.9,334.90000000000003,297.6,146.1,124.9,10
428,Taze Moore,Portland Trail Blazers,G,2,5,1,1,100.0,0,0,0.0,0,0,0.0,0,0,0,1,0,0,1,0,7,3,2,3,1,2.25,0.0,0.5625,0.0,5.0625,2.25,5.0625,0.5625,1
429,Terance Mann,LA Clippers,SG,118,260,47,74,645.6,12,12,700.0,12,24,333.3,16,29,45,17,19,2,6,1,-10,180,163,135,62,345.50472589792065,102.93950850661628,32.41776937618147,18.0,768.0264650283553,711.8884688090736,363.0,174.0,10
430,Terquavion Smith,Philadelphia 76ers,G,38,47,14,28,241.1,0,1,0.0,10,22,216.6,0,2,2,5,3,4,3,0,0,45,40,43,7,171.8125,1.3125,2.703125,14.8125,180.953125,167.0,183.203125,6.578125,5
431,Terry Rozier,Miami Heat,SG,171,321,66,146,458.8,21,23,741.7,18,53,336.9,7,36,43,61,19,8,15,2,17,275,214,232,104,161.7890625,31.15625,44.90625,20.0,398.8515625,258.8515625,300.2265625,77.625,10
432,Terry Taylor,Chicago Bulls,F,9,39,3,7,175.0,1,2,50.0,2,3,150.0,2,9,11,2,1,1,0,0,-17,22,20,11,13,12.83,25.470000000000002,3.07,1.3200000000000003,89.07000000000002,67.28,20.080000000000002,43.080000000000005,3
433,Thaddeus Young,Phoenix Suns,F,6,29,3,6,100.0,0,2,0.0,0,0,0.0,7,3,10,0,4,1,1,0,3,16,16,6,10,11.876543209876544,18.88888888888889,4.839506172839506,0.0,27.35802469135802,12.839506172839506,30.54320987654321,19.580246913580247,2
434,Thaddeus Young,Phoenix Suns,PF,41,128,20,28,469.9,1,3,50.0,0,2,0.0,11,18,29,14,12,2,4,1,-24,84,70,55,43,132.40740740740742,22.333333333333336,28.962962962962965,0.0,354.07407407407413,192.07407407407408,265.0740740740741,80.62962962962962,6
435,Thanasis Antetokounmpo,Milwaukee Bucks,SF,8,41,4,9,216.7,0,2,0.0,0,1,0.0,2,0,2,4,7,1,2,1,-11,14,10,12,6,13.0,1.4000000000000004,1.6,0.0,22.000000000000004,17.2,16.2,4.6,5
436,Theo Maledon,Phoenix Suns,PG,5,10,1,2,50.0,3,3,100.0,0,0,0.0,0,1,1,0,3,0,3,0,-11,6,6,5,1,14.0625,0.5625,0.0,0.0,20.25,20.25,14.0625,0.5625,1
437,Thomas Bryant,Miami Heat,C,2,16,1,4,33.3,0,0,0.0,0,3,0.0,0,1,1,1,2,0,0,3,-3,4,3,3,2,2.0,0.625,0.5,0.0,8.125,4.625,4.5,2.125,2
438,Tim Hardaway Jr.,Dallas Mavericks,SF,97,217,34,96,354.2,9,14,350.0,20,59,324.4,2,22,24,16,11,3,10,2,5,137,121,113,40,281.9750566893424,25.709750566893423,24.458049886621314,19.83673469387755,424.1111111111112,375.4897959183673,335.9478458049887,44.816326530612244,10
439,Tobias Harris,Philadelphia 76ers,PF,160,340,65,152,407.1,16,19,700.0,14,43,282.7,14,58,72,25,17,15,10,7,-18,257,232,185,97,653.0803324099724,81.61772853185596,26.828254847645432,23.606648199445985,1095.9362880886426,953.8116343490304,743.759002770083,159.89196675900277,10
440,Torrey Craig,Chicago Bulls,SF,41,149,14,35,281.6,3,4,150.0,10,29,255.0,7,23,30,10,10,4,6,6,-16,81,71,51,40,63.62809917355372,30.694214876033058,19.702479338842977,3.5041322314049586,210.68595041322314,162.71900826446281,97.61157024793387,64.3801652892562,8
441,Tosan Evbuomwan,Detroit Pistons,F,17,90,7,18,314.3,0,0,0.0,3,9,183.3,8,8,16,6,6,1,1,1,-34,39,33,23,22,14.833333333333332,107.33333333333334,8.0,1.5,197.5,137.5,28.833333333333332,161.33333333333334,6
442,Toumani Camara,Portland Trail Blazers,F,98,253,35,72,479.3,16,19,516.7,12,22,508.3,27,34,61,17,21,6,15,3,32,176,159,115,78,307.18559556786704,51.86426592797784,12.878116343490305,9.817174515235457,626.2714681440443,514.0914127423822,393.03324099722994,91.07479224376732,10
443,Trae Young,Atlanta Hawks,PG,235,370,76,173,432.4,45,55,813.4,38,93,399.0,2,18,20,109,22,11,45,2,-38,364,255,344,129,749.99173553719,12.0,83.0,44.247933884297524,779.1735537190083,615.99173553719,917.1735537190083,91.0,10
444,Trayce JacksonDavis,Golden State Warriors,F,87,161,39,50,784.2,9,21,361.7,0,0,0.0,20,26,46,9,22,4,6,14,-31,142,133,96,55,203.6115702479339,59.17355371900827,7.198347107438016,0.0,314.08264462809916,313.59504132231405,188.51239669421489,81.9586776859504,10
445,Tre Jones,San Antonio Spurs,PG,80,275,30,57,536.1,11,13,383.3,9,22,335.0,6,35,41,70,9,6,15,1,10,191,121,150,111,258.0,37.11791383219954,101.26530612244898,14.98185941043084,561.1723356009071,352.1655328798186,442.6938775510204,162.69614512471657,10
446,Tre Mann,Charlotte Hornets,PG,119,309,44,97,446.5,15,19,615.0,16,37,388.3,4,49,53,43,21,16,15,0,-29,215,172,162,96,229.59504132231405,46.239669421487605,23.925619834710744,10.429752066115702,470.5206611570248,381.05785123966945,281.86776859504135,107.35537190082644,10
447,Trendon Watford,Brooklyn Nets,PF,78,139,27,56,579.9,19,20,550.0,5,13,300.0,10,23,33,3,19,0,9,5,-54,114,111,81,36,280.3737024221453,53.98961937716263,2.1003460207612457,4.716262975778546,505.46020761245677,469.6297577854671,313.8996539792388,58.39446366782006,10
448,Trent Forrest,Atlanta Hawks,G,13,52,6,10,225.0,1,2,50.0,0,1,0.0,1,4,5,13,5,0,1,0,1,31,18,26,18,36.94,7.0,17.5,0.0,75.64,72.54,49.040000000000006,15.5,6
449,Trevelin Queen,Orlando Magic,SG,0,8,0,2,0.0,0,0,0.0,0,1,0.0,0,1,1,0,1,0,0,0,-12,1,1,0,1,0.0,0.25,0.0,0.0,0.25,0.25,0.0,0.25,1
450,Trey Jemison,Memphis Grizzlies,C,60,204,26,48,528.1,8,11,450.0,0,0,0.0,19,27,46,8,36,5,12,11,-46,114,106,68,54,132.27777777777777,36.27777777777778,7.777777777777779,0.0,321.77777777777777,282.0,158.5,57.611111111111114,10
451,Trey Lyles,Sacramento Kings,PF,53,194,19,48,399.6,10,14,600.0,5,25,236.7,12,31,43,8,20,2,7,4,5,104,96,61,51,130.125,12.2,8.0,8.125,195.42499999999995,141.62499999999997,175.125,29.0,10
452,Trey Murphy III,New Orleans Pelicans,SG,158,311,50,116,408.1,22,31,633.4,36,92,350.4,11,43,54,26,13,15,1,9,104,238,212,184,80,896.1329639889196,55.98337950138504,36.144044321329645,77.39612188365652,1078.9972299168976,1093.9279778393352,879.163434903047,94.16620498614957,10
453,Troy Brown Jr.,Detroit Pistons,SF,30,95,11,30,232.9,2,2,100.0,6,18,206.6,2,16,18,8,6,1,3,0,-31,56,48,38,26,71.86776859504134,23.685950413223136,8.066115702479337,3.834710743801653,195.4214876033058,153.10743801652893,109.42148760330578,36.51239669421488,8
454,TyTy Washington Jr.,Milwaukee Bucks,G,0,8,0,2,0.0,0,0,0.0,0,1,0.0,0,0,0,1,0,0,0,0,-4,1,0,1,1,0.0,0.0,0.44444444444444453,0.0,0.44444444444444453,0.0,0.44444444444444453,0.44444444444444453,1
455,Tyler Herro,Miami Heat,PG,165,290,64,148,394.5,10,13,333.4,27,69,369.6,3,45,48,47,9,0,12,1,52,260,213,212,95,148.0,24.0,23.555555555555557,12.0,266.88888888888886,188.0,200.22222222222223,74.22222222222223,9
456,Tyrese Haliburton,Indiana Pacers,PG,156,327,59,140,391.6,16,20,421.7,22,75,265.9,5,31,36,102,7,12,21,3,-5,294,192,258,138,494.54938271604937,36.79012345679012,108.27777777777779,25.679012345679013,1080.0,544.9444444444445,999.9012345679012,174.7716049382716,10
457,Tyrese Maxey,Philadelphia 76ers,PG,264,379,96,216,444.8,44,47,825.0,28,77,357.3,6,42,48,56,23,10,24,3,-63,368,312,320,104,414.08284023668637,52.84023668639053,33.25443786982249,14.0,701.7159763313609,595.9408284023668,486.1301775147929,119.82248520710058,10
458,Tyus Jones,Washington Wizards,PG,94,304,37,78,448.7,2,2,200.0,18,43,422.5,5,20,25,99,5,8,13,2,-82,218,119,193,124,335.67346938775506,34.64172335600907,188.79138321995464,23.927437641723355,814.7755102040816,519.4444444444445,624.6009070294785,229.83673469387756,10
459,Udoka Azubuike,Phoenix Suns,C,2,11,1,3,33.3,0,2,0.0,0,0,0.0,2,4,6,0,1,0,0,0,-3,8,8,2,6,1.7777777777777781,13.444444444444443,0.0,0.0,25.0,25.0,1.7777777777777781,13.444444444444443,1
460,Vasilije Micic,Charlotte Hornets,G,101,254,40,101,387.8,15,18,516.7,6,36,173.6,6,16,22,58,10,8,25,0,-72,181,123,159,80,328.9954648526077,27.709750566893426,58.56689342403629,4.408163265306122,531.8163265306123,480.4104308390023,366.124716553288,100.5532879818594,10
461,Victor Wembanyama,San Antonio Spurs,C,228,302,80,162,493.7,44,52,753.0,24,56,435.8,21,88,109,48,22,19,36,51,15,385,337,276,157,378.27681660899657,77.8719723183391,32.68512110726643,13.197231833910033,706.598615916955,495.1384083044982,554.083044982699,146.21107266435988,10
462,Vince Williams Jr.,Memphis Grizzlies,G,127,336,42,92,459.70000000000005,30,38,723.3,13,34,328.8,8,54,62,61,30,12,34,9,-54,250,189,188,123,223.7,72.5,33.125,17.325,495.02500000000003,469.0,229.22500000000002,126.125,10
463,Vit Krejci,Atlanta Hawks,G,3,22,1,5,20.0,0,0,0.0,1,4,25.0,1,0,1,5,1,2,0,1,7,9,4,8,6,2.25,0.25,6.25,0.25,20.25,4.0,16.0,9.0,1
464,Walker Kessler,Utah Jazz,C,86,244,37,64,610.1,12,15,525.0,0,3,0.0,30,49,79,14,22,7,11,25,-47,179,165,100,93,162.57777777777778,73.44444444444444,8.8,0.0,374.1111111111111,347.84444444444443,183.11111111111111,87.97777777777777,10
465,Wendell Carter Jr.,Orlando Magic,C,126,263,47,80,590.7,19,27,465.0,13,29,365.1,24,48,72,15,22,4,14,7,16,213,198,141,87,270.8,58.825,4.6,8.125,389.12499999999994,369.625,279.0,74.72500000000001,10
466,Wendell Moore Jr.,Minnesota Timberwolves,G,2,5,1,1,100.0,0,0,0.0,0,0,0.0,0,2,2,0,1,0,0,0,8,4,4,2,2,0.44444444444444453,1.0,0.1111111111111111,0.0,1.7777777777777781,2.7777777777777772,0.11111111111111106,0.44444444444444453,1
467,Wenyen Gabriel,Memphis Grizzlies,F,2,13,1,3,33.3,0,2,0.0,0,0,0.0,2,2,4,2,2,1,1,0,6,8,6,4,6,0.0,0.0,0.0,0.0,0.0,0.0,0.0,0.0,1
468,Wesley Matthews,Atlanta Hawks,SG,14,38,5,9,233.3,0,1,0.0,4,7,240.0,0,7,7,1,3,1,0,2,-6,22,21,15,8,26.444444444444443,16.11111111111111,0.7777777777777779,2.4444444444444446,66.44444444444446,67.0,27.0,15.777777777777779,4
469,Xavier Tillman,Boston Celtics,F,28,100,11,20,262.5,5,8,150.0,1,4,50.0,6,12,18,7,8,5,0,3,-11,53,46,35,25,46.48979591836735,10.244897959183673,5.530612244897959,0.816326530612245,92.38775510204081,67.83673469387755,70.26530612244898,16.551020408163264,5
470,Yuta Watanabe,Memphis Grizzlies,SF,20,90,9,23,150.0,0,2,0.0,2,12,64.3,0,9,9,5,5,5,4,0,-31,34,29,25,14,114.74074074074076,11.0,3.2962962962962963,1.4074074074074074,136.74074074074073,132.40740740740742,114.40740740740739,18.962962962962965,6
471,Zach Collins,San Antonio Spurs,PF,106,192,43,87,495.5,10,20,336.7,10,17,583.4,17,32,49,26,23,3,15,8,-50,181,155,132,75,323.8271604938272,107.51234567901234,28.641975308641975,6.771604938271604,605.8086419753087,514.4012345679013,368.44444444444446,182.94444444444446,10
472,Zeke Nnaji,Denver Nuggets,PF,36,110,11,27,338.3,14,16,500.0,0,3,0.0,12,11,23,5,11,3,3,13,-13,64,59,41,28,92.57777777777778,4.111111111111111,5.044444444444444,0.0,132.57777777777778,117.0,105.0,12.311111111111112,10
473,Ziaire Williams,Memphis Grizzlies,F,86,223,32,76,319.0,13,16,421.4,9,36,163.7,5,29,34,14,11,9,11,0,-44,134,120,100,48,399.5,29.5,13.5,12.875,607.5,516.0,492.0,42.0,8
474,Zion Williamson,New Orleans Pelicans,PF,210,316,83,158,520.5,43,56,738.2,1,3,50.0,18,44,62,67,19,7,27,12,57,339,272,277,129,542.5,81.95679012345678,68.60493827160494,0.9197530864197531,762.7777777777777,682.1234567901234,619.4382716049382,154.2777777777778,10
