,First Last Name,team,position,points,minutes,fgm,fga,fgp,ftm,fta,ftp,tpm,tpa,tpp,offReb,defReb,totReb,assists,pFouls,steals,turnovers,blocks,plusMinus,Points_Rebounds_Assist,Points_Rebounds,Points_Assist,Rebounds_Assist,points_deviation,totReb_deviation,assists_deviation,tpm_deviation,Points_Rebounds_Assist_deviation,Points_Rebounds_deviation,Points_Assist_deviation,Rebounds_Assist_deviation,count
0,A. Flagler,Oklahoma City Thunder,F,0,6,0,3,0.0,0,0,0.0,0,3,0.0,0,0,0,1,0,0,0,0,0,1,0,1,1,0.0,0.0,0.0,0.0,0.0,0.0,0.0,0.0,1
1,A.J. Green,Milwaukee Bucks,G,60,142,19,43,431.5,7,8,266.7,15,35,389.3,2,14,16,6,8,2,4,0,3,82,76,66,22,259.7361111111111,16.489197530864196,9.11111111111111,24.23611111111111,365.9012345679012,374.2716049382716,251.06944444444446,25.896604938271604,10
2,A.J. Lawson,Dallas Mavericks,G,20,42,8,21,223.3,2,6,100.0,2,8,100.0,2,6,8,3,5,1,0,1,-5,31,28,23,11,35.26530612244898,8.244897959183673,2.074829931972789,1.6734693877551021,59.81632653061225,50.72108843537415,41.0,13.680272108843537,6
3,Aaron Gordon,Denver Nuggets,PF,129,315,53,98,627.5,20,31,496.7,3,15,108.3,25,37,62,42,20,4,12,4,24,233,191,171,104,258.71119524067063,132.8826392644673,57.61060032449973,2.100054083288264,498.763115197404,619.0421849648459,192.99891833423473,135.92644672796104,10
4,Aaron Holiday,Houston Rockets,G,62,146,21,51,372.7,12,12,400.0,8,25,295.0,2,10,12,21,15,7,2,1,51,95,74,83,33,204.00413223140495,9.607438016528926,33.06198347107438,10.319214876033058,345.1942148760331,279.1735537190083,270.35537190082647,42.33884297520661,10
5,Aaron Nesmith,Indiana Pacers,SF,118,302,38,91,420.8,23,24,775.0,19,47,407.9,7,26,33,17,38,5,5,12,70,168,151,135,50,135.64365548980933,19.982248520710055,13.0,10.963182117028271,224.42472057856676,204.50164365548983,150.02827087442472,38.520710059171606,10
6,Aaron Wiggins,Oklahoma City Thunder,SG,53,146,20,37,553.0,8,11,280.0,5,12,200.0,9,9,18,11,6,7,10,5,-23,82,71,64,29,108.46694214876034,8.202479338842975,8.900826446280991,7.822314049586776,119.33884297520662,130.8677685950413,106.58264462809917,7.458677685950413,10
7,Admiral Schofield,Orlando Magic,SF,5,11,2,4,66.7,0,0,0.0,1,2,100.0,0,2,2,0,1,1,0,0,-11,7,7,5,2,15.131487889273355,0.02768166089965399,0.006920415224913495,0.5847750865051903,15.408304498269898,15.698961937716263,14.868512110726641,0.006920415224913498,2
8,Al Horford,Boston Celtics,C,112,283,41,76,569.3,8,8,400.0,22,45,499.3,14,43,57,23,17,9,9,6,84,192,169,135,80,463.7890625,78.15625,22.212890625,33.712890625,559.712890625,525.3515625,506.509765625,92.009765625,10
9,Alec Burks,New York Knicks,SG,71,131,23,72,280.0,14,19,446.4,11,40,257.5,4,15,19,9,2,3,4,0,-14,99,90,80,28,295.4510546241211,19.353704705246077,3.272579772850189,9.217414818820982,494.5889670091941,445.44077879935094,334.8869659275284,32.33856138453218,10
10,Aleksej Pokusevski,Charlotte Hornets,F,50,154,18,43,382.9,9,10,366.7,5,16,266.6,9,22,31,18,9,10,8,6,-49,99,81,68,49,79.39886578449905,18.94328922495274,11.841209829867674,1.9035916824196597,190.5954631379962,134.11153119092626,119.07750472589791,47.5897920604915,8
11,Aleksej Pokusevski,Oklahoma City Thunder,F,4,13,1,3,50.0,1,2,50.0,1,2,100.0,0,1,1,0,0,1,0,0,-8,5,5,4,1,31.001890359168243,22.05103969754253,8.351606805293008,0.5085066162570888,164.4858223062382,101.58223062381855,67.07372400756144,57.234404536862,2
12,Alex Caruso,Chicago Bulls,SG,117,313,41,87,449.6,11,16,375.0,24,53,440.8,7,34,41,45,30,19,14,6,-24,203,158,162,86,340.67233560090705,31.379818594104307,23.458049886621314,25.06122448979592,580.6145124716554,423.6145124716553,493.3163265306123,59.193877551020414,10
13,Alex Len,Sacramento Kings,C,34,97,12,15,550.0,10,11,475.0,0,0,0.0,5,17,22,9,12,2,4,10,32,65,56,43,31,66.88625904010519,23.60026298487837,15.071005917159765,0.0,155.698224852071,116.86390532544378,99.33399079552926,45.05785667324129,10
14,Alondes Williams,Miami Heat,G,0,6,0,1,0.0,0,0,0.0,0,1,0.0,0,1,1,0,0,0,1,0,-2,1,1,0,1,0.0,0.25,0.0,0.0,0.25,0.25,0.0,0.25,1
15,Alperen Sengun,Houston Rockets,C,209,324,81,157,512.7,43,68,622.9,4,12,200.0,39,68,107,45,36,16,26,7,2,361,316,254,152,847.1723356009071,197.81632653061226,123.77551020408163,4.408163265306122,1935.0226757369614,1622.4580498866212,993.7777777777778,487.5510204081633,10
16,Amari Bailey,Charlotte Hornets,G,2,6,1,3,33.3,0,0,0.0,0,2,0.0,0,0,0,1,0,1,0,0,7,3,2,3,1,1.7777777777777781,0.0,0.3402777777777777,0.0,3.6736111111111116,1.7777777777777781,3.6736111111111116,0.3402777777777777,1
17,Amen Thompson,Houston Rockets,F,135,257,58,92,645.5,18,24,521.4,1,5,100.0,30,46,76,24,23,11,12,7,99,235,211,159,100,413.71604938271605,68.18271604938272,29.11111111111111,0.9012345679012346,670.5111111111111,657.8000000000001,380.9753086419753,142.74567901234568,10
18,Amir Coffey,LA Clippers,SG,66,238,25,57,402.0,3,3,200.0,13,34,316.7,4,27,31,17,16,3,7,3,-48,114,97,83,48,235.0603915035402,82.26780508121615,16.460224906289046,18.13036234902124,552.4006663890046,414.4918783840066,337.5880882965431,134.1091211995002,10
19,Andre Drummond,Chicago Bulls,C,74,155,26,49,461.4,22,35,629.2,0,0,0.0,29,52,81,4,12,2,8,4,1,159,155,78,85,257.6570247933885,62.71900826446283,2.4132231404958677,0.0,478.0371900826447,442.2024793388431,283.0123966942149,75.6115702479339,10
20,Andre Jr. Jackson,Milwaukee Bucks,G,10,69,4,9,333.3,0,0,0.0,2,5,200.0,3,9,12,10,6,3,3,0,-10,32,22,20,22,12.559999999999997,6.96,7.04,1.5733333333333335,36.00000000000001,31.040000000000003,16.959999999999997,14.56,6
21,Andrew Nembhard,Indiana Pacers,PG,93,286,39,74,496.2,6,7,200.0,9,28,348.3,4,21,25,34,27,6,11,1,36,152,118,127,59,230.400826446281,41.243801652892564,18.566115702479344,3.111570247933884,473.5578512396695,332.59504132231405,356.88429752066116,74.2892561983471,10
22,Andrew Wiggins,Golden State Warriors,SF,123,243,46,102,442.5,17,23,371.4,14,35,375.0,21,30,51,13,16,7,7,3,-6,187,174,136,64,330.6765819361817,66.19956733369389,9.028123309897241,13.030827474310437,609.065981611682,563.0048674959438,373.8377501352082,78.12763656030286,10
23,Anfernee Simons,Portland Trail Blazers,SG,234,361,80,177,436.7,36,39,757.1,38,94,405.4,4,33,37,64,19,7,30,1,-38,335,271,298,101,919.6961451247166,28.132653061224488,125.18934240362812,19.16213151927438,1741.6938775510203,1186.046485260771,1442.6224489795918,186.04308390022675,10
24,Anthony Black,Orlando Magic,G,50,193,17,48,368.8,7,12,250.0,9,21,308.3,6,23,29,9,11,6,9,3,25,88,79,59,38,136.98439125910508,64.95421436004162,5.0582726326742975,10.9105098855359,335.10509885535896,290.70655567117586,176.01977107180022,75.37565036420396,10
25,Anthony Davis,Los Angeles Lakers,PF,215,347,83,151,545.3,45,56,802.6,4,10,200.0,33,103,136,37,24,14,16,21,46,388,351,252,173,514.2215647600262,297.11111111111114,16.221564760026297,2.4760026298487836,1490.4247205785668,1319.2130177514791,599.7751479289941,398.99079552925707,10
26,Anthony Edwards,Minnesota Timberwolves,SG,270,377,105,228,453.2,37,51,729.8,23,66,407.3,11,63,74,57,17,13,27,10,8,401,344,327,131,849.5604938271604,61.827160493827165,36.11111111111111,22.382716049382715,878.1111111111111,912.0,817.0197530864198,96.59012345679014,10
27,Anthony Gill,Washington Wizards,PF,38,91,14,31,284.4,6,6,200.0,4,11,191.7,8,11,19,10,9,5,8,0,-12,67,57,48,29,189.37370242214533,43.680795847750865,15.377162629757784,3.964532871972319,486.4351211072664,381.90916955017303,268.31487889273353,84.64273356401385,7
28,Ashton Hagans,Portland Trail Blazers,G,50,198,18,45,352.7,9,11,400.0,5,14,166.7,11,22,33,37,27,8,22,8,11,120,83,87,70,142.02499999999998,15.325,46.125,6.525,349.625,222.5,260.2,70.39999999999999,10
29,Ausar Thompson,Detroit Pistons,F,103,314,42,87,508.0,11,25,325.0,8,29,195.3,15,44,59,21,26,17,14,11,-6,183,162,124,80,121.7,31.399999999999995,24.125,8.5,347.72499999999997,237.7,200.02499999999998,87.225,10
30,Austin Reaves,Los Angeles Lakers,SG,180,344,60,120,503.1,31,37,766.7,29,63,437.6,5,44,49,60,14,4,24,3,21,289,229,240,109,271.4729327781082,21.024985127900056,99.14693634741224,34.29803688280786,468.24092801903635,323.96609161213564,454.5758477096966,81.3438429506246,10
31,Ayo Dosunmu,Chicago Bulls,SG,181,374,71,141,479.7,18,20,550.0,21,53,371.6,8,23,31,51,27,10,18,6,-60,263,212,232,82,893.2076446280992,35.45867768595041,63.376033057851245,22.5,961.8440082644629,789.0960743801653,1069.1869834710744,95.60330578512396,10
32,Bam Adebayo,Miami Heat,C,159,329,66,124,531.9,21,38,583.3,6,10,450.0,29,91,120,30,14,16,14,10,-22,309,279,189,150,240.9119000657463,112.62984878369494,24.946745562130175,4.476002629848784,432.71597633136093,395.0,265.7836949375411,150.42077580539117,10
33,Ben Sheppard,Indiana Pacers,G,51,185,19,46,422.1,6,6,300.0,7,30,253.3,2,17,19,11,18,5,3,0,32,81,70,62,30,92.29803688280785,25.48304580606782,12.921475312314099,4.85960737656157,156.4039262343843,141.16597263533612,123.55978584176086,22.380725758477098,10
34,Ben Simmons,Brooklyn Nets,PG,53,168,24,38,521.1,5,11,150.0,0,0,0.0,15,39,54,46,20,9,12,4,-5,153,107,99,100,134.88888888888889,64.0,78.88888888888889,0.0,382.0,162.8888888888889,300.0,196.88888888888889,9
35,Bennedict Mathurin,Indiana Pacers,SG,139,275,44,115,340.3,35,45,614.5,16,44,245.0,10,33,43,23,24,7,17,4,-18,205,182,162,66,753.4765625,123.6015625,38.125,30.4140625,1418.90625,1097.65625,970.9140625,265.5390625,10
36,Bilal Coulibaly,Washington Wizards,SG,90,289,30,76,451.5,19,27,633.3,11,39,238.3,9,30,39,18,22,12,8,7,-98,147,129,108,57,127.37777777777777,38.5,16.0,13.177777777777775,337.8777777777778,291.7444444444444,166.31111111111107,61.699999999999996,10
37,Bismack Biyombo,Oklahoma City Thunder,C,4,36,1,4,33.3,2,4,100.0,0,0,0.0,3,2,5,2,6,1,4,1,3,11,9,6,7,5.061224489795919,4.1020408163265305,1.2653061224489797,0.0,27.97959183673469,17.489795918367346,11.387755102040815,9.53061224489796,5
38,Blake Wesley,San Antonio Spurs,G,54,154,20,45,399.0,10,12,425.0,4,10,250.0,4,16,20,26,13,6,6,5,-11,100,74,80,46,168.70123456790122,20.9679012345679,62.99753086419753,4.577777777777778,345.5111111111111,175.33827160493826,299.3530864197531,123.48641975308642,10
39,Boban Marjanovic,Houston Rockets,C,3,7,1,1,100.0,1,2,50.0,0,0,0.0,0,3,3,0,0,0,1,0,-3,6,6,3,3,0.8622448979591834,5.224489795918367,0.0,0.0,10.331632653061225,10.331632653061225,0.8622448979591834,5.224489795918367,1
40,Bobby Portis,Milwaukee Bucks,F,166,261,71,131,533.3,12,15,525.0,12,26,333.4,16,70,86,11,24,8,16,2,9,263,252,177,97,616.4183884297521,145.19421487603304,5.855371900826446,24.24793388429752,1107.6373966942149,1121.4597107438017,605.5382231404959,148.10743801652893,10
41,Bogdan Bogdanovic,Atlanta Hawks,SG,155,327,55,132,403.9,13,16,416.7,32,78,424.6,9,25,34,44,20,11,19,4,56,233,189,199,78,391.48566792861004,39.15305570578691,57.10113574905354,23.71444023796647,405.46403461330453,354.9156300703082,439.7268793942672,98.56138453217956,10
42,Bojan Bogdanovic,New York Knicks,SF,72,177,26,75,318.5,8,10,300.0,12,39,268.3,3,11,14,8,13,0,18,0,-10,94,86,80,22,350.81632653061223,20.594104308390023,8.444444444444445,14.36281179138322,446.9478458049886,436.3764172335602,352.8798185941043,37.54648526077097,10
43,Bol Bol,Phoenix Suns,C,67,116,26,39,553.8,6,7,275.0,9,16,450.0,5,29,34,3,7,1,4,6,-10,104,101,70,37,248.13477975016437,32.40105193951347,4.3609467455621305,6.963182117028271,410.5272846811308,400.92373438527284,258.1051939513478,36.39513477975016,10
44,Bones Hyland,LA Clippers,PG,65,161,24,62,368.1,4,6,200.0,13,36,313.8,1,16,17,31,15,10,14,1,0,113,82,96,48,304.5,16.62629757785467,86.94982698961937,19.844290657439448,827.0,445.30276816609,619.273356401384,170.5,10
45,Bradley Beal,Phoenix Suns,SG,160,340,65,126,506.0,16,18,558.3,14,39,330.2,8,29,37,69,20,12,23,6,24,266,197,229,106,442.85663295657343,34.55145746579417,52.99048185603807,6.586555621653778,259.1980963712076,362.3063652587745,365.2903033908388,62.0,10
46,Brandin Podziemski,Golden State Warriors,G,79,276,28,67,391.1,9,13,375.0,14,31,433.3,18,36,54,35,13,10,12,4,17,168,133,114,89,188.90170132325142,56.74952741020794,38.20604914933837,11.248582230623818,479.35822306238185,380.5,264.21550094517954,118.5,10
47,Brandon Boston Jr.,LA Clippers,SG,59,135,24,55,462.1,7,14,350.0,4,15,150.0,5,14,19,3,15,3,4,6,-17,81,78,62,22,131.68512110726644,27.28373702422145,2.252595155709342,4.458477508650519,244.19723183391005,208.15224913494808,153.92387543252593,43.34256055363323,10
48,Brandon Ingram,New Orleans Pelicans,SF,180,306,68,138,496.2,36,43,724.5,8,27,260.0,6,50,56,54,24,6,19,7,49,290,236,234,110,670.2437673130194,25.364265927977836,44.40443213296399,6.5318559556786715,720.3393351800554,826.6662049861496,558.8476454293628,74.83795013850416,10
49,Brandon Miller,Charlotte Hornets,F,169,322,63,156,401.6,19,26,505.0,24,74,302.1,6,43,49,25,23,9,17,5,-106,243,218,194,74,318.08268887566925,43.49851279000595,42.83462224866152,12.440214158239144,639.3164782867341,571.8750743604998,378.6591314693635,93.19809637120763,10
50,Brandon Williams,Dallas Mavericks,G,7,24,2,9,83.3,3,4,100.0,0,2,0.0,1,1,2,4,1,0,1,0,-12,13,9,11,6,18.22448979591837,3.183673469387756,4.081632653061224,0.0,30.46938775510204,15.448979591836734,29.0,11.510204081632653,4
51,Braxton Key,Denver Nuggets,F,2,6,1,1,100.0,0,1,0.0,0,0,0.0,1,1,2,0,1,0,0,0,2,4,4,2,2,1.0,0.6400000000000001,0.04000000000000001,0.04000000000000001,2.5600000000000005,3.2399999999999993,0.6400000000000001,0.3600000000000001,1
52,Brice Sensabaugh,Utah Jazz,F,84,238,32,83,360.5,14,17,396.7,6,40,153.3,8,43,51,26,11,5,20,2,-47,161,135,110,77,367.30000000000007,101.70625,19.3,6.456250000000001,552.70625,552.25625,380.0,108.75625,10
53,Brook Lopez,Milwaukee Bucks,C,108,275,38,77,478.3,11,15,416.7,21,44,490.0,13,34,47,19,20,4,9,12,-10,174,155,127,66,200.44854253420584,29.316478286734085,29.392623438429506,16.220701963117193,350.98750743604995,266.6371207614515,267.8506841165972,75.65734681737062,10
54,Bruce Brown,Toronto Raptors,SF,103,277,39,86,438.0,20,25,583.3,5,16,250.0,11,33,44,36,17,6,19,1,-94,183,147,139,80,129.7655222790358,83.56026296566837,26.41051862673484,4.501826150474798,308.154127100073,221.51424397370346,210.8407596785975,115.53542731921111,10
55,Bruno Fernando,Atlanta Hawks,PF,75,204,32,52,550.9,11,16,400.0,0,1,0.0,20,49,69,13,30,12,18,9,-5,157,144,88,82,437.0,65.125,10.606250000000001,0.0,485.15625,448.62499999999994,474.85625000000005,74.40625,10
56,Bryce McGowens,Charlotte Hornets,G,54,155,18,37,330.8,13,18,441.7,5,15,180.0,3,21,24,8,15,7,4,3,-10,86,78,62,32,234.89965397923876,29.079584775086506,5.6055363321799305,6.923875432525952,399.55017301038066,387.09342560553637,250.0,32.04152249134948,10
57,Buddy Boeheim,Detroit Pistons,F,19,40,6,14,83.3,2,2,100.0,5,13,76.19999999999999,0,6,6,3,3,0,0,1,12,28,25,22,9,63.380165289256205,6.611570247933884,6.322314049586777,4.47107438016529,153.15702479338842,102.0578512396694,107.53719008264461,19.876033057851238,2
58,Buddy Hield,Philadelphia 76ers,SG,96,223,36,88,410.1,5,5,300.0,19,59,343.4,7,21,28,20,15,5,9,5,-23,144,124,116,48,112.5,44.76736111111111,15.90625,13.61111111111111,286.40277777777777,215.51736111111111,159.65625,84.40277777777777,10
59,CJ McCollum,New Orleans Pelicans,SG,177,315,69,145,457.7,7,9,241.7,32,82,360.3,2,32,34,43,13,5,19,2,43,254,211,220,77,587.4555785123968,21.194214876033058,54.15289256198347,46.03719008264463,905.2530991735537,569.1745867768595,940.3440082644628,58.53719008264463,10
60,Cade Cunningham,Detroit Pistons,PG,204,308,77,188,402.8,32,35,722.2,18,58,269.6,9,42,51,84,18,7,32,2,-62,339,255,288,135,575.6349480968859,35.06747404844291,26.77681660899654,20.685121107266436,981.863321799308,767.7750865051902,760.0207612456747,91.54671280276817,10
61,Caleb Houstan,Orlando Magic,G,47,172,15,40,329.4,2,2,100.0,15,38,362.7,6,11,17,3,14,3,3,2,-12,67,64,50,20,149.40625,32.400390625,2.40625,17.6640625,284.150390625,266.978515625,154.0,47.384765625,10
62,Caleb Martin,Miami Heat,SF,96,286,35,94,352.2,12,15,541.7,14,48,337.9,13,32,45,18,20,9,12,5,-27,159,141,114,63,228.4424012979989,46.89075175770687,29.610600324499732,10.607896160086533,533.0,345.0757166035695,376.49540292049755,116.37263385613845,10
63,Cam Reddish,Los Angeles Lakers,SF,30,125,9,24,213.3,6,12,141.7,6,16,216.6,4,5,9,1,7,5,2,4,10,40,39,31,10,81.5486111111111,9.4375,0.8819444444444443,3.381944444444444,65.21527777777777,56.44444444444445,92.86111111111111,7.777777777777779,7
64,Cam Thomas,Brooklyn Nets,SG,231,344,83,184,445.4,44,51,827.4,21,62,309.7,7,43,50,37,20,5,21,0,-19,318,281,268,87,298.9552925706772,54.1301775147929,22.221564760026297,31.68113083497699,283.7751479289941,277.77186061801444,299.94082840236683,81.36949375410914,10
65,Cam Whitmore,Houston Rockets,F,126,203,48,111,415.2,17,26,385.0,13,50,239.8,14,31,45,5,11,5,15,5,3,176,171,131,50,215.05817174515238,60.56232686980609,2.673130193905817,12.290858725761774,347.16343490304706,345.24376731301936,225.77008310249312,54.44321329639889,10
66,Cameron Johnson,Brooklyn Nets,SF,155,278,49,102,478.1,27,32,791.7,30,67,441.3,7,31,38,21,14,10,13,1,-6,214,193,176,59,438.37326515704893,44.94521548575602,15.10518626734843,29.869978086194305,601.2505478451424,475.08911614317026,546.4777209642075,78.1073776479182,10
67,Cameron Payne,Philadelphia 76ers,PG,103,196,39,93,427.9,8,9,275.0,17,45,363.3,3,12,15,33,18,5,16,4,-28,151,118,136,48,280.0132325141777,20.5,21.7703213610586,20.100189035916824,416.6219281663516,385.51323251417773,302.1219281663516,51.270321361058606,10
68,Caris LeVert,Cleveland Cavaliers,SG,125,324,44,115,355.9,25,35,450.2,12,48,226.6,8,42,50,79,20,17,21,7,16,254,175,204,129,527.2438016528926,26.74380165289256,96.38946280991735,7.674586776859504,1025.8894628099174,636.5,856.5919421487603,183.17458677685948,10
69,Cason Wallace,Oklahoma City Thunder,G,74,215,29,66,419.4,2,4,100.0,14,37,324.3,10,15,25,16,16,14,10,6,-23,115,99,90,41,343.88946280991735,14.582644628099173,22.509297520661157,18.698347107438014,459.4752066115703,389.125,418.0495867768595,33.28202479338843,10
70,Cedi Osman,San Antonio Spurs,SF,48,148,19,42,397.1,1,2,50.0,9,26,249.89999999999998,3,20,23,8,14,5,3,2,-44,79,71,56,31,120.63988312636961,20.468224981738494,9.89919649379109,7.137326515704894,125.73484295105916,142.19211102994888,113.64645726807889,20.903579254930605,10
71,Charlie Brown Jr.,New York Knicks,G,3,27,1,5,20.0,0,0,0.0,1,3,33.3,1,1,2,0,4,0,0,1,-6,5,5,3,2,6.12,2.7200000000000006,0.0,0.6800000000000002,17.0,17.0,6.12,2.7200000000000006,2
72,Chet Holmgren,Oklahoma City Thunder,PF,158,294,58,118,486.8,28,32,563.3,14,45,320.0,17,73,90,19,12,6,8,14,77,267,248,177,109,750.082644628099,150.6487603305785,18.910123966942148,9.327479338842975,1542.3729338842975,1461.9710743801652,790.0506198347108,209.99276859504133,10
73,Chimezie Metu,Detroit Pistons,PF,33,97,12,23,208.3,9,10,187.5,0,7,0.0,3,14,17,10,14,5,6,2,-19,60,50,43,27,161.48442906574397,23.56055363321799,9.737024221453286,0.0,340.76124567474045,285.9446366782007,208.00346020761248,41.59515570934257,4
74,Chimezie Metu,Phoenix Suns,PF,6,29,3,5,150.0,0,0,0.0,0,0,0.0,2,9,11,2,2,2,3,0,-7,19,17,8,13,36.06920415224913,18.86159169550173,2.3321799307958484,0.0,82.45328719723183,58.25259515570934,56.076124567474054,25.387543252595155,3
75,Chris Boucher,Toronto Raptors,PF,69,120,25,35,573.3,15,18,500.0,4,12,216.7,13,27,40,5,11,1,9,5,7,114,109,74,45,142.20987654320987,47.580246913580254,5.913580246913581,4.0246913580246915,410.0,329.0246913580247,192.69135802469134,83.98765432098766,8
76,Chris Duarte,Sacramento Kings,SG,72,143,26,54,474.2,5,6,250.0,15,35,447.7,7,19,26,8,11,5,2,4,-10,106,98,80,34,277.73611111111114,37.3641975308642,7.604938271604939,13.271604938271604,466.06944444444446,408.304012345679,314.8595679012346,65.6111111111111,10
77,Chris Livingston,Milwaukee Bucks,F,0,6,0,2,0.0,0,0,0.0,0,2,0.0,0,1,1,1,4,0,1,0,-10,2,1,1,2,0.4444444444444444,0.25,0.6944444444444445,0.0,0.44444444444444453,0.027777777777777804,0.027777777777777766,1.7777777777777781,1
78,Chris Paul,Golden State Warriors,PG,112,245,48,95,513.9,2,2,100.0,14,32,430.0,7,40,47,67,22,8,9,0,-16,226,159,179,114,147.625,32.15625,98.962890625,4.447265625,359.103515625,269.65625,254.431640625,113.759765625,10
79,Christian Braun,Denver Nuggets,G,95,205,38,60,653.1,8,14,275.0,11,21,516.6,9,30,39,19,24,6,7,3,24,153,134,114,58,312.53719008264466,39.37603305785124,30.15702479338843,7.97107438016529,669.0123966942148,465.4256198347107,474.77685950413223,110.88016528925621,10
80,Christian Wood,Los Angeles Lakers,F,59,133,22,51,477.0,11,14,450.0,4,19,225.0,6,28,34,6,12,5,5,2,-14,99,93,65,40,153.90277777777777,54.402777777777786,4.625,2.4444444444444446,305.125,285.0,156.7777777777778,76.27777777777777,10
81,Chuma Okeke,Orlando Magic,PF,0,33,0,4,0.0,0,0,0.0,0,4,0.0,0,4,4,2,2,2,2,0,-14,6,4,2,6,0.4253472222222223,2.953125,1.3836805555555554,0.008680555555555556,4.828125,2.868055555555556,1.25,5.472222222222221,5
82,Clint Capela,Atlanta Hawks,C,128,257,56,101,560.2,16,27,430.0,0,1,0.0,52,65,117,20,20,4,9,12,65,265,245,148,137,84.80428316478287,46.408685306365264,19.005353955978585,0.0,211.60440214158234,192.1695419393218,91.1921475312314,78.46103509815586,10
83,Coby White,Chicago Bulls,PG,196,366,68,155,431.0,34,37,796.7,26,69,359.0,4,38,42,48,24,6,21,3,-19,286,238,244,90,547.3444444444444,14.81111111111111,74.54444444444445,34.577777777777776,813.6111111111112,616.3111111111111,696.4000000000001,137.60000000000002,10
84,Cody Martin,Charlotte Hornets,SF,69,285,28,76,367.2,6,7,250.0,7,30,228.2,6,44,50,42,15,11,20,7,-28,161,119,111,92,111.0,28.18685121107267,64.68512110726644,2.6816608996539792,183.02076124567472,112.9515570934256,173.33217993079583,100.60899653979239,10
85,Cody Zeller,New Orleans Pelicans,C,7,31,3,6,200.0,1,2,50.0,0,0,0.0,5,10,15,3,5,2,3,0,14,25,22,10,18,3.2011834319526624,5.065088757396451,3.4319526627218937,0.0,18.396449704142015,12.337278106508876,6.266272189349112,11.49112426035503,5
86,Colby Jones,Sacramento Kings,G,4,20,2,7,83.3,0,0,0.0,0,2,0.0,1,4,5,3,3,0,1,0,4,12,9,7,8,4.75,4.749999999999999,0.5208333333333333,0.0,21.02083333333333,16.333333333333336,7.354166666666668,7.354166666666665,3
87,Cole Anthony,Orlando Magic,PG,116,232,43,96,434.6,18,24,587.5,12,41,247.0,10,30,40,25,15,6,11,6,50,181,156,141,65,263.625,48.625,34.525000000000006,11.606250000000001,463.92499999999995,410.0,323.29999999999995,77.4,10
88,Cole Swider,Miami Heat,F,19,44,6,16,104.7,2,2,100.0,5,13,116.7,0,5,5,1,1,0,4,0,-18,25,24,20,6,191.6172839506173,2.5555555555555554,0.8395061728395061,17.0,227.20987654320987,233.20987654320987,185.9135802469136,3.0987654320987654,5
89,Collin Gillespie,Denver Nuggets,G,45,104,17,35,277.8,2,5,100.0,9,18,250.0,0,14,14,15,10,6,9,0,26,74,59,60,29,177.66666666666666,7.407407407407407,33.74074074074073,11.518518518518517,253.1851851851852,180.85185185185185,231.18518518518516,59.96296296296297,6
90,Collin Sexton,Utah Jazz,PG,213,330,85,164,520.3,23,27,796.6,20,48,349.6,12,20,32,60,18,8,23,1,-71,305,245,273,92,54.49999999999999,34.624,44.196,32.25600000000001,171.944,107.204,112.13600000000001,85.924,10
91,Corey Kispert,Washington Wizards,SF,156,326,55,110,490.1,16,27,483.3,30,67,433.1,6,29,35,20,19,9,11,3,-23,211,191,176,55,286.0390625,98.94444444444444,24.277777777777782,23.73611111111111,625.1085069444443,495.48350694444446,369.4418402777777,169.44444444444443,10
92,Cory Joseph,Golden State Warriors,PG,27,71,10,16,316.7,0,0,0.0,7,11,316.7,2,9,11,6,6,0,1,0,9,44,38,33,17,31.2,10.8,2.8000000000000003,3.2,28.8,47.2,21.2,5.2,5
93,Craig Jr. Porter,Cleveland Cavaliers,G,68,141,28,53,475.3,7,8,400.0,5,12,175.0,6,20,26,23,7,3,9,2,-22,117,94,91,49,347.56711758584805,40.71800208116546,26.294484911550473,9.647242455775235,698.0613943808531,553.4068678459937,478.02601456815825,81.20811654526536,10
94,D'Angelo Russell,Los Angeles Lakers,PG,202,356,72,155,434.7,20,24,760.0,38,86,413.8,6,33,39,61,21,10,21,4,40,302,241,263,100,1063.7340720221607,30.106648199445985,126.98891966759001,51.61357340720222,1776.3504155124654,1339.4362880886426,1509.2603878116345,148.48337950138503,10
95,D.J. Carton,Toronto Raptors,G,8,31,2,7,83.3,3,4,150.0,1,4,50.0,2,1,3,3,1,1,1,0,-30,14,11,11,6,8.666666666666668,2.0,2.0,0.6666666666666667,8.666666666666666,2.6666666666666665,18.666666666666668,0.0,3
96,D.J. Wilson,Philadelphia 76ers,F,10,14,4,6,66.7,0,0,0.0,2,2,100.0,1,1,2,2,1,0,0,2,4,14,12,12,4,44.444444444444436,1.7777777777777781,1.7777777777777781,1.7777777777777781,87.11111111111109,64.0,64.0,7.1111111111111125,1
97,Daishen Nix,Minnesota Timberwolves,SG,5,5,2,3,66.7,0,0,0.0,1,2,50.0,0,0,0,0,1,1,0,0,6,5,5,5,0,9.0,0.0,0.08163265306122448,0.32653061224489793,7.367346938775511,9.0,7.367346938775511,0.08163265306122448,1
98,Dalano Banton,Portland Trail Blazers,G,171,324,62,145,432.5,24,26,941.7,23,62,402.2,9,38,47,32,18,10,25,6,-102,250,218,203,79,577.656899810964,73.36200378071834,41.52835538752363,17.494328922495274,1200.9310018903593,960.0831758034027,783.8204158790169,149.57466918714556,10
99,Dalen Terry,Chicago Bulls,F,41,132,17,35,341.1,3,6,150.0,4,14,208.3,8,15,23,16,7,7,4,1,-8,80,64,57,39,118.21402483564646,48.272461650840036,23.596785975164355,2.4353542731921114,366.57268078889706,247.3235938641344,182.5938641344047,126.73849525200876,10
100,Damian Jones,Cleveland Cavaliers,C,61,129,24,38,627.9,13,15,650.0,0,5,0.0,14,23,37,6,13,4,7,7,-25,104,98,67,43,159.53061224489798,63.44444444444444,4.403628117913832,0.0,267.90022675736964,267.546485260771,156.42403628117913,71.30839002267574,10
101,Damian Lillard,Milwaukee Bucks,PG,252,359,84,179,452.2,45,47,969.0,39,89,422.3,3,39,42,85,16,7,22,4,26,379,294,337,127,970.8798185941043,25.602040816326532,112.52267573696145,34.90362811791383,1284.9591836734694,1011.3526077097506,1234.5,148.11111111111111,10
102,Daniel Gafford,Dallas Mavericks,C,152,243,66,76,877.8000000000001,20,31,523.4,0,0,0.0,26,58,84,20,32,9,7,25,71,256,236,172,104,251.01243915630067,72.40021633315305,28.540832882639265,0.0,495.04705246078964,391.98269334775557,340.0551649540292,114.96268253109788,10
103,Daniel Theis,LA Clippers,C,44,135,19,38,427.5,3,3,200.0,3,8,200.0,11,21,32,12,18,1,7,9,14,88,76,56,44,136.31151974040023,26.561384532179556,9.89616008653326,4.2406706327744725,230.90535424553812,202.03136830719308,162.11249323958896,39.53055705786912,10
104,Danilo Gallinari,Milwaukee Bucks,PF,28,105,9,23,350.0,9,10,275.0,1,11,100.0,3,6,9,9,7,2,3,1,-43,46,37,37,18,84.784,5.096,12.904000000000002,1.384,101.456,101.496,83.0,19.744,10
105,Dante Exum,Dallas Mavericks,G,64,194,21,43,489.1,13,14,466.7,9,15,400.0,2,19,21,30,16,2,11,0,45,115,85,94,51,245.26742976066598,16.423517169614982,28.341311134235173,15.287200832466182,311.6472424557752,254.7107180020812,292.426638917794,54.54214360041624,10
106,Danuel House Jr.,Philadelphia 76ers,SF,42,143,14,30,276.3,13,15,466.7,1,11,33.3,6,11,17,7,16,7,3,3,-26,66,59,49,24,42.0,11.714285714285715,8.0,0.8571428571428572,41.714285714285715,51.714285714285715,40.0,11.714285714285715,7
107,Dario Saric,Golden State Warriors,PF,28,107,12,33,298.3,2,3,100.0,2,17,83.3,6,15,21,18,5,0,13,0,-31,67,49,46,39,52.0,27.193877551020407,15.673469387755102,2.1224489795918364,146.1326530612245,98.90816326530613,72.53061224489795,69.56122448979592,10
108,Darius Garland,Cleveland Cavaliers,PG,193,341,72,159,453.4,21,26,760.7,28,79,327.8,9,25,34,66,25,8,28,1,-2,293,227,259,100,693.3656030286642,34.830719307733915,70.41752298539751,52.30286641427799,1029.8263926446728,749.3926446727961,940.1865873445105,138.86100594916172,10
109,David Roddy,Phoenix Suns,F,61,140,25,62,497.0,6,10,241.7,5,21,143.3,3,17,20,13,7,2,10,0,-71,94,81,74,33,420.1570247933885,56.91827364554637,24.42148760330578,9.016528925619836,845.9155188246096,660.5573921028466,576.595041322314,110.25987144168961,10
110,Davion Mitchell,Sacramento Kings,PG,59,165,24,49,416.7,3,4,75.0,8,25,285.0,5,10,15,15,8,3,7,0,32,89,74,74,30,273.6015625,6.712673611111111,14.51736111111111,9.90625,310.23611111111114,306.8506944444444,264.10850694444446,34.10850694444444,10
111,Davis Bertans,Charlotte Hornets,SF,73,240,24,78,279.1,7,8,250.0,18,61,278.3,5,20,25,14,14,10,8,3,-84,112,98,87,39,272.9155188246097,59.61157024793389,20.146923783287416,15.976124885215794,550.7033976124885,442.7750229568411,353.15794306703395,107.44444444444443,10
112,Day'Ron Sharpe,Brooklyn Nets,C,58,144,24,44,590.8,10,19,341.6,0,1,0.0,26,26,52,17,19,3,11,8,-16,127,110,75,69,132.39239001189063,188.33293697978598,12.186682520808562,0.1070154577883472,431.5350772889417,372.98216409036866,155.48513674197383,235.97978596908445,10
113,De'Aaron Fox,Sacramento Kings,PG,243,353,90,210,439.59999999999997,36,42,777.2,27,80,356.7,13,50,63,56,30,25,24,5,74,362,306,299,119,234.9234404536862,36.35727788279773,73.6937618147448,16.148393194706994,255.62287334593572,250.26559546313797,280.3109640831758,70.02079395085066,10
114,De'Andre Hunter,Atlanta Hawks,SF,164,302,58,135,426.1,25,29,698.3,23,65,348.5,4,25,29,20,23,7,13,3,23,213,193,184,49,383.38775510204084,41.68934240362812,7.45124716553288,20.427437641723355,503.3083900226758,526.1111111111111,354.44444444444446,55.28117913832199,10
115,De'Anthony Melton,Philadelphia 76ers,SG,23,43,7,20,75.0,4,4,200.0,5,14,75.0,0,5,5,5,3,2,1,1,-2,33,28,28,10,128.66666666666666,2.666666666666667,2.666666666666667,8.666666666666666,206.0,164.66666666666669,164.66666666666669,10.666666666666668,3
116,DeAndre Jordan,Denver Nuggets,C,34,103,15,28,607.1,4,4,200.0,0,0,0.0,15,28,43,5,13,1,2,5,-11,82,77,39,48,99.43827160493828,75.43827160493827,8.777777777777779,0.0,315.679012345679,230.7530864197531,153.29012345679013,115.29012345679011,10
117,DeJon Jarreau,Memphis Grizzlies,F,35,140,13,46,208.3,5,11,250.0,4,13,141.7,8,35,43,25,13,6,9,1,-32,103,78,60,68,64.81065088757396,64.58579881656804,39.27810650887574,4.011834319526627,303.7396449704142,144.03550295857988,154.6508875739645,173.72781065088756,8
118,DeMar DeRozan,Chicago Bulls,SF,249,362,81,165,477.8,79,93,864.0,8,30,181.7,4,47,51,52,14,11,19,7,7,352,300,301,103,933.1415289256199,66.77789256198346,67.60743801652893,9.607438016528926,1516.3305785123969,1371.8388429752067,1034.3729338842977,177.6456611570248,10
119,Dean Wade,Cleveland Cavaliers,PF,46,178,15,35,260.2,5,7,216.7,11,31,233.4,4,27,31,7,8,3,1,9,-23,84,77,53,38,468.50000000000006,35.125,6.125,31.525000000000006,718.8,714.725,466.12499999999994,47.699999999999996,10
120,Deandre Ayton,Portland Trail Blazers,C,229,346,105,167,627.8,18,22,450.0,1,3,100.0,39,97,136,14,15,7,22,9,-35,379,365,243,150,638.5704894083273,219.7589481373265,6.410518626734843,0.9006574141709277,1419.390065741417,1479.582907231556,602.2505478451425,202.29656683710735,10
121,Dejounte Murray,Atlanta Hawks,SG,265,379,98,216,458.4,29,38,720.3,40,101,387.3,8,40,48,95,16,25,33,1,24,408,313,360,143,832.9462809917356,66.59504132231406,100.125,47.289256198347104,788.823347107438,1049.607438016529,584.707644628099,154.1745867768595,10
122,Delon Wright,Miami Heat,SG,48,181,17,45,414.7,9,12,283.3,5,18,175.0,5,15,20,23,5,10,1,2,14,91,68,71,43,132.58769513314968,8.918273645546371,34.72268135904499,7.016528925619834,234.49127640036733,168.92561983471074,199.0495867768595,42.74471992653811,10
123,Deni Avdija,Washington Wizards,SF,172,350,67,136,502.0,25,38,683.7,13,38,314.2,20,77,97,35,25,9,21,3,-47,304,269,207,132,114.9140625,131.125,24.978515625,12.634765625,364.962890625,285.7265625,177.306640625,172.947265625,10
124,Dennis Schroder,Brooklyn Nets,PG,150,353,56,130,417.1,18,21,491.7,20,55,360.9,5,26,31,62,16,8,33,4,-82,243,181,212,93,506.6911157024794,40.90082644628099,41.625,14.625,593.9752066115702,468.0092975206611,648.9752066115703,66.20764462809917,10
125,Dennis Smith Jr.,Brooklyn Nets,PG,62,171,23,48,512.1,8,11,383.3,8,22,348.3,5,13,18,29,22,17,13,0,6,109,80,91,47,81.37603305785125,19.057851239669418,36.64876033057851,4.037190082644629,138.96694214876032,124.5,89.0495867768595,62.5,10
126,Dereck II Lively,Dallas Mavericks,C,84,183,41,54,685.7,2,7,100.0,0,0,0.0,17,33,50,6,24,3,8,8,-12,140,134,90,56,390.10493827160496,77.73611111111111,8.444444444444445,0.0,794.5262345679013,703.1558641975308,474.91975308641975,92.73611111111111,10
127,Derrick Jones Jr.,Dallas Mavericks,SF,71,190,27,47,609.1,13,19,483.4,4,16,140.0,10,11,21,8,13,6,6,3,40,100,92,79,29,134.90005948839976,60.566924449732305,5.619274241522903,6.440214158239144,270.87685901249256,247.2242712671029,154.9214753123141,69.81737061273051,10
128,Derrick Rose,Memphis Grizzlies,PG,49,95,20,37,377.7,5,6,266.7,4,8,233.3,0,15,15,21,3,1,9,0,-9,85,64,70,36,70.0,14.857142857142858,12.0,3.7142857142857144,188.85714285714286,116.85714285714286,128.0,40.857142857142854,7
129,Derrick White,Boston Celtics,PG,149,357,54,130,407.0,16,18,555.6,25,75,244.9,10,52,62,70,21,9,14,17,79,281,211,219,132,491.284023668639,43.11111111111112,57.11111111111111,61.2629848783695,690.207100591716,569.7284681130835,571.9848783694937,140.0,10
130,Desmond Bane,Memphis Grizzlies,SG,67,125,22,63,136.3,13,15,266.7,10,31,128.5,2,10,12,18,9,4,9,2,-47,97,79,85,30,199.515625,8.0,9.5625,3.0625,325.390625,279.515625,245.390625,17.5625,4
131,Devin Booker,Phoenix Suns,SG,269,360,102,207,491.7,41,45,896.4,24,71,315.9,15,42,57,65,34,6,23,7,28,391,326,334,122,337.4830458060678,50.23140987507436,88.62046400951814,40.64366448542534,297.0701963117192,387.66805472932776,197.6335514574658,188.10350981558597,10
132,Devin Vassell,San Antonio Spurs,SG,191,368,75,158,443.2,22,25,791.7,19,55,309.4,2,38,40,46,14,12,17,3,-43,277,231,237,86,753.8388429752066,40.18595041322314,66.5,24.90082644628099,1119.7396694214876,846.603305785124,1013.2479338842975,120.41322314049587,10
133,Devonte' Graham,San Antonio Spurs,PG,17,36,6,14,158.3,1,1,100.0,4,11,170.0,0,9,9,2,2,2,1,0,18,28,26,19,11,51.358024691358025,1.432098765432099,3.555555555555556,2.8888888888888893,73.55555555555556,60.22222222222222,64.83950617283949,4.839506172839506,5
134,Dillon Brooks,Houston Rockets,SF,112,279,42,95,422.8,14,15,450.0,14,52,301.9,3,23,26,18,23,7,10,0,71,156,138,130,44,302.9530864197531,24.0,17.679012345679013,9.664197530864197,444.4197530864197,358.41975308641975,357.4864197530864,73.14567901234567,10
135,Domantas Sabonis,Sacramento Kings,PF,200,370,75,122,621.4,47,59,805.8,3,8,233.3,38,114,152,76,27,9,34,8,61,428,352,276,228,355.40277777777777,55.650173611111114,61.04600694444444,2.15625,466.26736111111114,460.2265625,341.48350694444446,136.65625,10
136,Dominick Barlow,San Antonio Spurs,F,57,150,21,38,506.6,15,18,416.6,0,1,0.0,19,22,41,15,19,4,4,3,10,113,98,72,56,248.18714555765598,76.55765595463139,44.882797731569,0.0,606.4631379962193,512.4536862003781,362.13988657844993,101.49716446124764,10
137,Donovan Mitchell,Cleveland Cavaliers,SG,241,347,75,167,435.8,52,59,812.8,39,86,449.3,3,47,50,49,22,13,34,6,4,340,291,290,99,886.6487603305785,22.330578512396695,23.0495867768595,16.96694214876033,1278.185950413223,1120.5,1030.0206611570247,59.69421487603306,10
138,Donte DiVincenzo,New York Knicks,SG,190,362,66,164,389.7,16,20,575.0,42,117,352.1,8,35,43,36,26,17,21,6,59,269,233,226,79,808.0444444444445,43.13827160493827,28.18271604938272,58.0,935.4938271604939,946.7530864197531,795.6641975308642,72.44197530864197,10
139,Dorian Finney-Smith,Brooklyn Nets,PF,93,307,34,77,439.4,11,12,475.0,14,50,283.3,15,31,46,17,18,13,5,5,-18,156,139,110,63,295.0163265306123,26.922448979591838,14.151020408163266,21.575510204081635,441.26530612244903,422.63265306122446,308.3755102040816,46.3469387755102,10
140,Doug McDermott,Indiana Pacers,SF,42,120,16,41,254.2,1,2,50.0,9,33,157.0,1,7,8,9,10,3,4,0,1,59,50,51,17,294.0,10.384,11.384,19.384,413.8,333.664,371.304,24.6,10
141,Draymond Green,Golden State Warriors,PF,82,282,35,80,475.7,6,9,225.0,6,27,143.3,17,62,79,62,30,9,23,8,12,223,161,144,141,107.61975308641976,77.81975308641977,121.77777777777779,6.404938271604938,516.7777777777778,215.0,260.18271604938275,348.81234567901237,10
142,Drew Eubanks,Phoenix Suns,PF,53,162,22,32,658.3,9,10,280.0,0,0,0.0,17,32,49,7,15,4,6,10,33,109,102,60,56,92.3875236294896,73.86862003780719,14.183364839319472,0.0,236.90453686200377,229.68714555765598,88.68052930056712,98.97637051039698,10
143,Duncan Robinson,Miami Heat,F,146,321,53,111,467.0,8,9,350.0,32,84,339.0,2,33,35,30,26,10,16,3,-13,211,181,176,65,468.41111111111104,21.877777777777776,36.01111111111111,37.7,674.5,489.5777777777777,640.8444444444444,70.37777777777778,10
144,Duop Reath,Portland Trail Blazers,C,80,163,29,60,365.9,11,12,550.0,11,27,266.7,7,16,23,5,22,3,9,4,-61,108,103,85,28,516.0141607663473,53.651395251978336,7.0508121615993335,13.413161182840483,939.3144523115369,817.7746772178259,610.7051228654727,87.55102040816325,10
145,Dwight Powell,Dallas Mavericks,C,20,119,7,12,450.0,6,11,325.0,0,0,0.0,12,20,32,9,19,0,9,3,-9,61,52,29,41,40.0226843100189,90.33459357277883,10.449905482041588,0.0,252.97353497164465,199.53686200378075,61.175803402646515,133.0680529300567,9
146,Dylan Windler,Atlanta Hawks,G,5,24,2,5,40.0,0,0,0.0,1,4,25.0,1,4,5,2,2,1,1,0,9,12,10,7,7,13.734693877551019,7.448979591836736,2.091836734693878,0.510204081632653,59.80612244897959,40.0,26.5,16.581632653061224,2
147,Dylan Windler,Los Angeles Lakers,G,3,14,1,4,25.0,0,0,0.0,1,4,25.0,0,1,1,2,1,0,0,0,-7,6,4,5,3,4.591836734693878,1.7346938775510208,0.09183673469387757,0.510204081632653,3.2346938775510203,4.0,4.5,1.1530612244897962,2
148,Dyson Daniels,New Orleans Pelicans,G,38,181,16,32,311.4,1,2,50.0,5,13,250.0,7,20,27,20,12,15,12,8,25,85,65,58,47,123.55555555555556,24.0,25.555555555555557,4.222222222222222,146.22222222222223,113.55555555555556,128.22222222222223,77.55555555555556,9
149,Emoni Bates,Cleveland Cavaliers,F,16,23,6,12,102.9,0,2,0.0,4,8,100.0,0,1,1,1,0,0,1,0,-3,18,17,17,2,8.125,0.625,0.5,2.125,10.0,8.5,10.625,0.125,2
150,Eric Gordon,Phoenix Suns,SG,83,240,31,69,382.9,3,5,150.0,18,42,359.2,2,11,13,20,12,7,6,2,9,116,96,103,33,524.3438527284682,8.79750164365549,16.657462195923735,32.1775147928994,595.3254437869822,456.51939513477976,667.7955292570678,20.80933596318212,10
151,Eugene Omoruyi,Washington Wizards,F,39,106,17,38,391.3,5,10,200.0,0,6,0.0,7,13,20,7,18,7,5,1,-68,66,59,46,27,94.91836734693878,9.033163265306124,6.798469387755102,0.012755102040816325,87.34693877551021,71.67602040816327,106.89030612244898,19.530612244897956,10
152,Evan Fournier,Detroit Pistons,SG,66,176,23,70,284.0,11,12,366.7,9,40,184.3,1,16,17,21,16,9,7,1,-41,104,83,87,38,356.81632653061223,10.83673469387755,16.918367346938776,14.175510204081633,462.8081632653061,439.3020408163265,381.48979591836735,26.587755102040816,10
153,Evan Mobley,Cleveland Cavaliers,PF,151,292,60,106,551.8,28,47,539.2,3,15,125.0,20,73,93,41,28,10,17,15,-20,285,244,192,134,373.0,144.325,92.125,5.325,842.6,702.425,451.225,298.4,10
154,Frank Ntilikina,Charlotte Hornets,PG,5,39,1,8,50.0,2,2,100.0,1,7,50.0,1,4,5,3,4,0,0,0,0,13,10,8,8,19.0,7.0,6.84,0.7600000000000002,24.439999999999998,14.0,18.64,24.640000000000004,4
155,Franz Wagner,Orlando Magic,SF,164,309,63,132,488.5,31,37,785.0,7,39,132.9,6,36,42,30,27,11,16,3,13,236,206,194,72,342.50000000000006,48.1,30.4,11.700000000000001,654.8000000000001,542.0,429.30000000000007,104.5,10
156,Fred VanVleet,Houston Rockets,PG,181,347,58,136,429.3,30,33,635.7,35,80,415.2,3,33,36,93,24,17,21,7,77,310,217,274,129,638.40625,22.425,97.15625,55.25625000000001,566.025,663.8562499999999,538.5,121.65625,10
157,Furkan Korkmaz,Philadelphia 76ers,SG,41,116,13,29,278.6,7,10,241.7,8,18,258.3,3,12,15,12,6,3,2,2,22,68,56,53,27,292.875,14.875,10.0,20.0,404.0,340.0,363.875,17.875,8
158,GG Jackson,Memphis Grizzlies,F,193,329,65,148,422.1,35,42,777.4,28,84,294.3,16,31,47,18,15,4,16,4,-88,258,240,211,65,788.8716049382716,38.13086419753086,18.0,46.0,963.3827160493828,880.4938271604938,863.1827160493827,64.70864197530864,10
159,Garrett Temple,Toronto Raptors,SF,18,57,6,10,250.0,3,4,150.0,3,7,150.0,1,10,11,8,6,4,1,1,10,37,29,26,19,23.6094674556213,9.828402366863905,9.514792899408285,2.78698224852071,33.84023668639053,21.792899408284022,25.100591715976336,29.899408284023668,4
160,Garrison Mathews,Atlanta Hawks,SG,69,194,21,39,565.0,11,13,263.3,16,29,541.8,3,12,15,9,26,4,0,3,-15,93,84,78,24,283.4938271604938,14.530864197530864,16.91111111111111,17.827160493827158,485.1975308641975,388.27160493827165,363.45679012345676,48.404938271604934,10
161,Gary Harris,Orlando Magic,SG,74,238,27,54,532.8,4,7,125.0,16,38,477.6,2,13,15,9,12,8,7,3,22,98,89,83,24,115.07777777777778,10.677777777777777,12.944444444444445,4.800000000000001,210.8111111111111,170.5111111111111,146.2,32.8,10
162,Gary Payton II,Golden State Warriors,SG,31,147,13,24,426.6,2,5,100.0,3,5,300.0,12,12,24,16,15,4,9,2,-9,71,55,47,40,93.6062819576333,55.41709276844413,36.891161431701974,2.2111029948867786,213.67494521548574,145.0,93.66764061358656,160.9218407596786,10
163,Gary Trent Jr.,Toronto Raptors,SG,208,330,76,176,437.1,24,27,646.7,32,89,350.2,9,30,39,15,15,16,3,2,-66,262,247,223,54,629.6897959183673,13.636734693877552,12.551020408163264,32.0,623.1183673469387,672.6081632653062,577.5877551020408,28.799999999999997,10
164,Georges Niang,Cleveland Cavaliers,SF,138,294,50,99,500.3,11,11,500.0,27,63,442.7,2,36,38,16,27,6,16,4,0,192,176,154,54,279.28922495274094,19.45274102079395,11.702268431001892,25.30907372400756,413.992438563327,338.29206049149343,337.48298676748584,48.661625708884685,10
165,Giannis Antetokounmpo,Milwaukee Bucks,PF,298,344,109,178,618.5,72,100,699.9,8,18,383.3,30,84,114,60,26,5,28,7,46,472,412,358,174,500.4792387543253,148.0,89.69550173010381,5.932525951557094,1202.2854671280277,948.7145328719723,757.3442906574395,234.40138408304497,10
166,Goga Bitadze,Orlando Magic,C,28,99,11,20,480.0,6,9,283.3,0,3,0.0,10,12,22,9,10,2,8,9,3,59,50,37,31,47.63905325443787,63.61094674556212,8.33284023668639,0.0,232.10059171597635,173.7174556213018,74.48668639053254,103.4792899408284,9
167,Gordon Hayward,Oklahoma City Thunder,SF,53,188,16,34,486.7,13,19,410.0,8,16,500.0,4,19,23,26,14,5,8,0,2,102,76,79,49,84.6640625,26.5,39.212890625,3.625,160.947265625,124.4140625,109.572265625,77.337890625,10
168,Gradey Dick,Toronto Raptors,G,115,320,43,114,361.4,10,12,533.3,19,59,313.3,4,23,27,20,19,6,16,2,-105,162,142,135,47,241.0,24.452706722189173,35.92742415229031,18.900059488399762,424.29744199881026,332.33075550267694,317.3176680547293,76.0291493158834,10
169,Grant Williams,Charlotte Hornets,PF,121,303,44,99,449.5,21,26,538.9,12,43,305.9,11,28,39,23,29,11,22,4,-116,183,160,144,62,345.0,22.206249999999997,19.0,8.5,396.40625,438.25625,302.0,42.356249999999996,10
170,Grayson Allen,Phoenix Suns,SG,166,345,56,96,579.3,17,20,691.7,37,70,420.0,2,26,28,28,18,8,11,6,48,222,194,194,56,680.5530864197531,15.777777777777777,37.501234567901236,94.37777777777778,809.0271604938272,637.0123456790124,858.9975308641975,46.84938271604938,10
171,Gui Santos,Golden State Warriors,F,38,103,13,24,372.5,8,9,350.0,4,8,250.0,9,21,30,9,14,2,5,2,22,77,68,47,39,164.88581314878894,97.67474048442905,13.71280276816609,4.173010380622837,524.6747404844291,468.1245674740484,185.69896193771626,147.12456747404843,8
172,Harrison Barnes,Sacramento Kings,SF,131,291,46,100,451.9,21,26,550.0,18,47,259.3,6,26,32,12,14,3,7,1,-1,175,163,143,44,286.98350694444446,33.90625,9.73611111111111,48.2890625,425.7890625,336.0043402777778,367.9765625,52.43402777777778,10
173,Harry III Giles,Brooklyn Nets,F,8,8,3,6,50.0,1,2,50.0,1,1,100.0,2,2,4,2,3,0,0,0,-12,14,12,10,6,44.72265625,10.16015625,3.28515625,0.765625,136.59765625,97.515625,72.25,25.0,1
174,Harry III Giles,Los Angeles Lakers,F,2,5,1,1,100.0,0,0,0.0,0,0,0.0,0,1,1,0,0,0,0,0,-3,3,3,2,1,0.47265625,0.03515625,0.03515625,0.015625,0.47265625,0.765625,0.25,0.0,1
175,Haywood Highsmith,Miami Heat,F,39,134,15,32,368.8,1,4,50.0,8,18,250.0,6,14,20,11,7,1,1,0,-37,70,59,50,31,327.5353955978585,35.426531826293875,9.121356335514575,19.828673408685304,602.6555621653777,535.8411659726354,374.09161213563357,64.80606781677572,10
176,Herbert Jones,New Orleans Pelicans,SF,85,311,30,55,490.8,12,15,500.0,13,29,310.8,5,24,29,29,28,14,13,13,61,143,114,114,58,209.65625,32.525,14.95625,20.5,357.125,281.05625000000003,252.79999999999998,80.40625,10
177,Hunter Tyson,Denver Nuggets,F,0,7,0,3,0.0,0,0,0.0,0,3,0.0,0,1,1,0,1,0,2,0,-1,1,1,0,1,7.5625,0.0,0.0625,0.5625,9.0,7.5625,9.0,0.0625,1
178,Ibou Badji,Portland Trail Blazers,C,7,32,3,4,150.0,1,2,50.0,0,0,0.0,1,2,3,4,6,0,5,3,-17,14,10,11,7,15.720000000000002,3.0800000000000005,2.75,0.0,37.06999999999999,30.32,21.470000000000002,6.83,3
179,Immanuel Quickley,Toronto Raptors,SG,195,364,68,158,420.7,33,45,597.2,26,77,328.3,2,55,57,88,17,11,26,3,-71,340,252,283,145,477.0639999999999,39.496,197.456,20.976,930.7840000000001,541.9359999999999,785.464,317.4,10
180,Isaac Okoro,Cleveland Cavaliers,SF,88,335,33,78,436.7,8,13,291.7,14,40,408.4,9,25,34,19,26,9,12,5,-36,141,122,107,53,109.35822306238185,48.661625708884685,12.912098298676748,6.401701323251418,259.10586011342156,211.91776937618147,146.296786389414,71.82325141776937,10
181,Isaiah Hartenstein,New York Knicks,C,91,237,40,55,762.4,11,16,580.0,0,0,0.0,32,55,87,29,28,11,9,17,99,207,178,120,116,312.65624999999994,63.7,10.899999999999999,0.0,437.25625,408.75625,313.75624999999997,102.0,10
182,Isaiah Jackson,Indiana Pacers,SF,87,174,34,52,694.3,19,27,708.3,0,1,0.0,21,32,53,13,25,10,8,7,19,153,140,100,66,228.11111111111114,189.64197530864197,28.111111111111114,0.0,792.8271604938271,680.7901234567901,262.4444444444444,295.4567901234568,10
183,Isaiah Joe,Oklahoma City Thunder,SG,55,162,20,58,287.9,3,3,100.0,12,40,253.3,4,14,18,9,11,3,3,3,-21,82,73,64,27,152.125,9.756250000000001,6.95625,7.7,218.5,192.00625,177.20624999999998,18.125,10
184,Isaiah Mobley,Cleveland Cavaliers,F,5,33,2,7,58.3,0,0,0.0,1,4,25.0,0,4,4,2,2,0,0,0,-1,11,9,7,6,0.6799999999999997,10.880000000000003,0.72,0.6800000000000002,13.32,9.0,2.1199999999999997,14.479999999999999,2
185,Isaiah Stewart,Detroit Pistons,C,106,319,40,71,587.7,10,12,516.7,16,38,409.0,10,48,58,12,11,4,10,10,-48,176,164,118,70,131.47520661157026,49.603305785123965,9.603305785123966,12.764462809917354,245.47520661157023,193.27685950413223,178.88016528925618,64.0,10
186,Ish Smith,Charlotte Hornets,PG,18,181,8,34,236.0,0,0,0.0,2,2,200.0,1,19,20,41,16,5,6,1,-90,79,38,59,61,54.36000000000001,24.0,78.09,1.5600000000000003,170.49,69.16000000000001,134.09,123.69,9
187,Ish Wainright,Phoenix Suns,F,3,11,1,6,16.7,0,0,0.0,1,4,25.0,3,2,5,1,1,1,1,0,-3,9,8,4,6,6.25,17.361111111111114,0.6944444444444445,0.6944444444444445,56.25,44.44444444444445,11.111111111111112,25.0,1
188,Ivica Zubac,LA Clippers,C,107,261,45,65,726.8,17,20,575.0,0,0,0.0,28,58,86,15,25,7,12,11,-18,208,193,122,101,195.70000000000002,30.000000000000007,4.5,0.0,267.59999999999997,234.1,215.20000000000002,48.50000000000001,10
189,JT Thor,Charlotte Hornets,F,17,99,7,15,308.3,0,0,0.0,3,8,200.0,1,12,13,6,9,0,2,3,22,36,30,23,19,44.183364839319474,13.952741020793953,5.0359168241965975,4.258979206049149,66.38941398865785,68.72211720226844,45.279773156899815,15.559546313799622,10
190,JaVale McGee,Sacramento Kings,C,23,44,11,18,355.0,0,3,0.0,1,2,100.0,5,8,13,1,6,2,1,0,3,37,36,24,14,49.73372781065089,13.0,0.834319526627219,0.834319526627219,84.55029585798816,89.50295857988166,49.08875739644971,9.526627218934912,6
191,Jabari Smith Jr.,Houston Rockets,PF,125,280,45,98,454.2,18,20,841.7,17,45,314.8,15,54,69,14,28,9,12,8,32,208,194,139,83,383.42950624628196,151.53539559785844,12.643664485425342,18.29327781082689,717.2218917311125,697.6311719214752,409.1213563355146,158.07792980368828,10
192,Jabari Walker,Portland Trail Blazers,F,111,253,44,80,546.2,17,22,740.0,6,15,366.7,19,57,76,14,34,9,9,1,-3,201,187,125,90,303.82450922070194,72.9244497323022,18.819750148721,6.468768590124925,547.7043426531827,487.2201070791196,319.0499702558001,137.0029744199881,10
193,Jacob Gilyard,Brooklyn Nets,G,0,11,0,2,0.0,0,0,0.0,0,2,0.0,0,0,0,1,2,1,0,0,0,1,0,1,1,37.00694444444444,1.5625,9.506944444444443,3.3611111111111107,108.50694444444443,53.77777777777777,84.02777777777777,18.777777777777775,1
194,Jacob Gilyard,Memphis Grizzlies,G,67,192,23,49,431.8,1,1,100.0,20,42,431.8,1,13,14,39,10,9,12,2,-59,120,81,106,53,240.89583333333337,11.0625,26.5625,20.91666666666667,391.0625,299.0,318.9166666666667,51.66666666666667,9
195,Jacob Toppin,New York Knicks,F,13,29,5,9,107.1,2,2,100.0,1,4,33.3,3,3,6,1,3,0,1,0,-18,20,19,14,7,78.05555555555556,8.722222222222221,0.5555555555555556,0.7222222222222223,130.22222222222223,136.55555555555554,72.5,8.5,2
196,Jaden Hardy,Dallas Mavericks,G,77,116,32,65,499.4,4,5,250.0,9,21,300.0,1,9,10,18,10,3,7,1,9,105,87,95,28,147.36525877453897,10.023795359904819,31.70493753718025,7.042831647828674,209.0,169.77810826888756,174.48720999405117,53.828673408685304,10
197,Jaden Ivey,Detroit Pistons,PG,144,307,53,139,389.7,26,33,691.7,12,53,220.6,10,23,33,41,25,11,31,6,-94,218,177,185,74,136.0,21.141528925619838,59.49173553719009,9.31095041322314,265.5010330578512,194.4142561983471,200.40082644628097,87.31921487603306,10
198,Jaden McDaniels,Minnesota Timberwolves,PF,109,302,43,103,416.8,12,22,298.8,11,40,295.0,13,37,50,13,35,9,10,6,-25,172,159,122,63,394.24444444444447,47.90123456790124,29.0,15.553086419753088,542.3604938271606,499.62716049382703,393.64444444444445,120.23456790123457,10
199,Jaden Springer,Boston Celtics,G,60,176,22,52,413.7,13,14,575.0,3,18,183.3,13,18,31,17,21,13,10,4,-19,108,91,77,48,209.3204775022957,46.322314049586765,28.35537190082644,2.537190082644628,615.8549127640036,435.89623507805334,333.5270890725436,130.42975206611573,10
200,Jae Crowder,Milwaukee Bucks,PF,60,199,24,50,442.9,2,2,100.0,10,26,316.6,8,16,24,11,15,8,2,1,-6,95,84,71,35,108.91322314049587,22.765495867768596,7.480371900826446,10.74380165289256,145.23140495867767,146.73243801652893,109.86880165289254,27.78925619834711,10
201,Jae'Sean Tate,Houston Rockets,SF,46,141,19,40,444.1,5,9,200.0,3,8,233.3,11,19,30,8,17,8,12,5,-2,84,76,54,38,85.06208911614316,32.93791088385683,5.899196493791088,2.1088385682980277,202.51570489408326,163.47114682249818,106.53761869978086,56.40613586559533,10
202,Jahmi'us Ramsey,Toronto Raptors,SG,47,120,18,41,306.3,5,6,175.0,6,22,183.3,4,18,22,8,10,7,7,0,-28,77,69,55,30,68.92,36.92,3.1575,3.1175,96.1175,107.67999999999999,77.21749999999999,20.217499999999998,7
203,Jaime Jr. Jaquez,Miami Heat,G,104,291,39,86,430.4,18,25,616.7,8,25,244.89999999999998,9,40,49,27,20,12,9,3,3,180,153,131,76,399.9229968782518,41.14984391259105,22.292403746097815,7.839750260145682,373.75650364203955,369.74921956295526,390.9687825182102,76.40374609781477,10
204,Jake LaRavia,Memphis Grizzlies,F,123,284,35,105,334.7,38,47,693.9,15,52,310.2,22,28,50,19,22,14,9,5,-48,192,173,142,69,213.60726643598616,104.21626297577855,28.916955017301035,4.508650519031142,442.0,454.681660899654,228.8044982698962,105.25432525951558,10
205,Jakob Poeltl,Toronto Raptors,C,122,251,55,101,543.9,12,20,491.7,0,0,0.0,39,53,92,31,28,10,11,19,35,245,214,153,123,161.8469387755102,127.67346938775509,30.387755102040813,0.0,516.704081632653,398.98979591836735,256.6224489795918,181.0,10
206,Jalen Brunson,New York Knicks,PG,284,331,106,228,469.9,41,49,659.1,31,78,425.1,6,27,33,60,15,8,23,2,99,377,317,344,93,840.9756625202813,16.288263926446728,64.4380746349378,14.711195240670634,581.8393726338562,794.9415900486749,624.4478096268255,84.15197404002164,10
207,Jalen Duren,Detroit Pistons,C,132,273,49,79,611.5,34,41,755.0,0,0,0.0,31,86,117,21,31,6,27,4,-81,270,249,153,138,262.72315558802046,252.23593864134403,23.061358655953253,0.0,1020.0,865.0613586559533,346.23593864134403,346.72315558802046,10
208,Jalen Green,Houston Rockets,SG,276,357,98,198,487.7,40,51,789.6,40,93,411.7,7,51,58,34,16,10,20,5,141,368,334,310,92,862.2716049382716,89.57530864197531,10.444444444444445,37.264197530864195,1148.0444444444445,1155.7777777777778,852.3456790123457,102.21234567901233,10
209,Jalen HoodSchifino,Los Angeles Lakers,G,5,11,1,6,33.3,2,4,100.0,1,3,50.0,0,2,2,0,1,0,1,0,-13,7,7,5,2,9.0,0.9799999999999999,0.020000000000000004,0.8200000000000001,13.32,14.180000000000001,8.42,0.72,2
210,Jalen Johnson,Atlanta Hawks,SF,178,339,71,149,485.0,19,29,568.3,17,46,399.9,13,75,88,44,19,7,16,11,35,310,266,222,132,520.0495867768595,92.6317722681359,50.47199265381084,14.673094582185492,1012.7970615243343,701.9265381083562,770.7750229568411,203.24885215794305,10
211,Jalen McDaniels,Toronto Raptors,PF,41,132,18,44,312.0,2,4,66.7,3,15,116.7,6,20,26,11,13,7,13,1,-46,78,67,52,37,175.8336483931947,85.91871455576559,12.674858223062383,4.370510396975425,428.2041587901701,349.7863894139886,222.5765595463138,130.26843100189035,9
212,Jalen Pickett,Denver Nuggets,G,2,7,1,3,33.3,0,0,0.0,0,2,0.0,0,0,0,2,0,0,0,0,-1,4,2,4,2,2.4693877551020407,0.02040816326530612,1.3061224489795917,0.0,6.612244897959182,2.0408163265306123,7.367346938775511,1.0,1
213,Jalen Slawson,Sacramento Kings,F,2,8,1,2,50.0,0,0,0.0,0,1,0.0,1,1,2,0,2,1,0,0,3,4,4,2,2,0.7346938775510206,0.32653061224489793,0.0,0.0,2.040816326530612,2.040816326530612,0.7346938775510206,0.32653061224489793,1
214,Jalen Smith,Indiana Pacers,PF,90,164,31,56,515.1,18,29,490.0,10,25,361.9,21,34,55,11,16,1,3,6,29,156,145,101,66,191.3149678604224,57.71441689623508,17.157943067033976,10.449954086317723,330.2314049586777,283.0422405876951,240.623507805326,72.75298438934803,10
215,Jalen Suggs,Orlando Magic,SG,136,280,48,92,530.1,15,21,533.3,25,56,437.9,4,28,32,31,28,13,17,5,123,199,168,167,63,251.80423666910153,28.34915997078159,14.938641344046749,23.305332359386416,291.2352081811541,257.46238130021914,268.6289262235208,60.23593864134405,10
216,Jalen Williams,Oklahoma City Thunder,F,188,289,75,143,512.6,25,29,786.7,13,32,323.2,6,30,36,37,22,16,18,10,49,261,224,225,73,568.0657462195923,23.138724523339906,18.296515450361607,14.134779750164366,824.3136094674556,714.7758053911899,653.7245233399079,65.31426692965155,10
217,Jalen Wilson,Brooklyn Nets,F,42,148,16,47,370.5,8,9,350.0,2,18,75.0,12,18,30,11,8,1,8,0,12,83,72,53,41,105.73061224489797,34.522448979591836,6.90204081632653,2.1224489795918364,234.2,185.73061224489797,130.26530612244898,65.35918367346937,10
218,Jamal Cain,Miami Heat,F,9,25,2,5,100.0,4,4,200.0,1,2,100.0,2,3,5,3,2,1,2,0,-5,17,14,12,8,9.0,2.0,2.099173553719008,0.7355371900826445,26.917355371900825,17.0,18.1900826446281,4.826446280991735,3
219,Jamal Murray,Denver Nuggets,PG,227,360,87,190,450.6,33,39,861.4,20,50,410.0,10,43,53,82,18,16,22,3,51,362,280,309,135,463.3490304709141,47.16481994459834,73.01523545706371,20.02770083102493,650.9362880886429,468.5,620.0124653739612,145.95290858725764,10
220,James Bouknight,Charlotte Hornets,SG,10,13,4,10,83.3,0,0,0.0,2,7,58.3,0,0,0,0,0,1,1,0,13,10,10,10,0,18.0,0.0,0.0,0.72,18.0,18.0,18.0,0.0,2
221,James Harden,LA Clippers,SG,155,356,50,119,418.2,33,37,941.7,22,67,277.8,5,44,49,97,18,8,26,6,-32,301,204,252,146,323.5116002379536,55.070196311719215,65.38548483045805,33.93218322427127,407.20464009518145,364.69482450922067,353.9619274241523,132.51516954193931,10
222,James Johnson,Indiana Pacers,PF,2,7,0,1,0.0,2,2,100.0,0,0,0.0,0,0,0,1,3,0,0,1,1,3,2,3,1,2.5600000000000005,0.0,0.6400000000000001,0.0,5.76,2.5600000000000005,5.76,0.6400000000000001,1
223,James Wiseman,Detroit Pistons,C,116,234,48,77,565.3,20,24,583.3,0,0,0.0,27,62,89,17,27,1,18,8,-58,222,205,133,106,384.3497698882314,96.77777777777777,18.797501643655487,0.0,831.2965154503614,688.1360946745563,516.3136094674556,126.77186061801449,10
224,Jamie Jr. Jaquez,Miami Heat,G,10,45,4,12,74.3,1,1,100.0,1,6,20.0,0,1,1,5,5,0,1,0,-22,16,11,15,6,8.0,0.5,0.5,0.5,8.0,12.5,4.5,0.0,2
225,Jarace Walker,Indiana Pacers,F,34,130,12,32,332.2,2,2,100.0,8,19,300.0,3,24,27,15,11,5,5,6,42,76,61,49,42,133.4025,50.0625,69.5625,8.622500000000002,571.8025,310.09,310.49,204.25,9
226,Jared Butler,Washington Wizards,SG,67,191,28,70,479.7,7,7,400.0,4,25,103.4,6,14,20,47,17,9,22,3,-25,134,87,114,67,146.7890625,20.3515625,153.125,4.447265625,566.0,182.125,447.1015625,257.0390625,10
227,Jared Rhoden,Detroit Pistons,G,19,67,8,15,203.3,0,0,0.0,3,7,133.3,0,11,11,4,8,1,4,4,-20,34,30,23,15,39.3125,11.8125,7.0,0.8125,67.0,94.0,23.8125,7.3125,4
228,Jaren Jackson Jr.,Memphis Grizzlies,PF,226,336,78,188,413.9,53,72,717.5,17,53,332.9,18,44,62,29,39,15,30,22,-102,317,288,255,91,501.2345679012345,142.0,38.84104938271605,10.21141975308642,800.9151234567901,916.5679012345679,450.24845679012344,116.17438271604938,10
229,Jarred Vanderbilt,Los Angeles Lakers,PF,68,142,26,42,412.7,13,17,375.0,3,5,166.7,12,22,34,12,8,16,11,2,23,114,102,80,46,111.33333333333334,59.333333333333336,18.0,3.5,362.0,274.0,157.33333333333334,119.33333333333334,6
230,Jarrett Allen,Cleveland Cavaliers,C,179,332,65,108,606.2,49,62,808.8,0,0,0.0,22,91,113,25,14,5,12,11,-15,317,292,204,138,473.093572778828,212.10680529300566,20.882797731569,0.0,1293.052930056711,1195.7277882797732,517.5207939508507,285.88752362948964,10
231,Jason Preston,Utah Jazz,G,4,25,2,6,66.6,0,0,0.0,0,0,0.0,2,4,6,7,1,0,1,0,10,17,10,11,13,1.2800000000000002,4.275555555555554,7.879999999999999,0.0,32.55555555555556,8.96888888888889,13.32,23.70222222222222,2
232,Javon Freeman-Liberty,Toronto Raptors,G,57,168,20,47,292.1,15,17,630.0,2,16,83.3,4,23,27,17,12,4,8,2,-35,101,84,74,44,221.78512396694217,11.719008264462811,8.446280991735538,1.702479338842975,314.2314049586777,293.83471074380157,234.0165289256198,28.3305785123967,8
233,Jaxson Hayes,Los Angeles Lakers,C,53,141,19,27,701.7,15,22,575.0,0,1,0.0,16,30,46,3,17,2,9,4,-6,102,99,56,49,53.44444444444445,86.88625904010519,4.221564760026299,0.0,156.46416831032218,150.34779750164367,52.67455621301775,97.99408284023669,10
234,Jay Huff,Denver Nuggets,C,3,5,1,2,50.0,0,0,0.0,1,2,50.0,0,0,0,0,2,0,0,0,-3,3,3,3,0,3.4082840236686396,0.4792899408284023,0.0,0.5917159763313609,1.3313609467455618,1.3313609467455618,3.4082840236686396,0.4792899408284023,1
235,Jaylen Brown,Boston Celtics,SG,291,337,112,217,515.3,38,60,625.9,29,73,398.6,19,38,57,28,24,16,16,0,100,376,348,319,85,515.2479338842974,106.1386593204775,19.887970615243344,18.463728191000918,848.4444444444446,801.8879706152435,535.4719926538108,152.35904499540862,10
236,Jaylin Williams,Oklahoma City Thunder,F,32,121,12,28,358.3,1,1,100.0,7,19,358.2,4,26,30,9,12,4,2,4,14,71,62,41,39,51.808641975308646,32.625,7.1419753086419755,2.1003086419753085,119.47067901234568,125.15586419753086,52.90123456790123,32.989197530864196,10
237,Jayson Tatum,Boston Celtics,SF,284,364,94,210,447.1,60,71,840.7,36,82,430.5,12,55,67,53,18,12,29,6,81,404,351,337,120,378.4891975308642,92.82716049382717,42.3966049382716,20.41512345679012,410.0,568.729938271605,278.1604938271605,76.82253086419753,10
238,Jeenathan Williams,Houston Rockets,G,12,26,6,10,133.4,0,2,0.0,0,0,0.0,3,3,6,0,5,1,0,0,18,18,18,12,6,45.170068027210874,5.598639455782314,0.061224489795918366,0.0,69.8639455782313,72.5374149659864,43.435374149659864,4.721088435374149,3
239,Jeff Dowtin,Philadelphia 76ers,G,31,81,11,19,237.1,2,2,100.0,7,14,216.7,1,9,10,16,0,4,3,1,18,57,41,47,26,160.23966942148758,14.0,33.96694214876033,5.330578512396694,405.0,212.05785123966945,323.0,78.14876033057853,6
240,Jeff Green,Houston Rockets,PF,78,174,27,60,373.9,10,13,375.0,14,33,375.0,3,24,27,7,12,2,4,5,27,112,105,85,34,383.71444023796647,38.22985397512169,2.437533802055165,16.546241211465656,573.2374256354786,572.9881016765819,387.34505137912384,37.28610059491617,10
241,Jerami Grant,Portland Trail Blazers,SF,169,342,56,142,386.6,38,46,711.3,19,49,402.0,6,19,25,35,18,14,28,2,-77,229,194,204,60,473.98961937716257,45.9204152249135,32.71626297577855,5.083044982698962,888.6262975778548,739.6678200692041,583.0934256055364,118.49134948096886,10
242,Jeremiah Robinson-Earl,New Orleans Pelicans,F,28,87,11,24,269.6,4,7,80.0,2,9,100.0,9,9,18,10,6,3,2,1,30,56,46,38,28,64.49108367626886,37.47462277091906,27.777777777777782,1.5610425240054868,223.19753086419752,152.1604938271605,107.55281207133059,93.22770919067217,7
243,Jeremy Sochan,San Antonio Spurs,F,134,308,52,126,392.1,20,26,633.4,10,44,214.2,20,64,84,33,25,10,22,12,-1,251,218,167,117,548.4197530864197,150.0,38.37777777777778,10.123456790123457,835.0790123456791,933.3530864197533,462.54567901234566,175.97777777777776,10
244,Jericho Sims,New York Knicks,C,21,164,8,11,366.7,5,7,130.0,0,0,0.0,17,28,45,8,11,5,5,4,18,74,66,29,53,93.06747404844292,74.71626297577855,9.6280276816609,0.0,278.8996539792388,223.16435986159166,140.9584775086505,92.18858131487889,10
245,Jerome Robinson,Golden State Warriors,SG,10,17,4,10,40.0,1,2,50.0,1,6,16.7,0,0,0,1,1,0,0,1,-2,11,10,11,1,61.5621301775148,0.21301775147928997,0.4792899408284023,0.7159763313609467,65.23668639053254,54.53254437869823,72.90532544378698,0.053254437869822466,1
246,Jett Howard,Orlando Magic,G,0,5,0,1,0.0,0,0,0.0,0,1,0.0,0,0,0,0,1,0,0,0,-5,0,0,0,0,0.25,0.0,0.0,0.027777777777777776,0.25,0.25,0.25,0.0,1
247,Jevon Carter,Chicago Bulls,PG,49,154,20,39,465.20000000000005,1,2,50.0,8,21,241.7,2,8,10,13,10,3,4,1,9,72,59,62,23,156.5,13.24567474048443,8.29930795847751,7.6055363321799305,217.6885813148789,186.92214532871975,172.26989619377164,36.541522491349475,10
248,Jimmy Butler,Miami Heat,SF,211,348,72,144,494.6,58,67,837.2,9,27,333.3,12,34,46,53,15,14,19,3,59,310,257,264,99,553.7242455775234,44.73048907388137,36.39229968782519,9.170655567117585,775.9937565036421,573.0332986472424,724.5348595213319,113.2726326742976,10
249,Jock Landale,Houston Rockets,C,98,203,37,55,669.6,19,21,550.0,5,9,350.0,23,24,47,23,21,2,8,14,95,168,145,121,70,225.0007304601899,102.10883856829803,38.23593864134405,5.641344046749452,758.1008035062089,585.0,338.57633308984657,199.8699780861943,10
250,Joe Harris,Detroit Pistons,SF,2,12,1,3,33.3,0,0,0.0,0,1,0.0,0,0,0,0,1,0,0,0,-5,2,2,2,0,0.0,0.0,0.0,0.0,0.0,0.0,0.0,0.0,1
251,Joe Ingles,Orlando Magic,SG,31,158,9,16,330.0,5,6,250.0,8,15,325.0,2,16,18,30,12,7,10,0,37,79,49,61,48,121.125,9.625,47.224999999999994,9.624999999999998,155.125,113.3,157.29999999999998,62.5,10
252,Joel Embiid,Philadelphia 76ers,C,45,61,16,38,82.8,9,12,170.0,4,10,83.3,2,12,14,5,6,2,10,0,-41,64,59,50,19,144.5,0.0,0.5,0.0,162.0,144.5,162.0,0.5,2
253,John Collins,Utah Jazz,PF,180,286,68,119,573.7,30,40,702.5,14,30,462.2,24,61,85,10,27,4,12,12,-40,275,265,190,95,256.625,123.55625,10.1,6.90625,556.05625,512.80625,289.22499999999997,144.30625,10
254,John Konchar,Memphis Grizzlies,SG,57,299,19,46,385.8,8,9,266.7,11,29,391.6,19,45,64,29,20,13,17,9,-3,150,121,86,93,131.33399079552927,70.48520710059172,15.057856673241288,7.21301775147929,291.4792899408284,223.5706771860618,166.67455621301775,118.1111111111111,10
255,Johnny Davis,Washington Wizards,G,34,144,14,36,321.4,3,4,150.0,3,13,83.3,4,12,16,9,13,3,1,5,-63,59,50,43,25,78.46876859012494,14.415229030339084,12.900059488399762,4.110053539559786,181.04283164782868,120.14872099940511,140.16478286734088,26.513384889946458,10
256,Johnny Juzang,Utah Jazz,G,58,155,22,48,336.9,0,0,0.0,14,36,269.2,4,14,18,6,12,0,4,0,-7,82,76,64,24,308.17474489795916,24.92984693877551,5.306122448979592,25.246173469387756,356.90306122448976,385.2704081632653,275.60331632653066,34.44005102040816,9
257,Jonas Valanciunas,New Orleans Pelicans,C,68,185,28,56,532.7,9,11,433.3,3,12,150.0,12,61,73,14,26,2,11,6,25,155,141,82,87,121.53591682419659,53.49810964083176,21.407372400756145,4.168241965973535,191.52835538752365,219.5482041587901,121.54253308128543,46.87901701323253,10
258,Jonathan Isaac,Orlando Magic,PF,108,173,41,60,698.4,9,11,333.4,17,26,643.3,12,38,50,4,8,8,3,13,62,162,158,112,54,321.78512396694214,34.44995408631772,4.824609733700643,13.809917355371903,437.981634527089,483.10009182736457,289.5408631772268,26.40036730945822,10
259,Jonathan Kuminga,Golden State Warriors,PF,204,299,79,151,524.4,36,45,640.0,10,22,350.1,7,38,45,22,31,12,21,6,6,271,249,226,67,269.61111111111114,66.93402777777777,13.100694444444443,10.3515625,319.44444444444446,274.18402777777777,314.40625,80.5,10
260,Jontay Porter,Toronto Raptors,C,49,159,18,41,352.3,4,6,150.0,9,26,230.4,10,23,33,32,11,10,13,9,-28,114,82,81,65,215.4023668639053,32.251479289940825,58.16863905325444,15.943786982248522,472.0,275.0917159763314,386.0976331360947,116.63313609467455,10
261,Jordan Clarkson,Utah Jazz,PG,161,328,58,144,353.7,31,35,737.9,14,53,206.6,7,29,36,63,18,10,23,0,-70,260,197,224,99,961.0661157024795,108.01652892561984,87.42561983471074,20.41322314049587,1358.7479338842977,1331.1487603305784,961.6074380165289,222.5,10
262,Jordan Goodwin,Memphis Grizzlies,G,71,257,29,86,350.5,5,12,225.0,8,31,229.89999999999998,13,33,46,42,16,16,17,10,-68,159,117,113,88,121.92500000000001,126.0,72.825,3.825,421.4,285.325,130.2,326.625,10
263,Jordan Hawkins,New Orleans Pelicans,G,45,112,16,52,354.8,4,5,150.0,9,34,190.0,2,11,13,8,6,1,2,2,9,66,58,53,21,183.0415224913495,16.188581314878892,7.688581314878892,11.399653979238753,255.83564013840828,232.5,209.0,21.254325259515568,10
264,Jordan McLaughlin,Minnesota Timberwolves,PG,62,165,21,34,594.4,4,4,200.0,16,25,419.4,4,19,23,28,7,7,4,2,62,113,85,90,51,176.825,26.35625,18.90625,27.156249999999996,214.50000000000003,220.90625,171.75625,43.925000000000004,10
265,Jordan Miller,LA Clippers,G,4,5,1,1,100.0,2,2,100.0,0,0,0.0,0,1,1,0,0,0,0,0,3,5,5,4,1,9.679012345679013,0.44444444444444453,0.0,0.0,14.271604938271604,14.271604938271604,9.679012345679013,0.44444444444444453,1
266,Jordan Nwora,Toronto Raptors,SF,105,185,43,86,517.8000000000001,8,10,416.7,11,37,301.6,4,36,40,9,10,10,16,5,-45,154,145,114,49,164.23155588020452,48.20745069393718,5.0,7.2279035792549315,223.9663988312637,239.23666910153398,144.25858290723156,57.91015339663988,10
267,Jordan Poole,Washington Wizards,SG,168,293,62,147,410.3,18,20,630.0,26,75,351.6,6,23,29,52,28,12,27,4,-61,249,197,220,81,514.4444444444445,25.444444444444446,94.44444444444444,12.421006944444445,509.4444444444444,463.0,544.0,136.7777777777778,10
268,Jordan Walsh,Boston Celtics,G,2,27,1,4,100.0,0,0,0.0,0,2,0.0,2,4,6,1,5,2,2,1,24,9,8,3,7,2.8099173553719012,13.355371900826448,0.8347107438016528,0.0,1.1983471074380163,4.0,6.68595041322314,7.512396694214876,2
269,Jose Alvarado,New Orleans Pelicans,PG,63,214,21,58,345.8,7,10,350.0,14,31,442.1,5,19,24,26,18,10,7,1,69,113,87,89,50,184.94444444444446,40.40022675736961,44.781179138321995,14.40816326530612,457.2755102040816,310.9954648526077,290.04308390022675,126.36281179138322,10
270,Josh Giddey,Oklahoma City Thunder,SG,139,249,60,111,552.2,5,5,400.0,14,37,403.6,16,52,68,52,18,5,19,4,74,259,207,191,120,239.81921487603307,85.29338842975206,41.88429752066115,8.87603305785124,429.2324380165289,313.9597107438017,304.4142561983471,177.8553719008264,10
271,Josh Green,Dallas Mavericks,SG,67,259,28,55,498.7,4,5,80.0,7,23,270.0,11,24,35,13,16,11,9,2,-34,115,102,80,48,175.42568370986916,41.573127229488705,10.20332936979786,7.416171224732463,227.9346016646849,241.15576694411413,176.20927467300828,37.77170035671819,10
272,Josh Hart,New York Knicks,SG,107,416,43,109,380.6,12,16,408.3,9,43,167.2,24,90,114,54,24,11,18,4,56,275,221,161,168,296.0094517958412,190.32230623818526,125.6710775047259,13.158790170132326,1117.6682419659735,651.5283553875236,615.8620037807183,462.2807183364839,10
273,Josh Minott,Minnesota Timberwolves,F,0,5,0,0,0.0,0,0,0.0,0,0,0.0,0,4,4,0,0,0,0,0,6,4,4,0,4,5.224489795918367,10.331632653061225,0.02040816326530612,0.18367346938775508,0.6173469387755101,0.8622448979591834,5.897959183673469,9.433673469387754,1
274,Josh Okogie,Phoenix Suns,SF,42,135,13,32,323.8,10,11,350.0,6,14,300.0,15,6,21,11,5,7,10,2,-6,74,63,53,32,136.82500000000002,13.8,7.3,6.425000000000001,199.025,190.125,141.125,25.7,10
275,Josh Richardson,Miami Heat,SG,98,211,38,76,433.2,6,6,200.0,16,45,301.7,4,26,30,19,16,5,3,2,3,147,128,117,49,296.8888888888889,20.0,10.88888888888889,27.555555555555557,468.0,427.55555555555554,344.0,24.22222222222222,9
276,Joshua Primo,LA Clippers,G,0,5,0,1,0.0,0,0,0.0,0,0,0.0,1,0,1,0,0,0,1,0,1,1,1,0,1,0.0,0.0,0.0,0.0,0.0,0.0,0.0,0.0,1
277,Jrue Holiday,Boston Celtics,PG,114,323,45,81,564.5,4,4,200.0,20,44,531.8,8,25,33,55,13,14,17,11,120,202,147,169,88,82.40532544378698,48.251479289940825,52.514792899408285,6.014792899408284,209.71597633136096,168.31360946745562,164.9023668639053,59.6715976331361,10
278,Jules Bernard,Washington Wizards,G,40,75,15,32,366.2,3,5,200.0,7,13,335.0,6,7,13,10,6,2,3,1,16,63,53,50,23,171.35349716446126,10.856332703213612,12.120982986767487,5.0,266.7126654064272,207.44612476370514,230.3931947069943,23.204158790170137,6
279,Julian Champagnie,San Antonio Spurs,F,67,237,19,53,303.7,14,17,566.7,15,40,252.5,2,19,21,14,9,7,9,6,13,102,88,81,35,251.2654958677686,36.32334710743802,18.4349173553719,30.3646694214876,571.6828512396695,410.21900826446284,367.9752066115703,99.51239669421489,10
280,Julian Phillips,Chicago Bulls,F,39,132,13,31,272.9,7,8,266.7,6,13,283.4,6,12,18,5,12,5,3,1,-11,62,57,44,23,170.91975308641975,27.290123456790123,6.777777777777779,6.401234567901234,314.4444444444444,289.44444444444446,184.5493827160494,45.43827160493827,10
281,Julian Strawther,Denver Nuggets,G,23,49,8,22,83.0,4,4,200.0,3,15,48.6,1,4,5,5,4,1,4,0,-3,33,28,28,10,166.18749999999997,9.354166666666668,4.187499999999999,3.6875,274.02083333333326,238.75,194.0,21.0,3
282,Julius Randle,New York Knicks,PF,66,99,23,48,142.2,14,14,300.0,6,11,195.0,8,17,25,18,7,1,10,0,25,109,91,84,43,98.0,2.666666666666667,14.0,2.0,140.66666666666669,120.66666666666666,126.0,8.666666666666668,3
283,Justin Champagnie,Washington Wizards,SF,53,142,17,46,209.3,10,12,250.0,9,30,158.3,11,17,28,11,11,6,8,5,-40,92,81,64,39,254.60714285714286,76.03571428571428,8.035714285714285,9.464285714285715,662.8928571428571,589.2857142857142,304.0,108.28571428571429,7
284,Justin Holiday,Denver Nuggets,SF,39,152,15,31,409.0,0,0,0.0,9,20,291.7,1,12,13,17,13,4,1,3,45,69,52,56,30,196.7777777777778,12.14792899408284,44.30177514792899,15.057856673241288,369.01051939513474,250.92570677186063,290.4128862590401,80.89940828402366,10
285,Justin Minaya,Portland Trail Blazers,F,12,99,4,17,149.89999999999998,1,2,50.0,3,14,116.6,6,10,16,4,5,3,3,2,-39,32,28,16,20,22.19753086419753,16.160493827160494,2.530864197530864,2.0123456790123457,47.01234567901234,53.0,17.567901234567902,17.333333333333332,9
286,Jusuf Nurkic,Phoenix Suns,C,85,269,36,70,529.5,13,32,305.4,0,0,0.0,38,86,124,35,31,7,26,10,15,244,209,120,159,59.93491735537188,230.0547520661157,33.66219008264463,0.0,414.4183884297521,379.97520661157023,80.5,277.59504132231405,10
287,Karl-Anthony Towns,Minnesota Timberwolves,C,193,306,66,146,451.8,41,47,734.2,20,56,341.5,20,55,75,29,33,8,24,8,98,297,268,222,104,265.0493827160493,98.62345679012346,46.91975308641975,18.771604938271604,548.530864197531,414.4012345679012,362.2777777777778,182.44444444444443,10
288,Kawhi Leonard,LA Clippers,SF,223,325,85,151,556.6,40,45,840.0,13,38,335.8,11,40,51,31,6,9,19,8,49,305,274,254,82,407.59031235853325,43.82571299230421,20.902218198279765,8.27116342236306,597.3114531462201,495.73653236758724,483.4558623811679,90.43730194658217,10
289,Keegan Murray,Sacramento Kings,SF,139,346,52,120,420.9,14,18,291.7,21,66,302.3,14,45,59,18,28,8,7,10,46,216,198,157,77,370.95463137996217,88.93194706994329,17.615311909262758,36.931947069943284,680.4319470699432,555.6030245746691,480.22778827977316,122.10302457466919,10
290,Keita Bates-Diop,Brooklyn Nets,SF,35,85,12,20,615.0,6,6,300.0,5,11,350.0,3,10,13,5,1,2,5,4,-13,53,48,40,18,50.12485136741973,16.633769322235434,4.645659928656361,5.35909631391201,90.30083234244947,83.89298454221166,48.97502972651605,28.837098692033297,10
291,Keldon Johnson,San Antonio Spurs,SF,161,296,57,117,483.40000000000003,23,28,580.0,24,60,411.6,15,44,59,19,13,4,8,1,-48,239,220,180,78,310.03033908387863,55.255800118976794,21.37120761451517,28.875669244497324,352.8096371207614,368.1082688875669,328.82450922070194,42.534205829863176,10
292,Kelly Olynyk,Toronto Raptors,PF,136,291,55,99,555.1,15,21,430.0,11,29,375.0,16,38,54,53,44,12,36,8,-87,243,190,189,107,281.40987507436046,27.810826888756694,99.098750743605,9.92088042831648,524.5597858417609,379.38726948245085,418.69779892920883,134.7941701368233,10
293,Kelly Oubre Jr.,Philadelphia 76ers,SG,184,332,67,170,397.7,35,47,559.5,15,53,258.5,20,38,58,24,23,12,21,11,-37,266,242,208,82,212.8493827160494,77.19999999999999,29.11111111111111,9.4,384.9234567901234,375.82716049382714,218.21234567901232,110.04444444444444,10
294,Kendall Brown,Indiana Pacers,SG,0,7,0,0,0.0,0,0,0.0,0,0,0.0,0,0,0,0,0,0,0,0,4,0,0,0,0,1.6530612244897962,0.08163265306122448,0.41326530612244905,0.0,4.903061224489797,2.4693877551020407,3.719387755102041,0.8622448979591837,1
295,Kenneth Lofton Jr.,Philadelphia 76ers,F,2,5,1,4,25.0,0,0,0.0,0,2,0.0,0,1,1,0,0,0,0,0,-4,3,3,2,1,0.0,0.0,0.0,0.0,0.0,0.0,0.0,0.0,1
296,Kenrich Williams,Oklahoma City Thunder,SF,36,126,14,34,281.7,2,2,100.0,6,19,216.7,13,21,34,16,13,8,3,1,17,86,70,52,50,157.85180055401665,39.26869806094183,13.691135734072022,7.796398891966759,282.4487534626039,252.53324099722994,163.18559556786704,77.5415512465374,10
297,Kentavious Caldwell-Pope,Denver Nuggets,SG,87,316,32,66,477.4,7,7,400.0,16,40,368.3,1,20,21,23,20,16,13,10,58,131,108,110,44,107.0,13.8,20.5,8.45625,76.5,137.20000000000002,52.1,28.5,10
298,Kenyon Martin Jr.,Philadelphia 76ers,F,47,162,18,37,486.1,8,12,400.0,3,8,250.0,11,22,33,13,31,4,7,3,6,93,80,60,46,121.125,129.92561983471074,18.239669421487605,2.103305785123967,553.4803719008264,439.5506198347107,205.8646694214876,177.35537190082644,10
299,Keon Ellis,Sacramento Kings,G,74,260,28,54,469.1,2,4,100.0,16,36,387.7,6,23,29,17,25,18,4,10,101,120,103,91,46,313.25054784514236,34.979547114682255,34.16143170197224,17.487216946676405,563.7326515704895,425.47918188458726,417.96420745069395,102.68078889700512,10
300,Keon Johnson,Brooklyn Nets,G,12,26,3,8,73.3,4,4,100.0,2,4,133.3,2,1,3,2,2,2,2,0,-9,17,15,14,5,18.88888888888889,0.5555555555555556,2.2222222222222223,0.22222222222222227,27.222222222222225,13.888888888888888,34.0,1.0,2
301,Kessler Edwards,Sacramento Kings,SF,24,67,9,21,206.7,1,2,50.0,5,14,211.7,2,12,14,4,8,4,1,1,21,42,38,28,18,80.27999999999999,17.669999999999998,2.1111111111111116,4.274444444444445,117.20777777777778,105.42999999999999,83.05777777777779,28.78111111111111,7
302,Kevin Durant,Phoenix Suns,PF,256,356,100,180,540.5,33,39,643.1,23,56,405.4,3,60,63,39,14,11,32,9,27,358,319,295,102,1167.9669187145557,61.10113421550094,36.715500945179585,22.556710775047257,1530.5756143667297,1320.5500945179583,1292.7240075614368,183.0850661625709,10
303,Kevin Huerter,Sacramento Kings,SG,72,231,29,79,330.1,2,4,100.0,12,45,205.0,6,24,30,25,23,8,11,2,5,127,102,97,55,288.7933884297521,30.44995408631772,4.61248852157943,16.24793388429752,456.10743801652893,441.77777777777777,290.6730945821855,47.51239669421488,10
304,Kevin Knox II,Detroit Pistons,SF,22,89,9,26,148.9,3,3,200.0,1,11,33.3,3,11,14,4,9,2,6,0,21,40,36,26,18,115.33333333333334,19.333333333333336,3.3333333333333335,0.8333333333333335,167.33333333333331,188.0,101.33333333333334,16.0,6
305,Kevin Love,Miami Heat,PF,88,158,30,62,483.6,10,14,208.3,18,45,387.4,10,55,65,19,20,3,10,3,31,172,153,107,84,362.530612244898,61.03061224489795,13.244897959183673,16.97959183673469,574.7448979591837,534.5,405.0,72.05102040816325,10
306,Kevon Looney,Golden State Warriors,F,23,98,10,20,533.3,3,7,75.0,0,0,0.0,6,22,28,10,16,1,6,3,25,61,51,33,38,20.733650416171226,20.149821640903685,4.107015457788347,0.0,18.376932223543395,21.26397146254459,13.361474435196197,28.741973840665874,10
307,Keyontae Johnson,Oklahoma City Thunder,F,5,39,2,8,66.7,0,0,0.0,1,2,100.0,2,4,6,2,4,0,2,0,-15,13,11,7,8,20.0,7.0,1.2653061224489797,0.8163265306122451,29.69387755102041,35.0,17.26530612244898,5.6938775510204085,5
308,Keyonte George,Utah Jazz,G,161,301,53,137,343.0,38,42,825.8,17,63,246.70000000000002,0,35,35,46,14,6,33,2,-115,242,196,207,81,764.9050395668471,32.73427738442316,44.400666389004584,32.23531861724281,1011.792586422324,788.5705955851728,988.1020408163265,77.15993336109955,10
309,Khris Middleton,Milwaukee Bucks,SF,141,258,55,107,485.8,16,19,417.5,15,38,413.3,10,39,49,55,32,8,22,4,28,245,190,196,104,315.0,60.6159169550173,64.4636678200692,4.086505190311419,499.7335640138408,329.49826989619373,453.6989619377163,156.6159169550173,9
310,Killian Hayes,Detroit Pistons,PG,18,79,7,14,209.6,1,3,33.3,3,6,100.0,0,15,15,20,4,0,5,2,-12,53,33,38,35,27.0,18.75,54.0,2.75,252.75,74.75,153.0,124.75,4
311,Kira Lewis Jr.,Utah Jazz,PG,12,39,4,11,44.4,3,4,75.0,1,3,33.3,1,4,5,7,1,0,2,0,-21,24,17,19,12,99.26654064272213,18.37051039697543,9.725897920604915,0.7901701323251418,275.1550094517958,202.35538752362947,152.71266540642725,47.449905482041586,3
312,Klay Thompson,Golden State Warriors,SG,191,278,68,156,441.2,16,18,616.7,39,96,403.1,4,20,24,26,12,8,12,3,0,241,215,217,50,394.30056710775045,19.032136105860115,42.412098298676746,15.158790170132324,371.3137996219282,344.58412098298675,430.187145557656,52.28733459357278,10
313,Kobe Brown,LA Clippers,G,6,32,3,7,200.0,0,0,0.0,0,2,0.0,4,6,10,2,5,0,3,0,-20,18,16,8,12,14.130193905817176,11.977839335180056,1.634349030470914,0.013850415512465372,26.70083102493075,20.623268698060944,12.484764542936286,21.335180055401665,5
314,Kobe Bufkin,Atlanta Hawks,G,27,81,11,31,158.4,1,2,50.0,4,14,115.0,1,10,11,14,6,3,4,1,21,52,38,41,25,72.63265306122449,3.9795918367346945,14.959183673469388,2.836734693877551,134.6326530612245,95.83673469387756,113.83673469387753,16.53061224489796,5
315,Kobi Simmons,Toronto Raptors,G,7,17,3,6,50.0,0,0,0.0,1,2,50.0,1,1,2,0,1,2,1,0,1,9,9,7,2,0.0,0.0,0.0,0.0,0.0,0.0,0.0,0.0,1
316,Kris Dunn,Utah Jazz,G,44,206,19,45,358.5,0,0,0.0,6,18,250.0,9,15,24,32,25,9,8,3,-52,100,68,76,56,114.4,18.641975308641975,28.19753086419753,6.800000000000001,309.6,162.95308641975308,229.88641975308644,78.0,10
317,Kris Murray,Portland Trail Blazers,F,89,302,36,87,432.8,6,10,233.4,11,42,203.29999999999998,14,35,49,18,19,10,11,7,-13,156,138,107,67,385.519692168402,30.416025350837483,9.60887279311906,12.902218198279765,456.5224083295609,471.7971933001358,366.8768673607967,43.39293798098687,10
318,Kristaps Porzingis,Boston Celtics,C,204,298,70,153,467.0,40,43,933.3,24,63,391.1,24,43,67,19,27,9,12,16,95,290,271,223,86,114.77091906721536,103.44444444444444,9.631001371742112,20.507544581618653,389.9753086419753,363.20301783264745,148.1604938271605,106.45816186556928,10
319,Kyle Anderson,Minnesota Timberwolves,SF,86,278,34,76,426.8,16,21,580.0,2,6,100.0,12,31,43,52,20,10,7,7,54,181,129,138,95,85.47505668934241,18.11111111111111,25.665532879818596,1.600907029478458,137.0,115.2845804988662,88.44444444444446,62.52267573696145,10
320,Kyle Kuzma,Washington Wizards,SF,245,341,93,180,530.4,43,55,805.3,16,47,258.3,3,61,64,48,22,8,30,6,-59,357,309,293,112,476.53462603878114,34.40027700831025,53.18559556786704,26.40443213296399,647.4695290858726,571.1703601108032,539.1551246537397,101.26454293628808,10
321,Kyle Lowry,Philadelphia 76ers,PG,76,292,25,66,340.2,11,14,475.0,15,44,310.4,3,25,28,40,22,11,14,2,-57,144,104,116,68,208.55775234131113,17.413111342351716,68.37460978147763,12.627471383975026,226.14776274713842,234.3267429760666,174.73048907388136,111.4360041623309,10
322,Kyrie Irving,Dallas Mavericks,PG,235,351,91,188,484.5,27,27,700.0,26,75,332.8,9,42,51,59,19,13,19,4,33,345,286,294,110,374.52216066482,36.5,112.03462603878117,16.400277008310248,814.3227146814405,450.3379501385042,703.612188365651,183.42936288088643,10
323,LaMelo Ball,Charlotte Hornets,PG,32,55,12,37,66.1,5,6,150.0,3,17,34.7,1,5,6,15,10,3,7,0,-49,53,38,47,21,2.0,2.0,0.5,0.5,4.5,8.0,0.5,0.5,2
324,Lamar Stevens,Memphis Grizzlies,PF,117,209,46,97,495.5,20,22,433.3,5,15,325.0,13,29,42,8,18,7,9,7,-30,167,159,125,50,267.0390625,49.90625,7.625,2.5,384.3515625,300.1640625,350.6015625,58.15625,10
325,Landry Shamet,Washington Wizards,SG,55,184,20,55,273.1,7,7,300.0,8,35,104.1,4,10,14,8,12,4,9,2,-68,77,69,63,22,330.90000000000003,22.5,5.700000000000001,15.624999999999998,463.7,413.80000000000007,373.0,35.99999999999999,10
326,Larry Nance Jr.,New Orleans Pelicans,PF,67,228,27,41,630.3,11,14,383.4,2,5,133.3,15,33,48,23,15,11,3,2,52,138,115,90,71,187.70672218917312,73.08387864366449,6.164782867340868,1.6466389054134445,288.1713265913147,318.75133848899463,180.8768590124926,55.49851279000595,10
327,Lauri Markkanen,Utah Jazz,PF,214,339,66,168,394.1,53,56,956.7,29,80,349.0,21,50,71,25,14,10,17,5,-55,310,285,239,96,345.625,129.03061224489795,46.65561224489796,35.75765306122449,690.0,520.655612244898,495.03061224489795,195.625,10
328,LeBron James,Los Angeles Lakers,SF,265,364,97,177,547.9,53,65,754.8,18,46,396.6,6,67,73,92,10,10,39,4,42,430,338,357,165,403.2716049382716,80.5,27.808641975308642,4.7484567901234565,379.11111111111114,301.88271604938274,516.2777777777777,72.53086419753086,10
329,Leaky Black,Charlotte Hornets,F,27,151,8,25,232.1,7,10,275.0,4,10,150.0,5,21,26,13,12,2,3,2,-31,66,53,40,39,88.0,30.96,8.41,8.25,118.49000000000001,84.96000000000001,110.40999999999998,50.49,9
330,Leonard Miller,Minnesota Timberwolves,F,0,5,0,1,0.0,0,0,0.0,0,0,0.0,0,0,0,2,0,0,0,0,8,2,0,2,2,0.04938271604938271,0.308641975308642,0.44444444444444453,0.0,0.01234567901234569,0.6049382716049383,0.19753086419753085,0.01234567901234569,1
331,Lester Quinones,Golden State Warriors,G,58,162,20,53,357.0,9,13,325.0,9,31,250.0,8,18,26,11,17,2,5,0,-34,95,84,69,37,196.7063020214031,19.05112960760999,14.900118906064211,10.90011890606421,260.0035671819263,292.0,181.92746730083232,16.733650416171226,10
332,Lindy Waters III,Oklahoma City Thunder,F,35,78,12,30,373.3,1,1,100.0,10,23,316.6,3,15,18,4,7,1,3,2,-38,57,53,39,22,125.45679012345677,31.0,4.271604938271606,13.345679012345679,242.77777777777774,211.12345679012344,143.77777777777774,48.604938271604944,9
333,Lonnie Walker IV,Brooklyn Nets,G,62,155,24,70,333.8,3,4,150.0,11,41,155.7,1,18,19,5,11,1,7,3,-4,86,81,67,24,536.2076798269335,20.90048674959438,3.48566792861006,30.9091400757166,762.4553812871823,707.4737696051919,582.14548404543,33.42996214169822,10
334,Luguentz Dort,Oklahoma City Thunder,G,112,275,37,77,493.8,15,15,600.0,23,52,456.5,7,22,29,18,31,7,8,1,56,159,141,130,47,134.198347107438,31.694214876033058,15.625,19.455578512396695,201.73657024793388,137.06611570247932,189.55061983471072,56.63739669421487,10
335,Luka Doncic,Dallas Mavericks,PG,317,380,109,247,440.2,60,73,837.5,39,113,334.0,12,86,98,105,19,14,45,3,74,520,415,422,203,526.4424720578567,61.545036160420764,115.09335963182117,31.5706771860618,622.0065746219592,716.9750164365548,379.32544378698225,228.7869822485207,10
336,Luka Garza,Minnesota Timberwolves,C,45,61,16,35,240.8,6,8,200.0,7,20,233.3,8,6,14,1,8,2,3,1,-7,60,59,46,15,15.927685950413224,17.123966942148762,0.919421487603306,1.2334710743801653,60.528925619834716,56.63842975206611,19.024793388429746,18.836776859504134,5
337,Luka Samanic,Utah Jazz,F,42,107,13,39,288.8,12,14,450.0,4,19,178.3,5,19,24,5,9,1,5,4,-42,71,66,47,29,117.18367346938776,54.79591836734694,4.877551020408164,2.4489795918367347,354.66666666666674,307.16326530612247,148.03401360544217,76.32653061224488,9
338,Luke Kennard,Memphis Grizzlies,SG,124,269,39,78,499.6,18,20,571.4,28,59,476.40000000000003,2,23,25,40,10,8,18,0,-65,189,149,164,65,418.7712665406427,7.29867674858223,89.46313799621927,24.192816635160682,601.7599243856333,437.31758034026467,557.0359168241965,122.93950850661625,10
339,Luke Kornet,Boston Celtics,C,67,196,28,42,628.4,11,12,350.0,0,0,0.0,25,28,53,18,11,3,3,12,69,138,120,85,71,242.25443786982245,176.8527284681131,42.74556213017751,0.0,813.8606180144642,636.4365548980934,338.62130177514797,300.65548980933596,10
340,M. Pereira,Memphis Grizzlies,F,7,25,3,9,100.0,0,1,0.0,1,4,50.0,3,5,8,0,2,2,1,0,5,15,15,7,8,14.75,15.469999999999999,0.0,0.8300000000000001,47.72,47.72,14.75,15.469999999999999,3
341,Malachi Flynn,Detroit Pistons,PG,76,149,27,68,361.7,9,13,341.7,13,34,357.9,4,15,19,18,7,8,8,1,-51,113,95,94,37,346.41111111111115,20.111111111111114,23.477777777777778,11.31111111111111,704.7777777777778,518.1,502.80000000000007,73.87777777777777,10
342,Malaki Branham,San Antonio Spurs,G,80,189,28,80,310.5,14,16,341.7,10,35,216.6,5,11,16,17,11,3,12,1,-65,113,96,97,33,548.0056689342404,22.19614512471655,18.1734693877551,26.05102040816326,792.4591836734694,646.0,690.1383219954648,44.69614512471655,10
343,Malcolm Brogdon,Portland Trail Blazers,PG,102,218,37,83,266.20000000000005,17,19,433.3,11,30,202.89999999999998,7,22,29,40,13,4,17,2,4,171,131,142,69,100.0,28.833333333333336,7.333333333333334,6.833333333333334,113.5,66.83333333333334,151.33333333333331,31.5,6
344,Malik Beasley,Milwaukee Bucks,SG,99,297,35,98,354.5,6,7,250.0,23,75,299.0,4,36,40,13,16,7,8,1,14,152,139,112,53,263.8,22.225,10.1,21.7,271.625,266.925,278.5,22.325000000000003,10
345,Malik Monk,Sacramento Kings,SG,165,275,58,142,390.8,35,37,830.0,14,63,194.7,6,30,36,50,28,6,20,2,48,251,201,215,86,611.2126736111111,37.35069444444444,30.850694444444443,10.546006944444445,898.9626736111111,807.3515625,655.0251736111111,116.0,10
346,MarJon Beauchamp,Milwaukee Bucks,F,30,42,10,16,350.0,7,8,175.0,3,7,200.0,2,9,11,1,4,1,3,0,-17,42,41,31,12,62.11834319526628,11.80473372781065,0.881656804733728,1.9349112426035502,114.73372781065089,103.97041420118344,69.5680473372781,16.0,6
347,Marcus Morris Sr.,Cleveland Cavaliers,SF,39,91,14,32,224.7,4,6,200.0,7,16,250.0,1,14,15,6,6,1,5,1,-24,60,54,45,21,95.3185595567867,30.340720221606645,6.800554016620499,9.279778393351801,196.0,210.590027700831,82.65650969529085,35.21329639889197,5
348,Marcus Morris Sr.,Philadelphia 76ers,SF,40,98,16,38,166.7,4,4,200.0,4,13,103.3,0,14,14,3,5,2,6,1,-21,57,54,43,17,89.202216066482,5.13573407202216,3.598337950138504,3.10803324099723,127.0,109.01939058171746,105.50415512465375,10.412742382271468,4
349,Marcus Sasser,Detroit Pistons,G,89,247,32,83,404.7,11,12,190.0,14,40,399.59999999999997,1,25,26,39,17,6,19,1,-69,154,115,128,65,336.1426692965155,18.16831032215648,45.68113083497699,6.444444444444445,471.7541091387245,357.17751479289944,459.86982248520707,54.69888231426693,10
350,Markelle Fultz,Orlando Magic,PG,61,170,27,62,408.6,7,8,183.3,0,2,0.0,10,17,27,20,14,6,9,2,37,108,88,81,47,177.0674740484429,50.832179930795846,28.186851211072664,0.00865051903114187,317.8131487889273,283.7993079584775,213.57958477508652,76.52076124567473,10
351,Markieff Morris,Dallas Mavericks,PF,5,11,2,3,150.0,0,0,0.0,1,2,50.0,0,2,2,0,0,0,0,0,4,7,7,5,2,0.625,2.5,0.0,0.625,4.625,4.625,0.625,2.5,2
352,Marques Bolden,Charlotte Hornets,C,0,13,0,1,0.0,0,0,0.0,0,0,0.0,0,1,1,0,1,0,1,0,2,1,1,0,1,0.0,0.7551020408163267,0.0,0.0,0.7551020408163267,0.7551020408163267,0.0,0.7551020408163267,2
353,Marvin Bagley III,Washington Wizards,PF,131,252,57,100,563.0,13,17,583.3,4,9,300.0,39,43,82,14,9,6,9,10,-26,227,213,145,96,277.0498614958449,100.8808864265928,14.986149584487535,2.4709141274238227,285.2603878116344,285.1440443213296,257.03324099722994,136.0,10
354,Mason Jones,Sacramento Kings,G,1,13,0,3,0.0,1,2,50.0,0,2,0.0,1,3,4,4,0,0,0,0,10,9,5,5,8,0.0,0.0,0.0,0.0,0.0,0.0,0.0,0.0,1
355,Mason Plumlee,LA Clippers,C,51,113,16,27,586.6,19,25,500.0,0,0,0.0,12,33,45,9,15,3,10,5,-17,105,96,60,54,58.91838842975207,105.23243801652895,8.901859504132231,0.0,211.00103305785123,216.51239669421489,58.264462809917354,109.27685950413223,10
356,Matisse Thybulle,Portland Trail Blazers,SG,75,232,28,57,448.9,6,9,250.0,13,32,368.3,8,23,31,21,15,19,12,8,-28,127,106,96,52,295.0863177226814,36.25436179981635,21.694214876033058,10.827364554637281,627.8760330578513,473.1404958677686,423.188246097337,84.5821854912764,10
357,Matt Ryan,New Orleans Pelicans,F,28,60,10,24,233.3,0,0,0.0,8,19,194.4,1,8,9,2,6,0,2,0,-2,39,37,30,11,171.72318339100346,15.432525951557095,1.4602076124567474,16.193771626297575,285.24567474048445,276.8581314878893,179.96539792387543,17.038062283737023,7
358,Matthew Hurt,Memphis Grizzlies,F,32,110,12,33,215.9,3,3,200.0,5,19,233.4,9,7,16,4,8,3,2,3,-7,52,48,36,20,161.5488,34.3872,4.8992,5.28,353.96479999999997,291.4848,210.83520000000001,52.480000000000004,7
359,Max Christie,Los Angeles Lakers,G,33,106,12,24,569.4,2,3,150.0,7,13,400.0,1,13,14,6,3,0,4,0,-4,53,47,39,20,80.63038714390065,9.159970781592403,2.4572680788897006,4.132213294375457,129.5434623813002,115.84587289992696,94.71073776479183,11.234477720964207,10
360,Max Strus,Cleveland Cavaliers,SG,118,312,42,93,422.4,12,15,316.7,22,62,318.5,11,20,31,48,25,6,16,4,-32,197,149,166,79,284.77562326869804,32.988919667590025,26.775623268698062,31.81717451523546,400.2908587257617,331.86426592797784,377.1024930747922,35.86426592797784,10
361,Maxi Kleber,Dallas Mavericks,PF,22,172,7,24,275.0,4,6,200.0,4,19,216.7,3,24,27,13,20,5,1,5,53,62,49,35,40,87.60737656157049,30.110053539559786,19.729327781082688,5.668054729327781,161.69541939321837,102.12076145151696,157.0,40.02141582391433,10
362,Maxwell Lewis,Los Angeles Lakers,F,0,5,0,1,0.0,0,0,0.0,0,1,0.0,0,0,0,2,0,0,0,0,-3,2,0,2,2,0.05536332179930796,0.0,1.9930795847750862,0.0,1.384083044982699,0.05536332179930796,1.384083044982699,1.9930795847750862,1
363,Micah Potter,Utah Jazz,C,26,80,9,14,300.0,3,3,200.0,5,9,250.0,4,10,14,2,4,0,2,1,-4,42,40,28,16,91.04,3.3855999999999997,1.3376000000000001,4.974399999999999,96.16,83.6896,102.8736,5.36,6
364,Michael Porter Jr.,Denver Nuggets,SF,185,305,71,124,561.2,15,18,580.0,28,60,460.4,14,46,60,16,15,6,11,4,62,261,245,201,76,482.93726338561385,54.25202812330989,12.417522985397511,15.613845321795566,592.96106003245,641.8772309356409,424.6830719307734,76.00757166035696,10
365,Mikal Bridges,Brooklyn Nets,SF,165,357,55,139,383.4,21,27,585.7,34,83,416.4,10,31,41,38,12,10,25,1,-65,244,206,203,79,282.35255198487715,41.879962192816635,34.374291115311905,22.461247637051038,321.29300567107754,332.48771266540643,278.5,68.91209829867675,10
366,Mike Conley,Minnesota Timberwolves,PG,142,295,50,108,444.4,21,24,596.7,21,58,326.2,9,19,28,47,17,15,11,2,5,217,170,189,75,519.8049886621316,23.910430839002267,32.13265306122449,30.98185941043084,525.8163265306122,492.6224489795918,554.4002267573696,54.641723356009074,10
367,Mike Muscala,Oklahoma City Thunder,C,26,127,9,35,234.2,1,2,50.0,7,25,250.0,5,15,20,6,8,2,1,2,24,52,46,32,26,105.66468489892986,21.322235434007133,7.686087990487515,11.618311533888228,234.89892984542215,201.22711058263974,126.41141498216408,41.9334126040428,10
368,Miles Bridges,Charlotte Hornets,SF,201,386,82,184,441.7,21,33,429.7,16,64,236.7,14,58,72,36,16,8,22,4,-107,309,273,237,108,558.2777777777778,78.80839002267574,31.06122448979592,18.403628117913833,894.8049886621316,843.7845804988661,585.9104308390023,133.25736961451247,10
369,Miles McBride,New York Knicks,PG,123,320,44,92,422.2,12,13,483.3,23,55,341.0,8,14,22,26,27,9,5,2,38,171,145,149,48,817.1351606805292,18.691871455576557,65.73534971644612,48.465973534971646,1036.01606805293,870.7533081285444,967.9706994328922,98.85444234404535,10
370,Mo Bamba,Philadelphia 76ers,C,57,210,21,40,526.3,6,9,175.0,9,22,390.0,13,38,51,10,27,8,8,12,-39,118,108,67,61,70.76636019469984,45.30935640886966,18.540832882639265,4.939426717144402,187.91238507301242,121.63115197404002,128.10654407787993,72.79123850730124,10
371,Monte Morris,Minnesota Timberwolves,PG,52,156,20,47,533.6,2,4,150.0,10,20,400.0,2,9,11,28,3,6,2,1,12,91,63,80,39,49.80193905817175,12.909972299168974,43.94459833795014,6.110803324099722,159.86426592797784,78.4016620498615,111.17036011080333,76.94875346260388,10
372,Moritz Wagner,Orlando Magic,C,94,149,36,56,613.8,16,18,660.0,6,16,316.6,7,28,35,11,13,1,13,2,30,140,129,105,46,236.65625,45.525,7.0,4.425,383.75624999999997,386.20624999999995,222.30625,64.425,10
373,Moses Brown,Portland Trail Blazers,C,27,67,11,22,333.3,5,16,120.8,0,0,0.0,11,11,22,4,9,0,4,3,-8,53,49,31,26,63.49382716049383,20.901234567901234,5.716049382716049,0.0,144.11111111111114,114.34567901234567,82.41975308641975,37.45679012345679,7
374,Moses Moody,Golden State Warriors,SG,79,192,32,76,421.5,9,12,233.3,6,32,168.3,11,25,36,5,14,9,6,8,28,120,115,84,41,236.702479338843,86.0,2.502295684113866,8.648301193755739,542.433425160698,538.1570247933885,245.46372819100094,84.01744719926538,10
375,Mouhamadou Gueye,Toronto Raptors,F,9,38,4,13,183.3,1,4,25.0,0,1,0.0,4,2,6,0,3,1,3,4,-32,15,15,9,6,2.5918367346938775,6.0,0.0,0.0,12.30612244897959,12.30612244897959,2.5918367346938775,6.0,4
376,Moussa Diabate,LA Clippers,F,2,7,1,1,100.0,0,2,0.0,0,0,0.0,1,3,4,0,0,1,0,1,1,6,6,2,4,0.0,0.0,0.0,0.0,0.0,0.0,0.0,0.0,1
377,Myles Turner,Indiana Pacers,C,162,271,60,117,498.0,21,33,528.4,21,44,424.2,10,52,62,14,31,3,12,26,28,238,224,176,76,450.7412254610351,44.171326591314696,18.400951814396194,28.952409280190363,460.8828078524688,465.5419393218322,487.7287328970851,20.925639500297443,10
378,Naji Marshall,New Orleans Pelicans,SF,98,203,40,76,522.8,3,3,200.0,15,33,492.1,7,41,48,22,10,10,7,1,79,168,146,120,70,258.31043807463493,58.0,9.835586803677664,21.23796646836127,460.81449432125464,447.6127636560302,250.25635478637096,89.09140075716604,10
379,Nassir Little,Phoenix Suns,SF,11,56,4,14,183.3,0,0,0.0,3,9,200.0,0,10,10,4,7,0,1,2,-10,25,21,15,14,13.011834319526628,15.5,4.4733727810650885,1.7218934911242603,42.00887573964497,36.281065088757394,15.97041420118343,22.742603550295854,6
380,Nate Hinton,Houston Rockets,G,12,22,4,7,110.0,2,3,66.7,2,3,66.7,1,5,6,3,4,1,1,2,10,21,18,15,9,48.05555555555556,6.722222222222221,1.3888888888888884,2.5,97.38888888888886,75.55555555555557,65.0,13.0,2
381,Nathan Mensah,Charlotte Hornets,C,4,59,2,5,66.7,0,0,0.0,0,0,0.0,4,6,10,1,13,2,1,4,-17,15,14,5,11,13.75,9.9375,0.859375,0.0,41.359375,44.4375,13.484375,7.984375,7
382,Naz Reid,Minnesota Timberwolves,C,170,273,60,125,478.9,18,25,459.2,32,66,437.5,10,60,70,20,22,7,17,15,6,260,240,190,90,783.0562500000001,115.225,24.30625,59.224999999999994,929.025,847.0062499999999,848.1,156.50625,10
383,Neemias Queta,Boston Celtics,C,39,80,19,26,443.4,1,2,100.0,0,0,0.0,12,17,29,4,8,3,4,6,63,72,68,43,33,78.9375,55.24609375,2.12109375,0.0,228.734375,238.96484375,76.33984375,49.734375,7
384,Nic Claxton,Brooklyn Nets,C,119,305,50,76,672.3,19,30,571.4,0,1,0.0,28,71,99,24,26,7,13,14,-46,242,218,143,123,217.7485822306238,96.02079395085066,15.379962192816636,0.0,300.41965973534974,317.51984877126654,225.75236294896033,86.296786389414,10
385,Nick Jr. Smith,Charlotte Hornets,G,53,164,17,59,301.1,8,9,187.5,11,32,275.0,2,10,12,17,19,4,5,0,8,82,65,70,29,240.77777777777777,12.1,23.044444444444444,15.8,326.5,253.34444444444446,290.4,58.677777777777784,10
386,Nick Richards,Charlotte Hornets,C,85,293,35,56,611.1,15,19,450.0,0,0,0.0,26,71,97,8,25,5,13,8,-36,190,182,93,105,196.85841760856636,206.91433670434265,9.704937537180252,0.0,475.4729327781082,492.62938726948244,199.48661511005355,196.8346222486615,10
387,Nickeil Alexander-Walker,Minnesota Timberwolves,SG,106,275,38,79,441.2,11,12,383.3,19,44,368.3,8,19,27,23,18,9,8,4,49,156,133,129,50,574.4197530864197,40.10123456790123,25.612345679012346,29.444444444444443,785.2641975308642,701.711111111111,616.0864197530865,107.6,10
388,Nicolas Batum,Philadelphia 76ers,PF,35,275,13,43,249.6,4,5,150.0,5,27,158.3,14,35,49,17,17,10,9,6,-3,101,84,52,66,144.23265306122448,49.48979591836734,24.26530612244898,5.236734693877551,294.3877551020408,223.0448979591837,181.55102040816325,107.7795918367347,10
389,Nikola Jokic,Denver Nuggets,C,271,369,106,183,587.1,49,57,856.2,10,22,248.7,30,94,124,75,18,16,30,7,93,470,395,346,199,532.95625,127.15625,92.10000000000001,18.025000000000002,917.6,728.9000000000001,711.45625,229.45624999999998,10
390,Nikola Jovic,Miami Heat,F,79,210,29,64,452.7,6,7,250.0,15,41,361.6,2,34,36,18,21,8,10,4,44,133,115,97,54,87.71330589849109,62.927297668038406,20.52400548696845,11.271604938271604,262.4540466392318,204.53086419753086,116.75308641975309,112.33470507544583,10
391,Nikola Vucevic,Chicago Bulls,C,189,341,81,153,538.5,15,19,525.0,12,38,278.3,24,76,100,33,21,5,21,8,-50,322,289,222,133,546.0206611570248,164.51652892561984,32.53719008264463,9.691115702479339,759.1404958677687,759.7438016528926,560.3677685950413,182.10330578512395,10
392,Noah Clowney,Brooklyn Nets,F,20,76,8,18,132.9,0,2,0.0,2,9,58.3,5,12,17,6,2,3,2,1,10,43,37,26,23,71.61250000000001,25.0,4.9125000000000005,1.2125,161.65,171.7125,65.25,26.212500000000006,5
393,Norman Powell,LA Clippers,G,172,286,59,117,498.3,28,33,725.0,26,66,428.6,4,25,29,11,23,8,11,2,-20,212,201,183,40,381.50865051903116,33.871972318339104,11.27681660899654,18.652249134948097,455.7162629757786,496.56401384083046,333.67128027681656,52.13840830449826,10
394,O.G. Anunoby,New York Knicks,SF,83,194,33,70,262.7,9,14,243.3,8,28,138.3,3,24,27,12,12,16,13,5,107,122,110,95,39,431.93491124260356,55.0,6.0,8.757396449704142,260.7810650887574,260.7810650887574,441.9349112426035,51.0,6
395,Obi Toppin,Indiana Pacers,PF,80,188,32,55,558.1,7,9,350.0,9,24,343.3,10,33,43,12,15,5,6,4,26,135,123,92,55,164.18595041322314,37.293388429752056,13.691115702479339,9.111570247933884,288.629132231405,304.53719008264466,148.13739669421489,51.125,10
396,Ochai Agbaji,Toronto Raptors,G,83,291,35,85,372.3,7,14,275.0,6,28,178.3,20,23,43,17,23,12,12,5,-102,143,126,100,60,160.65625,67.325,26.606250000000003,4.625,417.72499999999997,350.90625,202.10000000000002,119.30625,10
397,Olivier Sarr,Oklahoma City Thunder,C,11,22,4,7,125.0,3,5,116.7,0,1,0.0,4,4,8,0,3,0,1,1,-14,19,19,11,8,34.92,6.920000000000002,0.0,0.0,59.68000000000001,59.68000000000001,34.92,6.920000000000002,3
398,OlivierMaxence Prosper,Dallas Mavericks,F,10,36,3,6,150.0,4,7,57.1,0,2,0.0,2,6,8,0,1,1,1,1,-14,18,18,10,8,30.560000000000002,15.111111111111114,0.0,0.0,87.80444444444444,87.80444444444444,30.560000000000002,15.111111111111114,4
399,Omer Yurtseven,Utah Jazz,C,43,86,19,28,326.1,4,7,200.0,1,3,50.0,12,15,27,5,10,1,3,6,-14,75,70,48,32,143.65020576131687,24.19341563786008,9.5761316872428,0.8518518518518519,255.6255144032922,204.74074074074073,184.45267489711935,43.851851851851855,6
400,Onuralp Bitim,Chicago Bulls,SF,50,153,22,45,454.4,0,0,0.0,6,21,166.7,5,12,17,9,14,2,3,1,-38,76,67,59,26,245.166015625,52.181640625,4.947265625,6.6640625,482.775390625,450.7890625,263.125,71.15625,10
401,Onyeka Okongwu,Atlanta Hawks,PF,147,296,61,89,703.8000000000001,16,22,492.9,9,19,466.6,32,44,76,11,28,7,5,15,4,234,223,158,87,308.4240362811791,185.95918367346937,9.244897959183675,5.6893424036281175,807.5192743764171,822.7913832199548,307.3560090702948,181.0,10
402,Orlando Robinson,Miami Heat,C,13,59,4,11,108.3,4,5,175.0,1,2,100.0,8,9,17,5,4,1,3,0,4,35,30,18,22,48.835,19.235,3.0,0.8400000000000002,71.24000000000001,58.64,66.13499999999999,17.535,6
403,Oscar Tshiebwe,Indiana Pacers,C,3,5,1,3,33.3,1,2,50.0,0,0,0.0,2,0,2,0,1,0,0,1,8,5,5,3,2,0.25,0.0,0.0,0.0,0.25,0.25,0.25,0.0,1
404,Oshae Brissett,Boston Celtics,SF,46,179,15,33,477.2,12,23,288.3,4,12,283.3,16,24,40,15,13,3,4,2,61,101,86,61,55,110.24489795918367,60.41632653061224,22.2734693877551,2.4081632653061225,327.2448979591837,230.4,191.4,98.37959183673469,10
405,Ousmane Dieng,Oklahoma City Thunder,F,28,90,10,25,324.4,4,4,200.0,4,14,220.0,1,7,8,14,3,3,6,3,16,50,36,42,22,122.49704142011836,6.0,21.124260355029588,4.295857988165681,242.1183431952663,164.49704142011836,196.11834319526628,31.124260355029584,8
406,P.J. Tucker,LA Clippers,PF,19,147,7,19,183.3,0,0,0.0,5,12,283.4,7,21,28,4,12,4,4,4,-22,51,47,23,32,64.40642722117201,41.523629489603024,4.232514177693762,4.686200378071835,174.74102079395087,135.7069943289225,86.0,63.196597353497154,9
407,P.J. Washington,Dallas Mavericks,PF,95,321,36,94,397.0,11,16,400.0,12,52,223.3,13,47,60,12,18,11,5,10,40,167,155,107,72,235.4297520661157,54.046487603305785,10.137396694214877,13.607438016528924,340.71900826446284,272.05061983471074,278.41425619834706,89.86776859504133,10
408,Paolo Banchero,Orlando Magic,PF,211,350,79,158,557.2,37,48,653.9,16,41,483.0,6,55,61,63,21,7,34,7,34,335,272,274,124,178.08033240997227,71.2590027700831,82.4016620498615,8.759002770083102,413.15373961218836,316.35041551246536,248.82548476454298,179.71883656509695,10
409,Pascal Siakam,Indiana Pacers,PF,243,319,99,179,556.2,39,58,646.8,6,19,216.6,23,71,94,31,21,10,14,4,66,368,337,274,125,359.42561983471074,128.78202479338842,24.389462809917354,5.22004132231405,517.2396694214876,483.7778925619835,346.5836776859504,199.47520661157023,10
410,Pat Connaughton,Milwaukee Bucks,SG,75,227,26,53,493.5,11,13,525.0,12,32,401.0,7,20,27,17,9,2,5,2,9,119,102,92,44,192.78512396694214,32.125,21.455578512396695,12.731404958677686,276.8677685950413,306.22830578512395,174.8564049586777,42.14876033057851,10
411,Patrick Baldwin Jr.,Washington Wizards,F,44,158,16,50,325.9,5,7,260.0,7,30,171.9,5,34,39,13,11,8,7,7,-39,96,83,57,52,134.43265306122447,59.35918367346939,18.102040816326532,6.346938775510203,314.60408163265305,210.3469387755102,194.15102040816325,122.0,10
412,Patrick Beverley,Milwaukee Bucks,PG,44,212,13,45,231.7,10,13,483.4,8,26,242.89999999999998,3,26,29,18,22,9,7,8,-9,91,73,62,47,146.3926446727961,63.64034613304489,32.84586262844781,9.67009194159005,345.4023796646836,285.13845321795566,198.82747431043805,104.31530557057869,10
413,Patrick Williams,Chicago Bulls,PF,6,24,2,9,22.2,2,2,100.0,0,5,0.0,0,6,6,2,5,0,2,2,-11,14,12,8,8,0.0,0.0,0.0,0.0,0.0,0.0,0.0,0.0,1
414,Patty Mills,Atlanta Hawks,PG,0,10,0,2,0.0,0,0,0.0,0,1,0.0,0,2,2,1,0,1,0,0,2,3,2,1,3,17.316337148803328,0.5036420395421437,0.6503642039542142,0.3756503642039542,18.131113423517167,11.913631633714878,24.678459937565037,0.00936524453694067,1
415,Patty Mills,Miami Heat,PG,50,150,19,60,253.60000000000002,4,4,200.0,8,40,172.5,4,10,14,17,12,8,6,0,45,81,64,67,31,187.71800208116548,6.855359001040583,16.950052029136316,9.574401664932363,231.30905306971906,219.67429760665976,197.84807492195628,25.31009365244537,9
416,Paul George,LA Clippers,F,247,356,89,160,566.9,34,35,680.0,35,75,477.1,2,43,45,39,23,16,20,12,39,331,292,286,84,153.39012345679015,29.53827160493827,63.55308641975309,14.708641975308641,296.3827160493827,180.9777777777778,259.441975308642,102.44444444444444,10
417,Paul Reed,Philadelphia 76ers,SF,88,237,34,73,475.2,15,20,600.0,5,14,200.0,32,43,75,15,25,13,12,16,10,178,163,103,90,230.60479855138072,23.451788139429606,10.52829334540516,6.754640108646446,374.1023087369851,369.9117247623359,228.12358533272976,40.6518786781349,10
418,Payton Pritchard,Boston Celtics,PG,140,301,54,112,481.3,7,9,300.0,25,60,453.0,9,29,38,58,12,4,9,0,101,236,178,198,96,323.37603305785126,42.1456611570248,154.61673553719007,22.505165289256198,806.2314049586777,368.82334710743805,706.0712809917356,251.4752066115703,10
419,Peyton Watson,Denver Nuggets,F,68,184,28,65,413.4,9,13,400.0,3,18,225.0,6,34,40,8,21,5,6,10,21,116,108,76,48,134.79855371900825,49.9710743801653,7.640495867768594,2.174586776859504,314.228305785124,271.5919421487603,164.41838842975207,70.62809917355372,10
420,Precious Achiuwa,New York Knicks,PF,81,243,33,61,531.7,11,19,425.0,4,10,183.3,26,56,82,19,18,8,14,15,20,182,163,100,101,245.65028355387523,151.16540642722117,16.927221172022687,4.454631379962192,610.8090737240075,584.5831758034027,277.0633270321361,162.9054820415879,10
421,Quentin Grimes,Detroit Pistons,SG,82,213,26,80,296.2,19,24,525.0,11,50,200.0,2,27,29,19,13,7,9,4,-12,130,111,101,48,312.44628099173553,35.19834710743802,14.900826446280991,10.900826446280991,442.06611570247935,483.0495867768595,277.6942148760331,43.86776859504132,10
422,R. Rupert,Portland Trail Blazers,G,45,177,16,36,435.6,6,7,350.0,7,17,200.0,6,20,26,17,19,2,9,1,-3,88,71,62,43,170.36940686784598,32.61810613943809,24.567117585848074,15.778355879292402,326.38085327783557,329.3433922996878,171.77107180020812,52.8210197710718,10
423,RJ Barrett,Toronto Raptors,SG,208,328,85,152,559.5,20,43,406.1,18,37,425.0,9,42,51,46,22,5,28,4,-39,305,259,254,97,255.64444444444445,58.24444444444445,50.577777777777776,15.777777777777777,454.77777777777777,307.8,398.8,112.64444444444445,10
424,Reggie Bullock,Houston Rockets,SF,32,135,11,24,533.2,0,0,0.0,10,22,549.9,3,27,30,2,7,5,2,1,17,64,62,34,32,30.90625,48.15625,1.666015625,4.3515625,114.228515625,122.5,24.837890625,47.619140625,10
425,Reggie Jackson,Denver Nuggets,PG,87,164,31,75,390.3,15,18,272.7,10,27,368.4,2,7,9,34,10,4,13,2,47,130,96,121,43,355.41322314049586,8.648760330578511,50.45971074380165,6.418388429752066,453.228305785124,310.56611570247935,488.6291322314049,68.55475206611571,10
426,Richaun Holmes,Washington Wizards,F,90,236,36,64,549.7,18,21,591.7,0,2,0.0,32,52,84,9,31,7,8,9,3,183,174,99,93,268.51862673484294,278.2980277574872,7.035062089116143,0.007304601899196495,963.7143900657414,894.6676406135866,302.88312636961285,320.01533966398836,10
427,Ricky IV Council,Philadelphia 76ers,G,64,102,21,46,431.6,18,24,533.3,4,15,158.3,2,12,14,7,5,0,3,1,-9,85,78,71,21,267.35207100591714,20.713017751479292,6.100591715976331,5.044378698224852,476.94082840236683,402.2130177514793,331.70710059171597,37.18639053254438,10
428,Robin Lopez,Milwaukee Bucks,C,6,23,3,9,37.5,0,0,0.0,0,2,0.0,1,0,1,1,3,1,0,2,-16,8,7,7,2,21.92,0.52,0.6800000000000002,0.0,24.48,29.0,18.28,0.32000000000000006,2
429,Royce O'Neale,Phoenix Suns,PF,68,225,27,63,453.8,0,0,0.0,14,43,375.1,6,40,46,24,13,3,8,4,24,138,114,92,70,321.53086419753083,18.71604938271605,32.89382716049383,25.530864197530867,395.1012345679013,382.4444444444445,303.7777777777777,82.01975308641975,10
430,Rudy Gobert,Minnesota Timberwolves,C,133,371,54,85,636.7,25,37,605.0,0,1,0.0,42,100,142,14,35,7,18,25,24,289,275,147,156,298.125,82.70408163265307,12.418367346938775,0.0,433.125,460.61479591836735,257.7576530612245,108.0,10
431,Rui Hachimura,Los Angeles Lakers,PF,160,300,67,115,573.8,10,14,333.3,16,37,420.0,4,31,35,14,17,2,6,3,-11,209,195,174,49,404.28316478286735,32.998810232004764,6.925639500297443,11.068411659726353,350.58001189768,369.2498512790006,388.68887566924445,36.84889946460441,10
432,Russell Westbrook,LA Clippers,PG,94,208,36,98,379.9,18,24,556.7,4,26,95.0,10,16,26,33,17,11,14,0,-9,153,120,127,59,204.2530864197531,23.611111111111107,46.382716049382715,4.6419753086419755,431.12345679012344,316.5679012345679,282.99382716049377,105.80864197530865,10
433,Ryan Arcidiacono,New York Knicks,G,0,5,0,1,0.0,0,0,0.0,0,1,0.0,0,0,0,0,1,1,0,0,3,0,0,0,0,0.0,0.0625,0.0,0.0,0.0625,0.0625,0.0,0.0625,1
434,Saben Lee,Phoenix Suns,G,35,98,9,28,194.29999999999998,15,20,416.7,2,9,83.3,3,15,18,17,6,4,2,0,11,70,53,52,35,190.68,24.479999999999997,5.720000000000001,1.5200000000000005,336.32,336.0,189.68,31.519999999999996,8
435,Saddiq Bey,Atlanta Hawks,SF,146,337,48,125,372.4,31,35,800.0,19,59,298.4,29,32,61,14,7,4,10,4,-23,221,207,160,75,398.90000000000003,67.125,9.625,14.9,439.4000000000001,478.32500000000005,362.225,74.5,10
436,Sam Hauser,Boston Celtics,SF,131,237,46,91,496.3,0,0,0.0,39,78,482.20000000000005,4,34,38,9,8,11,2,7,85,178,169,140,47,762.841049382716,32.06944444444444,4.915123456790123,79.125,939.4027777777777,918.0308641975308,776.4444444444443,44.75308641975309,10
437,Sam Merrill,Cleveland Cavaliers,SG,86,244,26,74,341.3,9,9,500.0,25,71,339.9,3,20,23,28,13,2,5,3,10,137,109,114,51,186.4424012979989,48.11952406706327,83.27744726879394,22.501352082206598,365.54407787993506,299.019469983775,255.10113574905355,129.2628447809627,10
438,Samardo Samuels,Houston Rockets,F,0,6,0,1,0.0,0,0,0.0,0,0,0.0,1,1,2,0,0,0,0,0,-5,2,2,0,2,1.44,1.9599999999999997,0.0,0.0,0.03999999999999998,0.03999999999999998,1.44,1.9599999999999997,1
439,Sandro Mamukelashvili,San Antonio Spurs,PF,31,55,15,23,368.1,0,1,0.0,1,4,50.0,9,5,14,5,5,2,1,0,27,50,45,36,19,107.37024221453287,14.387543252595158,7.539792387543252,0.8650519031141868,189.08304498269896,158.13840830449828,123.89965397923876,36.34256055363321,7
440,Santi Aldama,Memphis Grizzlies,PF,137,333,50,105,484.3,15,22,550.0,22,58,347.0,12,58,70,31,11,10,10,16,-81,238,207,168,101,327.3083900226757,76.36281179138322,32.95804988662132,28.808390022675738,549.7335600907029,454.9954648526077,428.3367346938776,103.03061224489795,10
441,Sasha Vezenkov,Sacramento Kings,F,9,22,2,7,28.6,3,3,100.0,2,4,50.0,0,1,1,1,4,1,0,0,24,11,10,10,2,4.5,0.5,0.5,2.0,4.5,2.0,8.0,0.0,2
442,Scoot Henderson,Portland Trail Blazers,G,144,279,53,137,385.0,26,30,825.0,12,42,263.3,7,29,36,54,37,12,35,1,-86,234,180,198,90,340.9244497323022,42.47709696609161,48.92563950029744,7.737061273051755,702.7436049970256,441.71921475312314,554.3462224866151,139.0053539559786,10
443,Scottie Barnes,Toronto Raptors,SF,179,333,70,155,460.1,33,39,674.9,6,36,159.89999999999998,28,63,91,75,18,13,31,14,21,345,270,254,166,391.6640625,102.8515625,85.6640625,4.8515625,827.2890625,587.40625,576.65625,243.40625,10
444,Scotty Pippen Jr.,Memphis Grizzlies,G,125,252,42,83,488.7,23,34,490.4,18,33,605.0,10,25,35,51,28,14,25,5,-15,211,160,176,86,242.51111111111112,20.511111111111113,40.91111111111111,8.0,268.9111111111111,291.6,212.84444444444443,68.4,10
445,Seth Curry,Charlotte Hornets,SG,81,181,29,67,372.5,14,15,566.7,9,31,256.6,4,15,19,17,7,5,7,3,-33,117,100,98,36,233.0,12.900826446280993,16.140495867768593,4.900826446280991,334.3388429752066,276.08264462809916,269.8677685950413,50.429752066115704,10
446,Shai Gilgeous-Alexander,Oklahoma City Thunder,PG,264,334,94,188,496.0,62,76,803.5,14,46,284.3,8,48,56,51,24,20,29,9,49,371,320,315,107,624.9638429752066,71.09504132231405,37.414256198347104,18.41012396694215,940.3553719008266,730.7737603305786,832.8801652892562,110.17458677685951,10
447,Shake Milton,New York Knicks,SG,40,110,17,39,321.1,2,3,66.7,4,11,150.0,9,13,22,12,8,3,5,2,-21,74,62,52,34,133.17355371900825,78.08264462809917,17.338842975206614,8.148760330578511,486.7933884297521,382.0,194.2479338842975,139.14049586776858,8
448,Simone Fontecchio,Detroit Pistons,F,158,307,55,116,455.5,19,21,616.7,29,65,413.2,8,41,49,16,20,10,13,5,5,223,207,174,65,506.0,36.90963139120095,14.430439952437576,30.11296076099881,589.4708680142687,547.3923900118907,538.8442330558859,60.574316290130795,10
449,Skylar Mays,Los Angeles Lakers,SG,8,34,4,10,170.0,0,0,0.0,0,3,0.0,0,1,1,3,2,3,2,1,-3,12,9,11,4,12.0,0.75,2.890625,0.0,7.640625,12.75,8.390625,2.140625,4
450,Spencer Dinwiddie,Los Angeles Lakers,PG,65,238,19,44,385.2,16,19,438.9,11,24,416.7,1,13,14,22,17,3,8,6,36,101,79,87,36,535.8823142669296,4.539119000657462,26.0,8.928994082840237,706.0059171597633,561.5443786982248,679.8310322156476,31.051939513477976,10
451,Stanley Umude,Detroit Pistons,G,49,150,16,39,260.4,8,9,366.7,9,25,243.3,5,16,21,3,15,4,4,2,-32,73,70,52,24,177.08,44.0,1.9200000000000002,10.88,278.68,272.78,180.88,48.02,8
452,Stephen Curry,Golden State Warriors,PG,232,295,80,195,408.0,26,28,655.0,46,123,372.8,11,46,57,37,7,3,21,1,32,326,289,269,94,844.0086533261223,112.07193077339103,37.5949161709032,49.49053542455381,1506.2282314764736,1314.2287723093564,1028.0903190914007,157.58464034613303,10
453,Svi Mykhailiuk,Boston Celtics,SG,52,135,18,43,560.4,1,1,100.0,15,37,413.3,2,15,17,14,2,4,2,0,77,83,69,66,31,54.74435196195006,26.12009512485137,13.495838287752676,8.859690844233056,206.04875148632578,136.70749108204518,109.38882282996433,54.312722948870395,10
454,T. Vukcevic,Washington Wizards,PF,6,9,2,5,40.0,0,0,0.0,2,4,50.0,0,3,3,0,2,0,1,0,-5,9,9,6,3,20.25,2.25,0.0,2.25,36.0,36.0,20.25,2.25,1
455,T.J. McConnell,Indiana Pacers,PG,131,197,59,112,527.1,7,9,250.0,6,12,450.0,4,24,28,45,7,13,20,2,40,204,159,176,73,124.94883997620464,29.60023795359905,43.5116002379536,2.52587745389649,352.41403926234386,236.85127900059487,238.45806067816778,75.16537775133848,10
456,T.J. Warren,Minnesota Timberwolves,SF,29,98,13,34,301.2,1,2,50.0,2,11,83.3,5,11,16,7,10,3,4,1,31,52,45,36,23,31.317500000000003,13.520000000000001,6.28,1.4299999999999997,32.2575,45.3175,13.9375,24.12,7
457,Taj Gibson,Detroit Pistons,F,3,11,1,2,50.0,0,0,0.0,1,2,50.0,0,2,2,0,1,1,0,0,-3,5,5,3,2,2.5600000000000005,0.03999999999999998,0.16000000000000003,0.36,1.9599999999999997,3.2399999999999993,1.44,0.04000000000000007,1
458,Taj Gibson,New York Knicks,F,2,68,0,9,0.0,2,2,100.0,0,2,0.0,4,6,10,4,8,1,3,0,2,16,12,6,14,8.2,10.200000000000001,1.6,0.8000000000000002,15.600000000000001,12.400000000000002,6.6000000000000005,16.599999999999998,5
459,Talen Horton-Tucker,Utah Jazz,SG,64,154,19,65,304.2,16,18,566.7,10,30,384.9,3,17,20,23,12,6,3,5,-48,107,84,87,43,48.12071330589849,52.87791495198902,31.444444444444446,2.0548696844993137,214.45404663923182,140.54046639231825,112.20713305898491,94.14951989026062,10
460,Taurean Prince,Los Angeles Lakers,PF,75,188,29,57,547.7,2,3,100.0,15,35,408.70000000000005,2,28,30,10,13,3,4,7,11,115,105,85,40,154.88458728999268,34.06574141709277,13.051862673484296,14.545653761869978,261.8970051132213,258.0241051862673,154.23155588020452,51.643535427319215,10
461,Taylor Hendricks,Utah Jazz,F,86,258,31,68,495.0,11,13,425.0,13,39,346.9,14,52,66,7,31,4,5,13,-94,159,152,93,73,101.06509695290859,115.91689750692521,2.189750692520776,6.1024930747922435,264.4072022160665,239.79085872576178,121.34349030470914,122.44459833795014,10
462,Taze Moore,Portland Trail Blazers,G,2,5,1,1,100.0,0,0,0.0,0,0,0.0,0,0,0,1,0,0,1,0,7,3,2,3,1,1.44,0.0,0.6400000000000001,0.0,4.0,1.44,4.0,0.6400000000000001,1
463,Terance Mann,LA Clippers,SG,105,267,37,74,515.3,16,17,650.0,15,33,553.5,6,18,24,9,19,9,4,4,-27,138,129,114,33,223.82231404958677,22.418388429752067,17.491735537190085,5.992768595041323,302.4349173553719,213.72830578512398,314.61157024793386,37.82747933884296,10
464,Terquavion Smith,Philadelphia 76ers,G,40,59,14,34,241.1,2,3,100.0,10,26,216.6,0,2,2,10,3,7,4,0,9,52,42,50,12,186.96296296296296,1.4074074074074074,17.185185185185183,17.185185185185183,177.40740740740742,184.66666666666663,179.62962962962965,18.666666666666668,6
465,Terry Rozier,Miami Heat,SG,177,341,70,160,437.9,18,21,572.7,19,54,305.4,6,45,51,43,17,10,11,2,1,271,228,220,94,212.19395134779745,26.170282708744246,100.1715976331361,36.907955292570676,482.1860618014464,277.42669296515453,404.1564760026298,139.1387245233399,10
466,Terry Taylor,Chicago Bulls,F,11,46,4,8,275.0,1,2,50.0,2,3,150.0,2,10,12,3,1,1,0,0,-17,26,23,14,15,13.702947845804989,31.560090702947843,3.2947845804988662,1.6553287981859413,100.86621315192743,79.0,21.383219954648524,49.04081632653062,4
467,Thaddeus Young,Phoenix Suns,F,10,35,5,10,150.0,0,2,0.0,0,0,0.0,8,4,12,2,4,2,2,0,1,24,22,12,14,3.1875,29.467499999999994,3.87,0.0,8.27,13.279999999999998,11.307499999999997,20.2075,3
468,Thaddeus Young,Phoenix Suns,PF,53,152,26,34,569.9,1,5,50.0,0,2,0.0,15,20,35,18,15,3,4,2,-39,106,88,71,53,241.9375,60.6575,39.03000000000001,0.0,746.63,466.32,452.4174999999999,169.5175,7
469,Thanasis Antetokounmpo,Milwaukee Bucks,SF,10,48,5,11,266.7,0,2,0.0,0,1,0.0,2,1,3,4,8,1,3,1,-18,17,13,14,7,14.0,1.530612244897959,1.673469387755102,0.0,20.55102040816326,18.10204081632653,16.24489795918367,3.408163265306122,6
470,Theo Maledon,Phoenix Suns,PG,5,10,1,2,50.0,3,3,100.0,0,0,0.0,0,1,1,0,3,0,3,0,-11,6,6,5,1,14.0625,0.5625,0.0,0.0,20.25,20.25,14.0625,0.5625,1
471,Thomas Bryant,Miami Heat,C,70,132,24,43,496.9,19,21,725.0,3,13,200.0,9,32,41,8,16,2,1,7,16,119,111,78,49,186.05486968449932,73.04938271604938,9.890260631001372,4.3086419753086425,383.0493827160494,344.923182441701,226.19753086419752,80.92318244170096,10
472,Tim Hardaway Jr.,Dallas Mavericks,SF,85,193,29,82,289.3,9,14,350.0,18,52,282.2,2,18,20,19,7,8,5,0,42,124,105,104,39,497.18285123966945,67.45867768595042,18.001033057851238,27.674586776859503,907.8223140495868,798.7365702479339,594.0,97.72830578512396,10
473,Tobias Harris,Philadelphia 76ers,PF,155,343,64,149,402.7,17,24,593.3,10,40,225.0,11,63,74,25,13,11,15,5,-35,254,229,180,99,541.9964328180738,112.77288941736029,22.141498216409037,10.42806183115339,781.6646848989299,673.9060642092746,630.0856123662306,154.58382877526753,10
474,Torrey Craig,Chicago Bulls,SF,64,198,23,53,384.9,2,4,100.0,16,39,353.8,7,20,27,15,19,6,8,3,-65,106,91,79,42,174.51239669421489,29.874196510560147,8.557392102846649,16.64830119375574,344.752984389348,321.3728191000918,202.25436179981637,34.06978879706153,10
475,Tosan Evbuomwan,Detroit Pistons,F,60,198,22,48,516.6,9,14,241.7,7,20,373.3,11,27,38,7,16,2,6,2,-103,105,98,67,45,210.06944444444446,141.7777777777778,10.5,6.277777777777778,508.2361111111111,458.06944444444446,206.90277777777777,205.6111111111111,10
476,Toumani Camara,Portland Trail Blazers,F,86,294,33,68,479.4,11,12,450.0,9,26,311.6,23,24,47,24,27,8,12,8,-28,157,133,110,71,272.60474802165766,70.26530612244898,32.71970012494794,4.970012494793836,680.5735110370679,543.5347771761766,378.00499791753435,134.6234902124115,10
477,Trae Young,Atlanta Hawks,PG,235,370,76,173,432.4,45,55,813.4,38,93,399.0,2,18,20,109,22,11,45,2,-38,364,255,344,129,758.2361111111111,12.069444444444445,83.0,45.06944444444444,786.5,622.5,926.4027777777778,90.90277777777777,10
478,Trayce JacksonDavis,Golden State Warriors,F,114,239,51,65,797.1,12,26,495.0,0,0,0.0,24,43,67,18,19,7,7,19,4,199,181,132,85,156.44444444444446,74.23456790123457,26.09382716049383,0.0,399.77530864197524,332.2938271604939,205.841975308642,118.41234567901236,10
479,Tre Jones,San Antonio Spurs,PG,108,301,40,72,561.9,17,19,558.3,11,23,237.1,8,34,42,74,11,13,13,0,1,224,150,182,116,540.4101239669421,28.202479338842974,70.0,25.376033057851238,512.7654958677685,521.8564049586777,498.95557851239676,130.56611570247932,10
480,Tre Mann,Charlotte Hornets,PG,117,320,47,102,469.1,11,17,317.1,12,36,301.7,8,43,51,50,15,15,14,0,-83,218,168,167,101,189.69916765755053,28.900118906064208,50.19024970273484,8.057074910820452,355.5148632580262,311.2508917954816,255.95362663495834,57.09988109393579,10
481,Trendon Watford,Brooklyn Nets,PF,67,123,22,51,430.0,19,23,495.7,4,12,150.0,12,20,32,1,18,2,13,4,-24,100,99,68,33,365.9463667820069,76.0,1.5397923875432526,4.5121107266435985,630.6591695501731,637.3581314878893,371.7179930795848,65.06920415224913,10
482,Trent Forrest,Atlanta Hawks,G,24,131,11,26,348.3,2,2,100.0,0,2,0.0,4,12,16,32,5,3,5,2,-18,72,40,56,48,47.38775510204081,12.8,80.0,0.0,162.41632653061225,56.64489795918367,152.75918367346938,93.2,10
483,Trevelin Queen,Orlando Magic,SG,0,13,0,3,0.0,0,0,0.0,0,2,0.0,0,1,1,1,1,0,0,0,-17,2,1,1,2,0.0,0.5555555555555556,0.5555555555555556,0.0,0.22222222222222227,0.5555555555555556,0.5555555555555556,0.22222222222222227,2
484,Trey Jemison,Memphis Grizzlies,C,82,232,36,58,546.0,10,12,500.0,0,0,0.0,27,24,51,11,29,3,15,7,-11,144,133,93,62,473.3246135552913,22.29607609988109,6.95243757431629,0.0,545.0725326991678,606.4506539833532,414.9904875148632,26.204518430439958,10
485,Trey Lyles,Sacramento Kings,PF,53,186,18,46,392.9,12,16,625.0,5,22,236.7,11,28,39,8,19,0,7,3,1,100,92,61,47,103.99173553719008,15.06198347107438,7.640495867768594,7.148760330578514,183.88429752066114,131.55785123966942,140.88016528925618,38.14049586776859,10
486,Trey Murphy III,New Orleans Pelicans,SG,170,303,55,122,437.1,25,30,810.7,35,88,374.2,8,48,56,26,8,5,10,6,72,252,226,196,82,722.4444444444446,55.23456790123457,18.893827160493828,80.23456790123457,764.5086419753087,815.1604938271605,661.7086419753086,84.21234567901234,10
487,Tristan Thompson,Cleveland Cavaliers,C,18,63,8,13,258.4,2,6,100.0,0,0,0.0,10,13,23,6,8,3,4,3,-11,47,41,24,29,26.177285318559555,9.202216066481995,0.8005540166204986,0.0,38.22437673130194,41.87257617728532,23.73130193905817,8.800554016620499,5
488,Troy Brown Jr.,Detroit Pistons,SF,40,153,14,46,298.3,6,7,180.0,6,25,183.2,4,28,32,9,7,1,6,0,-64,81,72,49,41,60.4,43.376000000000005,9.0,4.4,210.296,174.816,93.0,55.25600000000001,10
489,TyTy Washington Jr.,Milwaukee Bucks,G,0,8,0,2,0.0,0,0,0.0,0,1,0.0,0,0,0,1,0,0,0,0,-4,1,0,1,1,0.0,0.0,0.44444444444444453,0.0,0.44444444444444453,0.0,0.44444444444444453,0.44444444444444453,1
490,Tyler Herro,Miami Heat,PG,183,325,71,166,433.4,10,13,333.4,31,80,406.0,3,46,49,50,11,0,13,1,35,282,232,233,99,148.11111111111111,40.94444444444444,28.069444444444443,12.944444444444445,309.7361111111111,207.61111111111111,206.125,113.125,10
491,Tyrese Haliburton,Indiana Pacers,PG,185,338,69,146,477.4,26,29,705.0,21,69,300.79999999999995,2,40,42,102,15,18,27,8,45,329,227,287,144,199.72499999999997,42.5,84.15624999999999,25.0,255.5562500000001,136.125,364.40625,81.40624999999999,10
492,Tyrese Maxey,Philadelphia 76ers,PG,250,371,88,197,449.1,45,51,766.7,29,74,381.4,4,27,31,48,22,8,16,3,10,329,281,298,79,586.4207758053911,51.5706771860618,52.44444444444444,29.710059171597635,912.3477975016436,876.9289940828402,576.6771860618014,149.1775147928994,10
493,Tyus Jones,Washington Wizards,PG,91,313,36,84,402.0,4,4,300.0,15,43,360.8,3,22,25,97,4,9,13,2,-70,213,116,188,122,345.04336734693874,43.53316326530612,160.5,20.959183673469386,776.265306122449,542.0510204081633,542.9719387755102,240.3188775510204,10
494,Udoka Azubuike,Phoenix Suns,C,2,11,1,3,33.3,0,2,0.0,0,0,0.0,2,4,6,0,1,0,0,0,-3,8,8,2,6,1.7777777777777781,13.444444444444443,0.0,0.0,25.0,25.0,1.7777777777777781,13.444444444444443,1
495,Vasilije Micic,Charlotte Hornets,G,145,307,55,107,502.6,22,24,777.8,13,38,280.0,6,21,27,50,14,7,28,3,-82,222,172,195,77,550.6,40.60625,69.30625,24.85625,690.5,577.7562500000001,617.5562500000001,155.70000000000002,10
496,Victor Wembanyama,San Antonio Spurs,C,215,311,76,163,466.70000000000005,42,58,702.8,21,62,357.6,27,89,116,46,23,10,41,42,37,377,331,261,162,774.3367346938776,94.48979591836735,31.11111111111111,20.98979591836735,1531.3798185941043,1274.7448979591836,987.7335600907029,168.8390022675737,10
497,Vince Williams Jr.,Memphis Grizzlies,G,127,336,42,92,459.70000000000005,30,38,723.3,13,34,328.8,8,54,62,61,30,12,34,9,-54,250,189,188,123,231.93628808864267,72.8808864265928,35.61495844875347,18.00831024930748,492.2326869806094,474.07479224376726,226.76454293628805,131.82548476454295,10
498,Vit Krejci,Atlanta Hawks,G,65,256,24,51,409.7,4,5,150.0,13,32,310.4,4,15,19,26,23,7,9,4,27,110,84,91,45,167.42333333333335,29.556666666666672,14.026666666666667,15.743333333333334,284.0933333333333,297.0,152.81,45.290000000000006,9
499,Walker Kessler,Utah Jazz,C,80,252,36,51,772.5,8,10,400.0,0,0,0.0,31,63,94,10,16,3,9,12,-101,184,174,90,104,154.38279773156899,69.36105860113423,6.118147448015123,0.0,254.66162570888469,242.5,152.07561436672967,89.94801512287334,10
500,Wendell Carter Jr.,Orlando Magic,C,109,265,40,80,502.6,18,26,516.7,11,36,306.7,29,56,85,24,16,9,16,7,26,218,194,133,109,203.44444444444446,106.75147928994085,8.779750164365549,6.955292570677186,325.8724523339908,323.8369493754109,229.9335963182117,91.07758053911897,10
501,Wendell Moore Jr.,Minnesota Timberwolves,G,2,5,1,1,100.0,0,0,0.0,0,0,0.0,0,2,2,0,1,0,0,0,8,4,4,2,2,2.777777777777778,3.0625,0.006944444444444444,0.0,11.111111111111112,11.67361111111111,2.506944444444444,2.777777777777778,1
502,Wenyen Gabriel,Memphis Grizzlies,F,17,81,8,22,168.3,0,5,0.0,1,6,50.0,7,18,25,3,10,2,8,2,-16,45,42,20,28,58.72781065088757,41.28550295857988,4.031065088757396,0.8757396449704142,174.85798816568047,165.25,59.20266272189348,54.44970414201183,5
503,Wesley Matthews,Atlanta Hawks,SG,48,125,16,32,559.3,2,3,100.0,14,22,641.7,1,18,19,5,7,4,1,6,-25,72,67,53,24,108.68262226847034,34.9105098855359,8.81477627471384,6.5348595213319465,205.63371488033297,206.2424557752341,120.6649323621228,31.13423517169615,10
504,Xavier Moon,LA Clippers,G,2,11,1,6,33.3,0,0,0.0,0,2,0.0,1,1,2,0,1,1,1,0,-20,4,4,2,2,2.967863894139887,2.3780718336483933,0.3062381852551985,0.0,0.8506616257088842,0.13610586011342138,4.362948960302457,2.003780718336484,2
505,Xavier Tillman,Boston Celtics,F,36,168,15,30,485.0,3,4,150.0,3,15,183.3,10,26,36,10,9,5,3,4,38,82,72,46,46,56.05202913631634,32.72632674297606,6.010405827263267,2.213319458896982,109.43600416233087,119.0468262226847,54.32466181061395,30.85327783558793,10
506,Yuta Watanabe,Memphis Grizzlies,SF,22,97,10,24,250.0,0,2,0.0,2,12,64.3,0,11,11,5,6,5,4,0,-36,38,33,27,16,115.08000000000001,11.27,3.75,1.4800000000000004,136.28,131.43,116.23000000000002,18.72,7
507,Zach Collins,San Antonio Spurs,PF,106,199,40,81,495.1,19,26,541.7,7,15,466.7,17,35,52,17,33,7,20,10,-50,175,158,123,69,317.14243973703435,60.63988312636962,16.371804236669103,6.275383491599708,570.8948137326515,454.72753834916,399.927684441198,110.3937180423667,10
508,Zeke Nnaji,Denver Nuggets,PF,18,100,6,17,350.0,6,8,300.0,0,2,0.0,7,10,17,4,10,2,2,10,-19,39,35,22,21,50.40625,16.277777777777775,7.350694444444445,0.0,130.125,94.18402777777779,73.06944444444443,36.90625,10
509,Ziaire Williams,Memphis Grizzlies,F,103,270,39,94,389.0,13,16,421.4,12,46,213.7,6,38,44,20,15,12,15,0,-39,167,147,123,64,552.1,32.4,24.0,17.599999999999998,788.1,632.1,714.1,50.4,10
510,Zion Williamson,New Orleans Pelicans,PF,247,324,96,150,621.9,55,71,725.9,0,1,0.0,20,58,78,44,21,13,30,11,83,369,325,291,122,838.7966468361276,51.338020551649535,50.729042725797726,0.005408328826392644,957.889129259059,996.7955651703624,824.5424553812873,77.41481882098431,10
