,First Last Name,team,position,points,minutes,fgm,fga,fgp,ftm,fta,ftp,tpm,tpa,tpp,offReb,defReb,totReb,assists,pFouls,steals,turnovers,blocks,plusMinus,Points_Rebounds_Assist,Points_Rebounds,Points_Assist,Rebounds_Assist,points_deviation,totReb_deviation,assists_deviation,tpm_deviation,Points_Rebounds_Assist_deviation,Points_Rebounds_deviation,Points_Assist_deviation,Rebounds_Assist_deviation,count
0,A. Flagler,Oklahoma City Thunder,F,0,6,0,3,0.0,0,0,0.0,0,3,0.0,0,0,0,1,0,0,0,0,0,1,0,1,1,0.0,0.0,0.0,0.0,0.0,0.0,0.0,0.0,1
1,A.J. Green,Milwaukee Bucks,G,52,141,16,40,371.5,7,8,266.7,13,33,339.3,2,15,17,6,9,3,4,0,18,75,69,58,23,277.1456611570248,16.174586776859506,9.47107438016529,24.819214876033055,390.8305785123967,387.49173553719004,280.3192148760331,25.810950413223136,10
2,A.J. Lawson,Dallas Mavericks,G,26,47,11,24,323.3,2,6,100.0,2,8,100.0,2,7,9,3,5,1,0,1,2,38,35,29,12,43.617065556711765,8.298647242455775,2.3423517169614985,1.7710718002081167,67.03433922996877,58.8168574401665,48.05098855359,14.424557752341313,7
3,Aaron Gordon,Denver Nuggets,PF,138,314,54,96,649.8,25,37,646.7,5,17,158.3,24,39,63,44,22,3,17,4,53,245,201,182,107,232.26989619377161,116.08112264513649,51.434063821607076,4.577854671280277,375.961937716263,517.8550557477894,137.63936947327952,120.25259515570934,10
4,Aaron Holiday,Houston Rockets,G,54,144,18,48,303.1,12,12,400.0,6,22,228.3,4,8,12,21,14,5,3,1,21,87,66,75,33,255.70637119113573,11.945829485995691,33.52939365958757,9.606648199445983,437.45429362880895,349.2200677131425,341.4075100030779,48.00831024930748,10
5,Aaron Nesmith,Indiana Pacers,SF,122,316,42,100,431.2,17,17,600.0,21,57,383.7,8,29,37,19,36,6,7,11,67,178,159,141,56,107.60016659725115,12.670137442732194,13.82465639316951,9.229904206580592,110.591420241566,111.48979591836735,97.84964598084132,35.34693877551021,10
6,Aaron Wiggins,Oklahoma City Thunder,SG,70,164,28,44,605.8,6,9,180.0,8,15,275.0,9,13,22,13,4,6,11,5,-3,105,92,83,35,224.1301775147929,13.715976331360945,8.597633136094675,12.0,335.698224852071,342.84023668639054,222.66863905325442,16.633136094674555,10
7,Admiral Schofield,Orlando Magic,SF,5,11,2,4,66.7,0,0,0.0,1,2,100.0,0,2,2,0,1,1,0,0,-11,7,7,5,2,15.131487889273355,0.02768166089965399,0.006920415224913495,0.5847750865051903,15.408304498269898,15.698961937716263,14.868512110726641,0.006920415224913498,2
8,Al Horford,Boston Celtics,C,112,283,41,76,569.3,8,8,400.0,22,45,499.3,14,43,57,23,17,9,9,6,84,192,169,135,80,463.918188458729,79.16946676406135,22.10007304601899,33.61431701972242,562.127100073046,527.45434623813,506.80861943024104,93.05186267348431,10
9,Alec Burks,New York Knicks,SG,71,129,23,72,280.0,14,19,446.4,11,40,257.5,3,15,18,9,2,3,4,0,-8,98,89,80,27,291.6373966942149,21.038223140495866,3.264462809917355,9.09194214876033,498.97520661157023,450.1570247933885,330.61673553719004,34.14152892561983,10
10,Aleksej Pokusevski,Charlotte Hornets,F,66,196,24,55,507.9,12,16,466.7,6,22,283.3,11,30,41,19,9,11,9,6,-56,126,107,85,60,86.40036730945822,29.198347107438014,16.915518824609734,2.405876951331497,222.87603305785123,172.4196510560147,122.52066115702479,60.449954086317724,10
11,Alex Caruso,Chicago Bulls,SG,121,317,42,91,432.5,11,16,375.0,26,56,464.2,8,37,45,49,26,17,16,4,-10,215,166,170,94,324.71900826446284,29.19504132231405,20.88429752066116,22.148760330578515,565.4,414.13884297520656,446.63140495867765,79.42809917355372,10
12,Alex Len,Sacramento Kings,C,35,106,12,17,516.7,11,13,525.0,0,0,0.0,8,16,24,10,15,2,3,11,24,69,59,45,34,68.51479289940829,22.648668639053255,18.44748520710059,0.0,156.9023668639053,121.28476331360946,96.79955621301775,48.428994082840234,10
13,Alondes Williams,Miami Heat,G,0,6,0,1,0.0,0,0,0.0,0,1,0.0,0,1,1,0,0,0,1,0,-2,1,1,0,1,4.591836734693877,0.7346938775510206,0.0,0.0,1.6530612244897955,1.6530612244897955,4.591836734693877,0.7346938775510206,1
14,Alperen Sengun,Houston Rockets,C,209,324,81,157,512.7,43,68,622.9,4,12,200.0,39,68,107,45,36,16,26,7,2,361,316,254,152,847.1723356009071,197.81632653061226,123.77551020408163,4.408163265306122,1935.0226757369614,1622.4580498866212,993.7777777777778,487.5510204081633,10
15,Amari Bailey,Charlotte Hornets,G,2,6,1,3,33.3,0,0,0.0,0,2,0.0,0,0,0,1,0,1,0,0,7,3,2,3,1,2.419753086419753,0.0,0.5216049382716049,0.0,5.188271604938271,2.419753086419753,5.188271604938271,0.5216049382716049,1
16,Amen Thompson,Houston Rockets,F,156,292,64,106,631.1,27,36,579.7,1,5,100.0,41,53,94,28,23,11,15,3,92,278,250,184,122,501.44411414982164,111.2936979785969,35.69322235434007,0.9096313912009513,987.7390011890607,899.2728894173604,509.3489892984542,227.54815695600476,10
17,Amir Coffey,LA Clippers,SG,66,234,24,53,457.5,4,5,250.0,14,34,376.7,4,18,22,16,14,5,7,2,-42,104,88,82,38,108.26404635928446,27.82262534643487,12.400100781053162,12.613252708490805,105.81204333585286,70.97505668934242,155.49155958679768,27.83219954648526,10
18,Andre Drummond,Chicago Bulls,C,90,165,32,57,573.9,26,36,684.2,0,0,0.0,28,61,89,7,13,5,7,6,20,186,179,97,96,162.0,63.80086180363189,8.246537396121884,0.0,352.49430594028934,288.5727916281932,209.82548476454295,88.14342874730687,10
19,Andre Jr. Jackson,Milwaukee Bucks,G,10,69,4,9,333.3,0,0,0.0,2,5,200.0,3,9,12,10,6,3,3,0,-10,32,22,20,22,13.598615916955021,6.3321799307958475,6.4498269896193765,1.6124567474048441,33.01038062283737,30.311418685121104,17.07958477508651,12.0,6
20,Andrew Nembhard,Indiana Pacers,PG,114,294,47,88,538.9,7,9,250.0,13,35,398.3,3,21,24,33,24,8,8,1,30,171,138,147,57,159.0991094513071,34.49008905486929,17.93881068658431,6.193335248491813,386.94829072105716,314.89112324044817,218.37029589198505,65.21488078138465,10
21,Andrew Wiggins,Golden State Warriors,SF,161,289,59,125,477.4,25,33,531.4,18,45,395.0,20,43,63,18,15,6,12,8,36,242,224,179,81,261.3890427823946,36.360418590335485,49.77777777777777,11.734072022160664,543.4016620498614,355.7759310557094,412.5469375192366,122.60603262542321,10
22,Anfernee Simons,Portland Trail Blazers,SG,234,361,80,177,436.7,36,39,757.1,38,94,405.4,4,33,37,64,19,7,30,1,-38,335,271,298,101,935.5240670632775,28.301243915630067,125.20497566252028,19.635478637101134,1764.6960519199567,1205.978907517577,1461.0362358031368,186.71119524067063,10
23,Anthony Black,Orlando Magic,G,47,184,16,46,365.9,6,13,183.3,9,21,308.3,6,21,27,8,11,6,8,3,13,82,74,55,35,105.81632653061224,64.26530612244896,3.6,10.387755102040817,258.54693877551017,233.3469387755102,130.21632653061226,68.66530612244898,10
24,Anthony Davis,Los Angeles Lakers,PF,232,368,90,174,524.8000000000001,45,55,822.4,7,19,237.5,38,113,151,36,21,15,21,19,37,419,383,268,187,628.596,356.504,16.884,8.136000000000001,1732.9360000000001,1660.356,652.064,422.5,10
25,Anthony Edwards,Minnesota Timberwolves,SG,247,371,95,213,440.3,37,49,690.6,20,68,356.1,11,60,71,58,16,14,30,8,18,376,318,305,129,648.4753086419753,78.62071330589849,29.777777777777775,27.086419753086417,930.9190672153634,834.4499314128943,739.4382716049382,113.90466392318244,10
26,Anthony Gill,Washington Wizards,PF,49,125,19,43,371.9,6,6,200.0,5,15,225.0,12,13,25,12,16,6,9,0,-4,86,74,61,37,199.69333333333336,46.693333333333335,17.77777777777778,4.506666666666667,516.9733333333334,405.9955555555556,283.29333333333335,91.84888888888888,9
27,Ashton Hagans,Portland Trail Blazers,G,57,203,20,46,387.7,10,11,450.0,7,16,266.7,8,24,32,39,26,8,24,8,1,128,89,96,71,156.13007284079083,16.0,39.872008324661806,8.17585848074922,318.0,221.54942767950052,244.0,64.45265348595214,10
28,Ausar Thompson,Detroit Pistons,F,103,314,42,87,508.0,11,25,325.0,8,29,195.3,15,44,59,21,26,17,14,11,-6,183,162,124,80,121.7,31.399999999999995,24.125,8.5,347.72499999999997,237.7,200.02499999999998,87.225,10
29,Austin Reaves,Los Angeles Lakers,SG,185,361,62,133,456.9,38,45,850.0,23,67,301.2,7,59,66,62,16,4,23,5,40,313,251,247,128,401.56441326530614,148.89604591836735,67.9719387755102,38.14604591836734,961.9617346938776,772.8367346938776,561.4011479591837,246.15625,10
30,Ayo Dosunmu,Chicago Bulls,SG,187,366,73,138,514.5,22,24,650.0,19,48,348.7,7,25,32,48,25,8,17,5,-57,267,219,235,80,828.612188365651,35.4324407510003,65.68975069252078,26.628808864265928,899.2320714065867,721.1822099107418,1010.6731301939058,97.11111111111111,10
31,Bam Adebayo,Miami Heat,C,172,322,72,126,571.7,19,34,574.9,9,14,550.0,29,96,125,38,15,15,17,11,0,335,297,210,163,289.73677634319034,94.42107455226989,49.815910037484386,5.728029987505206,487.6339025406081,370.46022490628906,415.7017909204498,135.44564764681382,10
32,Ben Sheppard,Indiana Pacers,G,50,186,19,49,365.0,6,6,300.0,6,32,186.6,2,15,17,14,17,5,3,0,26,81,67,64,31,108.3858418367347,20.125,15.15625,3.061224489795918,194.90816326530611,158.70727040816325,154.46173469387756,25.40625,10
33,Ben Simmons,Brooklyn Nets,PG,53,168,24,38,521.1,5,11,150.0,0,0,0.0,15,39,54,46,20,9,12,4,-5,153,107,99,100,134.88888888888889,64.0,78.88888888888889,0.0,382.0,162.8888888888889,300.0,196.88888888888889,9
34,Bennedict Mathurin,Indiana Pacers,SG,139,275,44,115,340.3,35,45,614.5,16,44,245.0,10,33,43,23,24,7,17,4,-18,205,182,162,66,753.4765625,123.6015625,38.125,30.4140625,1418.90625,1097.65625,970.9140625,265.5390625,10
35,Bilal Coulibaly,Washington Wizards,SG,90,289,30,76,451.5,19,27,633.3,11,39,238.3,9,30,39,18,22,12,8,7,-98,147,129,108,57,127.37777777777777,38.5,16.0,13.177777777777775,337.8777777777778,291.7444444444444,166.31111111111107,61.699999999999996,10
36,Bismack Biyombo,Oklahoma City Thunder,C,4,36,1,4,33.3,2,4,100.0,0,0,0.0,3,2,5,2,6,1,4,1,3,11,9,6,7,5.752066115702478,5.033057851239669,1.4380165289256195,0.0,32.950413223140494,20.768595041322314,12.942148760330578,11.462809917355369,5
37,Blake Wesley,San Antonio Spurs,G,44,145,15,37,382.4,11,14,475.0,3,9,150.0,4,17,21,21,11,4,6,2,-15,86,65,65,42,138.43320884803217,19.7204826199368,22.709853490376325,4.1312841137604135,228.78655558747485,151.02355644929617,214.83338121229534,43.793162884228664,10
38,Boban Marjanovic,Houston Rockets,C,3,7,1,1,100.0,1,2,50.0,0,0,0.0,0,3,3,0,0,0,1,0,-3,6,6,3,3,1.41015625,5.0625,0.0,0.0,11.81640625,11.81640625,1.41015625,5.0625,1
39,Bobby Portis,Milwaukee Bucks,F,141,253,60,121,485.1,10,13,425.0,11,24,333.4,19,65,84,8,23,9,14,3,6,233,225,149,92,555.2112482853223,104.77091906721536,7.382716049382717,23.962277091906724,880.9012345679012,907.7901234567901,549.0960219478739,91.37997256515776,10
40,Bogdan Bogdanovic,Atlanta Hawks,SG,167,343,62,146,425.1,11,14,316.7,32,79,424.0,14,28,42,44,21,12,16,3,47,253,209,211,86,286.25308641975306,38.5679012345679,52.27160493827161,22.077503429355286,310.9938271604939,268.0308641975309,310.94444444444446,109.1111111111111,10
41,Bojan Bogdanovic,New York Knicks,SF,69,165,27,69,344.1,4,5,150.0,11,33,278.6,3,11,14,10,10,0,17,0,4,93,83,79,24,381.292899408284,14.222633136094675,6.832100591715976,17.758136094674555,446.715976331361,402.42677514792905,423.1190828402366,23.517751479289938,10
42,Bol Bol,Phoenix Suns,C,51,115,18,30,456.7,6,7,275.0,9,15,400.0,5,23,28,5,9,0,4,6,-2,84,79,56,33,220.823224852071,18.376479289940832,4.5,8.928994082840235,359.5976331360947,340.09763313609466,236.323224852071,26.87647928994083,10
43,Bones Hyland,LA Clippers,PG,65,161,24,62,368.1,4,6,200.0,13,36,313.8,1,16,17,31,15,10,14,1,0,113,82,96,48,336.05625000000003,18.125,89.65625000000003,21.125,907.325,493.25625,678.8000000000001,179.10625,10
44,Bradley Beal,Phoenix Suns,SG,140,337,56,114,479.5,12,14,433.3,16,42,348.1,10,31,41,66,16,10,25,7,14,247,181,206,107,351.63305898491086,20.900548696844993,66.65363511659808,8.40877914951989,282.9444444444444,330.3882030178326,331.4128943758573,60.330589849108364,10
45,Brandin Podziemski,Golden State Warriors,G,68,261,27,66,392.5,4,6,250.0,10,29,243.3,18,38,56,26,17,10,10,2,24,150,124,94,82,195.225,64.5,33.06944444444444,14.044444444444443,489.5111111111111,399.625,274.94444444444446,107.7361111111111,10
46,Brandon Boston Jr.,LA Clippers,SG,59,135,24,55,462.1,7,14,350.0,4,15,150.0,5,14,19,3,15,3,4,6,-17,81,78,62,22,129.24251278305331,26.39371804236669,2.2227903579254926,4.423666910153397,236.43024105186268,201.31775018261504,150.89846603360118,42.07304601899197,10
47,Brandon Clarke,Memphis Grizzlies,PF,6,21,3,7,42.9,0,1,0.0,0,1,0.0,3,2,5,1,1,1,0,0,15,12,11,7,6,0.0,0.0,0.0,0.0,0.0,0.0,0.0,0.0,1
48,Brandon Ingram,New Orleans Pelicans,SF,180,306,68,138,496.2,36,43,724.5,8,27,260.0,6,50,56,54,24,6,19,7,49,290,236,234,110,670.2437673130194,25.364265927977836,44.40443213296399,6.5318559556786715,720.3393351800554,826.6662049861496,558.8476454293628,74.83795013850416,10
49,Brandon Miller,Charlotte Hornets,F,173,322,64,156,404.0,18,25,505.0,27,80,302.3,8,39,47,26,21,8,14,6,-94,246,220,199,73,532.9000384467512,44.1526336024606,39.590926566705114,30.25259515570934,859.4940407535563,831.2110726643599,555.082276047674,89.84429065743944,10
50,Brandon Williams,Dallas Mavericks,G,7,24,2,9,83.3,3,4,100.0,0,2,0.0,1,1,2,4,1,0,1,0,-12,13,9,11,6,18.22448979591837,3.183673469387756,4.081632653061224,0.0,30.46938775510204,15.448979591836734,29.0,11.510204081632653,4
51,Braxton Key,Denver Nuggets,F,2,6,1,1,100.0,0,1,0.0,0,0,0.0,1,1,2,0,1,0,0,0,2,4,4,2,2,0.11111111111111106,0.44444444444444453,0.25,0.25,0.25,1.0,0.027777777777777728,0.027777777777777804,1
52,Brice Sensabaugh,Utah Jazz,F,62,214,23,77,294.4,11,13,330.0,5,42,153.3,5,37,42,28,12,4,18,2,-76,132,104,90,70,261.3862584549662,48.58098967604129,26.677109291562832,4.7002491990032045,301.58276966892134,292.51975792096835,248.1744393022428,97.53292986828053,10
53,Brook Lopez,Milwaukee Bucks,C,109,286,39,74,514.0,10,12,433.4,21,46,465.0,11,37,48,18,23,4,11,13,4,175,157,127,66,177.08227604767396,28.269896193771626,25.799307958477506,15.033833141099578,320.57247212610537,239.02229911572473,250.70165321030373,62.0,10
54,Bruce Brown,Toronto Raptors,SF,101,276,40,84,471.3,15,20,483.3,6,16,300.0,8,28,36,34,16,6,21,1,-101,171,137,135,70,158.5576559546314,80.54820415879017,33.014177693761816,4.4120982986767485,495.48298676748584,343.7372400756144,280.5,143.36578449905483,10
55,Bruno Fernando,Atlanta Hawks,PF,77,197,32,49,600.9,13,19,425.0,0,1,0.0,20,45,65,14,31,13,16,9,-5,156,142,91,79,424.12802768166085,56.81314878892734,8.671280276816608,0.0,437.1557093425606,426.90657439446363,447.37370242214536,52.48788927335641,10
56,Bryce McGowens,Charlotte Hornets,G,54,155,18,37,330.8,13,18,441.7,5,15,180.0,3,21,24,8,15,7,4,3,-10,86,78,62,32,243.33884297520663,33.70247933884298,5.867768595041323,7.243801652892563,432.95867768595036,414.0,261.90082644628103,39.96694214876033,10
57,Buddy Boeheim,Detroit Pistons,F,19,40,6,14,83.3,2,2,100.0,5,13,76.19999999999999,0,6,6,3,3,0,0,1,12,28,25,22,9,65.0,3.9199999999999995,6.12,3.8800000000000003,142.48000000000002,94.12000000000002,108.32000000000001,15.079999999999998,2
58,Buddy Hield,Philadelphia 76ers,SG,99,216,39,86,453.7,4,4,300.0,17,53,347.4,10,16,26,18,17,3,7,5,-32,143,125,117,44,118.30905306971904,26.64984391259105,16.276795005202914,11.099375650364204,198.4292403746098,160.0046826222685,136.1716961498439,63.488553590010405,10
59,CJ McCollum,New Orleans Pelicans,SG,204,345,77,168,456.4,14,16,441.7,36,86,396.7,3,36,39,50,12,6,16,2,49,293,243,254,89,493.09421487603305,37.08595041322314,47.6,34.429752066115704,865.8033057851239,554.7487603305785,801.2396694214875,87.59504132231405,10
60,Cade Cunningham,Detroit Pistons,PG,237,317,89,212,416.7,41,45,809.7,18,59,272.1,9,45,54,78,17,9,32,2,-25,369,291,315,132,663.25625,52.956250000000004,64.35625,15.825000000000001,921.4562499999997,793.3,720.0999999999999,188.625,10
61,Caleb Houstan,Orlando Magic,G,49,161,16,41,337.7,2,2,100.0,15,39,329.4,6,11,17,4,14,3,2,2,-23,70,66,53,21,151.88979591836735,31.832653061224487,2.9224489795918362,16.72244897959184,285.09387755102046,262.00000000000006,163.1224489795918,46.61632653061225,10
62,Caleb Martin,Miami Heat,SF,89,266,33,89,361.1,12,14,575.0,11,43,320.0,13,33,46,25,10,10,11,3,-10,160,135,114,71,249.84585261658953,48.51975792096832,41.46920612317551,8.910288358846564,582.128159487362,404.8924884300463,394.40014239943037,122.67034531861873,10
63,Cam Reddish,Los Angeles Lakers,SF,30,155,9,28,213.3,6,12,141.7,6,17,216.6,7,6,13,1,8,5,2,6,-16,44,43,31,14,117.25651577503427,21.49931412894376,0.9396433470507545,4.92729766803841,121.01234567901236,109.12894375857339,131.26886145404666,20.31001371742113,10
64,Cam Thomas,Brooklyn Nets,SG,265,360,95,200,470.3,50,56,877.4,25,67,338.6,7,44,51,40,23,6,21,1,3,356,316,305,91,362.25803402646505,68.765595463138,24.01890359168242,35.45368620037807,381.7703213610586,287.4338374291115,462.05387523629486,87.32514177693761,10
65,Cam Whitmore,Houston Rockets,F,126,203,48,111,415.2,17,26,385.0,13,50,239.8,14,31,45,5,11,5,15,5,3,176,171,131,50,215.05817174515238,60.56232686980609,2.673130193905817,12.290858725761774,347.16343490304706,345.24376731301936,225.77008310249312,54.44321329639889,10
66,Cameron Johnson,Brooklyn Nets,SF,155,273,49,102,478.1,27,32,791.7,30,67,441.3,7,31,38,21,14,10,13,1,2,214,193,176,59,438.8213296398892,44.260387811634345,15.087257617728532,29.77285318559556,603.5013850415513,477.3642659279779,547.1468144044321,77.15927977839334,10
67,Cameron Payne,Philadelphia 76ers,PG,92,178,35,85,472.29999999999995,5,6,175.0,17,42,363.3,3,11,14,31,17,5,14,4,-33,137,106,123,45,321.625,22.944444444444446,21.23611111111111,20.125,493.7,452.86944444444447,350.11111111111114,56.525,10
68,Caris LeVert,Cleveland Cavaliers,SG,114,320,41,109,344.8,22,30,390.2,10,47,193.3,8,40,48,79,21,14,23,7,0,241,162,193,127,580.4396433470507,29.777777777777775,99.6803840877915,8.0,1115.0486968449932,723.6495198902606,913.7400548696844,187.55692729766804,10
69,Cason Wallace,Oklahoma City Thunder,G,89,232,35,69,505.3,2,4,100.0,17,35,466.0,7,19,26,18,19,11,8,5,19,133,115,107,44,398.18682671591256,10.660510926438905,24.55340104647584,26.495844875346265,543.6088027085258,448.9168975069252,489.48199445983374,38.61064943059403,10
70,Cedi Osman,San Antonio Spurs,SF,48,150,19,39,432.1,1,2,50.0,9,23,266.6,3,25,28,12,17,4,3,2,-33,88,76,60,40,112.44675124951942,40.68512110726644,31.688581314878896,12.024221453287197,291.10649750096115,188.880430603614,174.49288735101885,112.55363321799305,10
71,Charlie Brown Jr.,New York Knicks,G,3,27,1,5,20.0,0,0,0.0,1,3,33.3,1,1,2,0,4,0,0,1,-6,5,5,3,2,6.12,2.7200000000000006,0.0,0.6800000000000002,17.0,17.0,6.12,2.7200000000000006,2
72,Chet Holmgren,Oklahoma City Thunder,PF,153,283,56,111,457.7,30,33,633.3,11,39,253.4,13,75,88,16,20,6,14,18,91,257,241,169,104,810.6675900277008,94.53185595567867,15.375192366882116,11.821175746383503,1414.3271775931055,1309.2437673130194,889.4444444444443,136.21360418590336,10
73,Chimezie Metu,Detroit Pistons,PF,46,155,17,40,268.0,11,12,387.5,1,14,33.3,5,22,27,13,18,8,9,4,-28,86,73,59,40,138.53061224489798,30.602040816326532,7.408163265306122,0.8367346938775512,296.765306122449,263.5,167.20408163265304,42.60204081632653,6
74,Chimezie Metu,Phoenix Suns,PF,6,29,3,5,150.0,0,0,0.0,0,0,0.0,2,9,11,2,2,2,3,0,-7,19,17,8,13,66.83673469387756,19.158163265306122,4.918367346938775,0.061224489795918366,153.52551020408166,104.75,107.38775510204084,32.30102040816327,3
75,Chris Boucher,Toronto Raptors,PF,69,120,25,35,573.3,15,18,500.0,4,12,216.7,13,27,40,5,11,1,9,5,7,114,109,74,45,142.20987654320987,47.580246913580254,5.913580246913581,4.0246913580246915,410.0,329.0246913580247,192.69135802469134,83.98765432098766,8
76,Chris Duarte,Sacramento Kings,SG,57,131,20,48,444.2,5,6,250.0,12,32,422.7,7,16,23,7,10,4,3,3,-29,87,80,64,30,136.20949604331526,42.28529779258643,8.26530612244898,5.9225322782174095,338.34693877551024,274.40816326530614,174.68471470220743,76.01416076634735,10
77,Chris Livingston,Milwaukee Bucks,F,0,6,0,2,0.0,0,0,0.0,0,2,0.0,0,1,1,1,4,0,1,0,-10,2,1,1,2,1.0,0.390625,0.765625,0.0,0.25,0.140625,0.015625,2.25,1
78,Chris Paul,Golden State Warriors,PG,95,245,42,86,457.8,1,2,50.0,10,26,340.0,6,43,49,64,24,4,14,0,-6,208,144,159,113,271.64650283553874,42.44801512287335,96.4914933837429,6.231568998109641,669.4442344045369,481.640831758034,443.5103969754253,154.87901701323253,10
79,Christian Braun,Denver Nuggets,G,83,212,33,65,506.4,8,14,275.0,9,21,449.9,13,24,37,19,19,6,7,3,-22,139,120,102,56,316.196675900277,36.71191135734072,31.529393659587566,3.112034472145275,705.0289319790705,472.44321329639894,502.62357648507236,114.40012311480457,10
80,Christian Wood,Los Angeles Lakers,F,59,133,22,51,477.0,11,14,450.0,4,19,225.0,6,28,34,6,12,5,5,2,-14,99,93,65,40,153.90277777777777,54.402777777777786,4.625,2.4444444444444446,305.125,285.0,156.7777777777778,76.27777777777777,10
81,Chuma Okeke,Orlando Magic,PF,0,33,0,4,0.0,0,0,0.0,0,4,0.0,0,4,4,2,2,2,2,0,-14,6,4,2,6,0.4253472222222223,2.953125,1.3836805555555554,0.008680555555555556,4.828125,2.868055555555556,1.25,5.472222222222221,5
82,Clint Capela,Atlanta Hawks,C,130,267,58,95,630.0,14,28,380.0,0,1,0.0,53,67,120,18,19,8,14,16,53,268,250,148,138,57.15976331360948,45.625,17.609467455621303,0.0,170.0687869822485,141.4770710059172,61.289940828402365,87.69600591715975,10
83,Coby White,Chicago Bulls,PG,173,358,61,159,382.9,27,31,676.7,24,69,336.7,7,36,43,50,25,6,18,3,-27,266,216,223,93,202.9902650081125,24.28501892915089,83.38020551649541,28.455381287182256,413.12168739859374,284.3244997295835,332.35208220659814,107.10059491617092,10
84,Cody Martin,Charlotte Hornets,SF,69,285,28,76,367.2,6,7,250.0,7,30,228.2,6,44,50,42,15,11,20,7,-28,161,119,111,92,111.0,28.18685121107267,64.68512110726644,2.6816608996539792,183.02076124567472,112.9515570934256,173.33217993079583,100.60899653979239,10
85,Cody Zeller,New Orleans Pelicans,C,7,31,3,6,200.0,1,2,50.0,0,0,0.0,5,10,15,3,5,2,3,0,14,25,22,10,18,3.2091836734693877,5.25,3.494897959183673,0.0,19.08673469387755,12.673469387755102,6.408163265306122,11.959183673469386,5
86,Colby Jones,Sacramento Kings,G,6,25,3,10,116.6,0,0,0.0,0,2,0.0,3,4,7,5,4,0,1,0,-3,18,13,11,12,5.3884297520661155,5.578512396694214,1.6611570247933884,0.0,28.48760330578512,19.165289256198342,11.0,10.950413223140497,4
87,Cole Anthony,Orlando Magic,PG,125,235,46,100,436.2,16,23,437.5,17,43,324.5,11,29,40,26,14,5,8,8,38,191,165,151,66,464.59257582616567,50.394748755092806,36.414667270258036,22.31552738795835,854.949298325034,714.5101856043458,580.6568583069262,111.1842462652784,10
88,Cole Swider,Miami Heat,F,19,44,6,16,104.7,2,2,100.0,5,13,116.7,0,5,5,1,1,0,4,0,-18,25,24,20,6,143.3114186851211,2.017301038062284,0.8996539792387545,12.847750865051903,168.42906574394465,172.6574394463668,139.0,3.0,5
89,Collin Gillespie,Denver Nuggets,G,53,125,19,43,306.4,4,7,200.0,11,25,283.3,0,15,15,18,12,7,9,0,24,86,68,71,33,228.0,14.140495867768596,42.0,14.330578512396691,391.8677685950413,264.59504132231405,324.0,87.41322314049586,8
90,Collin Sexton,Utah Jazz,PG,227,341,93,171,546.4,25,28,823.3,16,44,304.1,14,21,35,63,20,9,28,4,-68,325,262,290,98,103.56336608717558,41.05089443184681,48.111111111111114,25.06122448979592,202.9571680524061,177.2693373645755,146.70093222474173,71.71227009322247,10
91,Corey Kispert,Washington Wizards,SF,159,335,59,115,508.9,10,21,383.3,31,67,459.5,4,30,34,12,24,9,12,3,-54,205,193,171,46,277.90943294813223,100.70196183821554,12.670249932813759,20.460897608169844,498.98978769148073,488.1126041386724,260.46089760816983,141.69793066380007,10
92,Cory Joseph,Golden State Warriors,PG,27,71,10,16,316.7,0,0,0.0,7,11,316.7,2,9,11,6,6,0,1,0,9,44,38,33,17,31.2,10.8,2.8000000000000003,3.2,28.8,47.2,21.2,5.2,5
93,Craig Jr. Porter,Cleveland Cavaliers,G,64,136,27,52,425.3,5,6,300.0,5,12,175.0,6,17,23,24,4,3,8,2,-29,111,87,88,47,343.30625,40.1,18.799999999999997,9.399999999999999,668.70625,551.50625,446.90625,72.5,10
94,D'Angelo Russell,Los Angeles Lakers,PG,195,361,65,156,389.7,28,30,800.0,37,84,400.6,7,29,36,71,21,9,23,4,24,302,231,266,107,1312.8999999999999,32.724,121.684,64.296,2291.156,1623.944,1914.304,220.216,10
95,D.J. Carton,Toronto Raptors,G,8,31,2,7,83.3,3,4,150.0,1,4,50.0,2,1,3,3,1,1,1,0,-30,14,11,11,6,8.666666666666668,2.0,2.0,0.6666666666666667,8.666666666666666,2.6666666666666665,18.666666666666668,0.0,3
96,D.J. Wilson,Philadelphia 76ers,F,10,14,4,6,66.7,0,0,0.0,2,2,100.0,1,1,2,2,1,0,0,2,4,14,12,12,4,16.0,0.6400000000000001,0.6400000000000001,0.6400000000000001,31.359999999999996,23.04,23.04,2.5600000000000005,1
97,DaQuan Jeffries,New York Knicks,SG,0,7,0,2,0.0,0,0,0.0,0,2,0.0,0,0,0,3,0,0,1,0,7,3,0,3,3,1.0,0.0,4.0,0.1111111111111111,1.0,1.0,1.0,4.0,1
98,Daishen Nix,Minnesota Timberwolves,SG,5,5,2,3,66.7,0,0,0.0,1,2,50.0,0,0,0,0,1,1,0,0,6,5,5,5,0,9.0,0.0,0.08163265306122448,0.32653061224489793,7.367346938775511,9.0,7.367346938775511,0.08163265306122448,1
99,Dalano Banton,Portland Trail Blazers,G,181,327,69,165,425.7,21,22,875.0,22,68,349.5,10,42,52,35,15,12,31,5,-161,268,233,216,87,579.3,72.44444444444443,73.04444444444444,16.402777777777775,1205.4777777777779,796.5444444444446,967.7444444444444,165.9777777777778,10
100,Dalen Terry,Chicago Bulls,F,42,140,18,37,357.8,3,6,150.0,3,14,158.3,9,18,27,18,10,6,6,2,20,87,69,60,45,113.7,42.104,27.700000000000003,2.164,288.104,216.964,146.0,108.64399999999999,10
101,Damian Jones,Cleveland Cavaliers,C,61,129,24,38,627.9,13,15,650.0,0,5,0.0,14,23,37,6,13,4,7,7,-25,104,98,67,43,157.48224852071007,70.0621301775148,4.5,0.0,282.2633136094675,278.22485207100596,156.1360946745562,79.94674556213018,10
102,Damian Lillard,Milwaukee Bucks,PG,238,369,82,186,434.9,38,43,888.0,36,90,399.3,4,43,47,90,21,6,20,3,36,375,285,328,137,692.0155325443787,14.977071005917157,92.52366863905327,33.1457100591716,1083.6005917159764,705.0,1081.832100591716,96.28476331360946,10
103,Daniel Gafford,Dallas Mavericks,C,140,247,62,76,809.2,16,24,433.4,0,0,0.0,25,53,78,21,32,9,10,24,117,239,218,161,99,319.28595041322313,87.05785123966942,28.90082644628099,0.0,614.0479338842975,510.90247933884297,415.9619834710744,122.42809917355373,10
104,Daniel Theis,LA Clippers,C,44,135,19,38,427.5,3,3,200.0,3,8,200.0,11,21,32,12,18,1,7,9,14,88,76,56,44,135.03591682419662,26.27693761814745,9.965973534971644,4.183364839319471,226.83270321361056,198.32230623818526,160.36672967863893,39.42249527410208,10
105,Danilo Gallinari,Milwaukee Bucks,PF,28,105,9,23,350.0,9,10,275.0,1,11,100.0,3,6,9,9,7,2,3,1,-43,46,37,37,18,84.24417009602195,4.939643347050755,12.972565157750342,1.6310013717421123,98.74622770919068,99.64197530864199,81.65569272976681,19.60493827160494,10
106,Dante Exum,Dallas Mavericks,G,61,206,21,47,412.4,8,9,366.7,11,21,406.7,2,18,20,29,17,2,11,0,35,110,81,90,49,195.9150892374256,12.778799351000542,23.22065981611682,15.075716603569496,188.19469983775014,180.91563007030828,206.19469983775014,32.99891833423472,10
107,Danuel House Jr.,Philadelphia 76ers,SF,42,143,14,30,276.3,13,15,466.7,1,11,33.3,6,11,17,7,16,7,3,3,-26,66,59,49,24,42.0,11.714285714285715,8.0,0.8571428571428572,41.714285714285715,51.714285714285715,40.0,11.714285714285715,7
108,Dario Saric,Golden State Warriors,PF,28,107,12,33,298.3,2,3,100.0,2,17,83.3,6,15,21,18,5,0,13,0,-31,67,49,46,39,52.0,27.193877551020407,15.673469387755102,2.1224489795918364,146.1326530612245,98.90816326530613,72.53061224489795,69.56122448979592,10
109,Darius Garland,Cleveland Cavaliers,PG,173,342,66,151,442.3,14,18,775.0,27,77,312.8,8,29,37,77,20,8,26,1,5,287,210,250,114,419.4132231404958,31.591735537190083,114.97685950413222,55.11239669421488,626.1008264462811,417.37520661157026,591.6,183.1074380165289,10
110,David Roddy,Phoenix Suns,F,61,130,25,53,522.0,6,10,241.7,5,20,143.3,4,15,19,11,5,1,10,0,-72,91,80,72,30,428.972242512783,53.189919649379114,19.333089846603357,9.159240321402482,841.0,667.6303871439006,583.4331628926224,91.43170197224252,10
111,Davion Mitchell,Sacramento Kings,PG,56,168,23,48,400.5,3,4,75.0,7,21,261.7,4,10,14,16,7,4,6,0,26,86,70,72,30,249.6307444235421,6.510077936038699,10.51706530502553,10.506584251545284,280.5896264445042,282.604676162322,242.18865896264444,22.454178984144047,10
112,Davis Bertans,Charlotte Hornets,SF,67,224,20,67,271.7,11,12,450.0,16,54,282.1,2,15,17,11,13,10,9,3,-65,95,84,78,28,256.37263385613846,22.766360194699836,16.336938885884262,14.407787993510006,376.93726338561385,308.1914548404543,316.5613845321796,47.66035694970254,10
113,Day'Ron Sharpe,Brooklyn Nets,C,58,136,24,41,674.2,10,17,308.3,0,1,0.0,24,28,52,15,24,2,13,6,7,125,110,73,67,143.11111111111111,176.8402366863905,16.51479289940828,0.059171597633136105,428.0282708744247,362.61801446416837,170.95923734385272,230.91715976331363,10
114,De'Aaron Fox,Sacramento Kings,PG,233,356,84,197,436.7,36,42,777.2,29,75,413.1,14,46,60,58,28,25,27,4,53,351,293,291,118,154.31399023269176,21.266877334099394,55.71042803792014,14.178971559896581,239.25395001436368,222.95978167193337,167.86009767308246,79.72536627405917,10
115,De'Andre Hunter,Atlanta Hawks,SF,169,318,61,140,431.4,23,27,690.0,24,69,330.8,7,35,42,18,17,5,13,3,34,229,211,187,60,392.9658241367035,133.15485938056247,7.851192595229619,28.536845852616587,645.4371662513349,685.5532217871129,366.15984336062655,127.69597721609114,10
116,De'Anthony Melton,Philadelphia 76ers,SG,23,43,7,20,75.0,4,4,200.0,5,14,75.0,0,5,5,5,3,2,1,1,-2,33,28,28,10,128.66666666666666,2.666666666666667,2.666666666666667,8.666666666666666,206.0,164.66666666666669,164.66666666666669,10.666666666666668,3
117,DeAndre Jordan,Denver Nuggets,C,45,102,20,33,678.5,5,5,300.0,0,0,0.0,16,29,45,5,14,1,3,5,-9,95,90,50,50,134.01234567901236,78.91495198902606,9.737997256515774,0.0,384.77777777777777,312.34293552812073,174.01371742112485,121.08641975308642,10
118,DeJon Jarreau,Memphis Grizzlies,F,43,150,17,50,308.3,5,11,250.0,4,13,141.7,8,36,44,26,14,6,9,2,-24,113,87,69,70,75.33333333333333,83.13888888888889,43.138888888888886,4.229166666666666,313.0,146.0277777777778,154.02777777777777,214.55555555555551,9
119,DeMar DeRozan,Chicago Bulls,SF,250,356,83,167,481.9,78,93,854.2,6,27,156.7,4,45,49,42,15,13,19,7,30,341,299,292,91,890.9578331794398,56.168359495229296,61.48045552477686,4.638350261618959,1354.9015081563557,1303.0,954.7823945829485,105.72576177285319,10
120,Dean Wade,Cleveland Cavaliers,PF,46,178,15,35,260.2,5,7,216.7,11,31,233.4,4,27,31,7,8,3,1,9,-23,84,77,53,38,468.50000000000006,35.125,6.125,31.525000000000006,718.8,714.725,466.12499999999994,47.699999999999996,10
121,Deandre Ayton,Portland Trail Blazers,C,225,336,103,165,623.1,18,22,450.0,1,4,100.0,37,97,134,12,13,8,22,9,-47,371,359,237,146,648.1702827087444,237.83694937541094,4.04207758053912,0.9000657462195925,1489.9257067718609,1545.2366863905327,607.4247205785667,227.31360946745565,10
122,Dejounte Murray,Atlanta Hawks,SG,280,383,105,234,463.0,27,35,645.3,43,111,394.6,8,41,49,94,16,25,32,4,13,423,329,374,143,858.4,58.6099173553719,96.63471074380165,38.94380165289256,758.6859504132233,1022.2099173553719,589.8347107438017,160.28595041322313,10
123,Delon Wright,Miami Heat,SG,44,198,16,50,310.0,7,10,183.3,5,19,125.0,4,16,20,23,6,9,1,1,25,87,64,67,43,147.14007571660355,12.194699837750136,27.83288263926447,6.728501892915089,222.32179556517033,171.94375338020552,198.3564088696593,39.189291508923745,10
124,Deni Avdija,Washington Wizards,SF,178,358,69,139,508.5,29,43,678.7,11,38,270.8,22,78,100,37,24,9,24,3,-24,315,278,215,137,85.82499999999999,81.6,50.85625,11.15625,349.55625,213.625,195.05625,159.15625,10
125,Dennis Schroder,Brooklyn Nets,PG,155,350,57,140,396.7,18,20,525.0,23,58,374.5,6,27,33,62,18,9,31,5,-40,250,188,217,95,385.27914951989027,32.21536351165981,40.077503429355275,31.114540466392324,579.9478737997256,473.55075445816186,499.3456790123457,64.62345679012346,10
126,Dennis Smith Jr.,Brooklyn Nets,PG,58,167,21,46,487.1,8,11,383.3,8,22,348.3,5,13,18,28,22,16,11,0,3,104,76,86,46,75.38271604938271,18.711111111111112,41.77777777777778,4.0,181.82716049382717,136.47901234567902,110.41975308641975,70.80000000000001,10
127,Dereck II Lively,Dallas Mavericks,C,96,195,46,61,730.4,4,11,150.0,0,0,0.0,17,45,62,9,18,4,6,10,12,167,158,105,71,322.5,61.69184027777777,9.3515625,0.0,589.9340277777778,511.9001736111111,395.7265625,75.85069444444444,10
128,Derrick Jones Jr.,Dallas Mavericks,SF,83,209,31,56,592.0,14,20,533.4,7,22,223.3,9,14,23,10,12,7,5,3,84,116,106,93,33,73.09469562121751,51.83873264506943,10.088999644001424,8.232467070131719,178.53399786400854,140.92132431470273,103.49412602349591,69.14097543609826,10
129,Derrick Rose,Memphis Grizzlies,PG,49,95,20,37,377.7,5,6,266.7,4,8,233.3,0,15,15,21,3,1,9,0,-9,85,64,70,36,70.0,14.857142857142858,12.0,3.7142857142857144,188.85714285714286,116.85714285714286,128.0,40.857142857142854,7
130,Derrick White,Boston Celtics,PG,168,363,61,136,459.70000000000005,16,18,555.6,30,79,328.2,10,53,63,68,24,10,15,13,78,299,231,236,131,339.6404958677686,45.29855371900827,60.368801652892564,56.25309917355372,558.6528925619834,448.9183884297521,412.8564049586777,142.18595041322314,10
131,Desmond Bane,Memphis Grizzlies,SG,93,165,30,80,183.4,19,21,366.7,14,40,172.9,2,14,16,34,14,5,13,2,-54,143,109,127,50,268.168,8.808,116.15199999999999,4.832,706.2,363.952,591.808,143.568,5
132,Devin Booker,Phoenix Suns,SG,241,347,91,189,476.2,41,46,882.1,18,64,244.7,14,42,56,71,32,4,22,6,14,368,297,312,127,508.2914951989027,42.439643347050755,83.69684499314128,31.54252400548697,527.8737997256516,582.4622770919068,400.03086419753083,179.80864197530863,10
133,Devin Vassell,San Antonio Spurs,SG,193,373,77,163,440.2,18,21,691.7,21,61,312.3,0,33,33,47,16,12,18,1,-43,273,226,240,80,800.1432818073722,27.0,52.30975029726516,24.942925089179546,1070.5481569560047,841.9363852556481,1016.9274673008323,91.13733650416171,10
134,Devonte' Graham,San Antonio Spurs,PG,17,36,6,14,158.3,1,1,100.0,4,11,170.0,0,9,9,2,2,2,1,0,18,28,26,19,11,51.735537190082646,1.1239669421487604,4.495867768595041,2.8264462809917354,74.89256198347107,58.82644628099173,68.29752066115702,5.12396694214876,5
135,Dillon Brooks,Houston Rockets,SF,122,284,46,105,425.8,14,15,450.0,16,56,329.2,4,25,29,18,27,7,14,2,97,169,151,140,47,344.5,23.841854934601663,23.873959571938165,10.45243757431629,538.8662306777646,394.5832342449465,454.1670630202141,82.33174791914387,10
136,Domantas Sabonis,Sacramento Kings,PF,169,359,60,114,536.8,47,62,755.8,2,8,133.3,33,110,143,78,29,6,29,7,35,390,312,247,221,233.60037624294546,73.03977425423274,67.17387798978768,1.724267669981188,300.19618382155346,381.5823703305563,158.5818328406342,133.84600913732865,10
137,Dominick Barlow,San Antonio Spurs,F,57,150,21,38,506.6,15,18,416.6,0,1,0.0,19,22,41,15,19,4,4,3,10,113,98,72,56,290.46020761245677,80.55017301038063,45.74567474048443,0.0,713.3996539792388,588.5674740484428,425.3581314878893,116.23010380622837,10
138,Donovan Mitchell,Cleveland Cavaliers,SG,213,341,65,155,410.6,48,55,812.8,35,83,413.6,3,42,45,52,22,14,30,6,-3,310,258,265,97,719.9340277777777,14.777777777777779,31.069444444444443,22.569444444444446,986.3506944444446,874.40625,824.6006944444445,53.125,10
139,Donte DiVincenzo,New York Knicks,SG,191,355,67,148,437.9,12,16,450.0,45,111,393.6,9,37,46,28,25,16,12,7,70,265,237,219,74,699.8132231404959,45.85785123966942,14.07603305785124,58.50743801652892,821.9619834710744,817.793388429752,707.2479338842975,56.66776859504132,10
140,Dorian Finney-Smith,Brooklyn Nets,PF,74,301,26,71,370.4,13,16,575.0,9,45,223.3,14,32,46,19,16,12,5,5,-21,139,120,93,65,166.479012345679,26.444444444444443,12.930864197530862,10.960493827160493,213.0,182.241975308642,208.11111111111111,28.501234567901236,10
141,Doug McDermott,Indiana Pacers,SF,45,123,17,43,287.5,1,2,50.0,10,35,190.29999999999998,1,7,8,10,10,3,4,0,-8,63,53,55,18,270.50625,9.60625,10.00625,18.1,364.10625000000005,300.09999999999997,334.5,19.625,10
142,Draymond Green,Golden State Warriors,PF,76,299,34,79,427.3,4,6,125.0,4,26,93.3,19,67,86,66,33,12,24,6,43,228,162,142,152,102.71071531169204,46.841712151680554,110.25337546681988,4.517667336972134,400.274059178397,177.093363975869,219.28181557023845,263.70468256248205,10
143,Drew Eubanks,Phoenix Suns,PF,42,152,18,27,565.0,6,7,280.0,0,0,0.0,12,29,41,7,14,3,6,9,6,90,83,49,48,89.79201378914107,42.974719908072395,14.563343866704967,0.0,179.00890548692902,153.48606722206262,102.34271760988221,70.51019821890262,10
144,Duncan Robinson,Miami Heat,F,146,321,53,111,467.0,8,9,350.0,32,84,339.0,2,33,35,30,26,10,16,3,-13,211,181,176,65,468.41111111111104,21.877777777777776,36.01111111111111,37.7,674.5,489.5777777777777,640.8444444444444,70.37777777777778,10
145,Duop Reath,Portland Trail Blazers,C,87,181,34,72,360.1,9,10,450.0,10,32,220.0,7,21,28,10,23,4,10,4,-75,125,115,97,38,523.641975308642,54.47165532879819,24.00251952632905,12.493827160493828,1020.9818594104307,835.3093978332074,667.4081632653061,120.38044847568656,10
146,Dwight Powell,Dallas Mavericks,C,20,119,7,12,450.0,6,11,325.0,0,0,0.0,12,20,32,9,19,0,9,3,-9,61,52,29,41,47.0633608815427,103.12396694214877,12.0,0.0,309.16253443526176,238.37465564738292,76.4573002754821,156.51790633608817,9
147,Dylan Windler,Atlanta Hawks,G,16,41,6,11,106.7,0,0,0.0,4,9,85.0,1,6,7,2,2,2,1,0,3,25,23,18,9,72.84917355371901,7.487603305785125,2.6838842975206614,5.328512396694214,110.76859504132233,101.39462809917356,75.11570247933884,17.27892561983471,3
148,Dylan Windler,Los Angeles Lakers,G,3,14,1,4,25.0,0,0,0.0,1,4,25.0,0,1,1,2,1,0,0,0,-7,6,4,5,3,11.111570247933887,1.9917355371900825,0.33471074380165283,0.7644628099173554,12.330578512396691,16.384297520661157,8.47107438016529,0.913223140495868,2
149,Dyson Daniels,New Orleans Pelicans,G,38,181,16,32,311.4,1,2,50.0,5,13,250.0,7,20,27,20,12,15,12,8,25,85,65,58,47,123.55555555555556,24.0,25.555555555555557,4.222222222222222,146.22222222222223,113.55555555555556,128.22222222222223,77.55555555555556,9
150,Emoni Bates,Cleveland Cavaliers,F,16,23,6,12,102.9,0,2,0.0,4,8,100.0,0,1,1,1,0,0,1,0,-3,18,17,17,2,22.765432098765434,0.8024691358024691,0.5061728395061729,2.617283950617284,28.888888888888893,26.58024691358024,25.98765432098765,0.3950617283950617,2
151,Eric Gordon,Phoenix Suns,SG,80,230,30,66,393.0,2,2,200.0,18,43,374.2,1,14,15,17,13,7,5,3,14,112,95,97,32,436.625,6.503698224852071,18.21597633136095,26.366863905325445,478.8284023668639,365.801775147929,550.6102071005918,23.76109467455621,10
152,Eugene Omoruyi,Washington Wizards,F,39,106,17,38,391.3,5,10,200.0,0,6,0.0,7,13,20,7,18,7,5,1,-68,66,59,46,27,94.91836734693878,9.033163265306124,6.798469387755102,0.012755102040816325,87.34693877551021,71.67602040816327,106.89030612244898,19.530612244897956,10
153,Evan Fournier,Detroit Pistons,SG,73,195,26,75,325.7,11,14,366.7,10,42,209.3,1,15,16,18,16,10,8,1,-42,107,89,91,34,338.148393194707,12.658790170132324,23.615311909262758,14.118147448015122,478.4659735349716,441.43100189035914,370.9092627599244,40.54820415879017,10
154,Evan Mobley,Cleveland Cavaliers,PF,159,293,62,106,571.6,29,47,547.6,6,18,275.0,19,73,92,44,27,10,14,14,-12,295,251,203,136,373.0,163.2986472424558,70.8678459937565,6.826222684703433,838.2195629552549,796.4921956295525,351.6097814776275,297.28407908428716,10
155,Frank Ntilikina,Charlotte Hornets,PG,5,39,1,8,50.0,2,2,100.0,1,7,50.0,1,4,5,3,4,0,0,0,0,13,10,8,8,19.0,7.0,6.84,0.7600000000000002,24.439999999999998,14.0,18.64,24.640000000000004,4
156,Franz Wagner,Orlando Magic,SF,155,307,61,133,473.5,29,34,872.5,4,32,90.0,8,34,42,30,25,13,13,2,-15,227,197,185,72,158.99366229062926,47.339067451335445,28.829334540516072,7.507469443186963,435.3920325939338,322.69941149841554,253.2498868266184,94.60479855138071,10
157,Fred VanVleet,Houston Rockets,PG,183,359,62,145,434.29999999999995,27,29,585.7,32,84,363.7,3,34,37,87,29,21,22,10,88,307,220,270,124,659.7034531861873,18.39480242079032,115.76824492702029,59.60697757208971,618.5977216091135,672.945532217871,587.0758276966892,152.4428622285511,10
158,Furkan Korkmaz,Philadelphia 76ers,SG,41,116,13,29,278.6,7,10,241.7,8,18,258.3,3,12,15,12,6,3,2,2,22,68,56,53,27,292.875,14.875,10.0,20.0,404.0,340.0,363.875,17.875,8
159,GG Jackson,Memphis Grizzlies,F,196,334,66,148,433.2,35,42,777.4,29,86,302.6,15,34,49,17,17,4,17,3,-100,262,245,213,66,750.99173553719,31.8,20.33884297520661,42.96694214876033,895.6297520661157,792.1371900826447,846.1570247933885,60.46611570247934,10
160,Garrett Temple,Toronto Raptors,SF,33,84,11,20,300.0,5,6,250.0,6,13,200.0,4,13,17,10,8,6,2,1,-4,60,50,43,27,115.76033057851242,17.280991735537192,8.041322314049587,6.820247933884297,179.29752066115702,174.09917355371903,112.84297520661157,33.438016528925615,5
161,Garrison Mathews,Atlanta Hawks,SG,88,200,26,50,520.5,17,19,363.3,19,37,464.0,0,14,14,11,27,4,2,3,-6,113,102,99,25,443.31441326530614,12.441326530612244,15.25829081632653,27.9795918367347,649.9795918367347,559.2940051020408,515.0433673469388,46.65625,10
162,Gary Harris,Orlando Magic,SG,69,238,25,52,520.3,5,8,225.0,14,35,460.9,3,10,13,8,14,8,8,2,13,90,82,77,21,72.759765625,4.212890625,13.603515625,2.40625,123.181640625,88.65625,100.125,24.9765625,10
163,Gary Payton II,Golden State Warriors,SG,34,144,15,27,459.9,2,4,100.0,2,5,200.0,9,8,17,16,16,6,6,4,2,67,51,50,33,96.1284121491734,56.78008458285274,36.8319876970396,1.6885813148788926,212.65782391387927,121.25605536332179,107.01422529796231,174.12802768166088,10
164,Gary Trent Jr.,Toronto Raptors,SG,217,331,78,173,463.0,29,33,730.0,32,83,387.7,8,30,38,19,15,14,4,2,-98,274,255,236,57,504.69834710743805,17.310950413223143,31.050619834710744,34.52582644628099,482.0495867768595,553.5382231404959,446.625,34.946280991735534,10
165,Georges Niang,Cleveland Cavaliers,SF,141,288,51,98,516.4,10,10,400.0,29,64,468.1,1,29,30,10,28,5,15,3,-9,181,171,151,40,329.22770511296073,28.0743162901308,6.240784780023781,27.793697978596906,275.7580261593341,284.9976218787158,303.7205707491082,50.582639714625444,10
166,Giannis Antetokounmpo,Milwaukee Bucks,PF,314,372,120,197,614.5,69,106,607.9,5,18,183.3,36,95,131,69,30,7,35,10,-10,514,445,383,200,467.1373966942148,204.4638429752066,83.48037190082644,4.505165289256198,1042.2365702479337,882.3677685950414,606.9008264462809,308.04958677685954,10
167,Goga Bitadze,Orlando Magic,C,28,99,11,20,480.0,6,9,283.3,0,3,0.0,10,12,22,9,10,2,8,9,3,59,50,37,31,47.63905325443787,63.61094674556212,8.33284023668639,0.0,232.10059171597635,173.7174556213018,74.48668639053254,103.4792899408284,9
168,Gordon Hayward,Oklahoma City Thunder,SF,55,181,17,37,430.5,12,18,400.0,9,16,450.0,4,17,21,23,10,3,6,0,-5,99,76,78,44,137.7111111111111,30.901234567901234,38.11111111111111,9.000000000000002,285.5679012345679,199.7382716049383,198.0,94.55308641975309,10
169,Gradey Dick,Toronto Raptors,G,126,319,49,120,383.7,10,12,533.3,18,55,323.3,5,21,26,20,18,6,15,2,-120,172,152,146,46,361.764,26.8,36.70399999999999,15.744,474.5,419.68399999999997,396.5,83.584,10
170,Grant Williams,Charlotte Hornets,PF,135,289,49,103,484.5,22,28,555.6,15,46,414.5,13,35,48,24,27,11,22,4,-86,207,183,159,72,296.88399999999996,33.796,20.5,6.5040000000000004,451.204,394.264,317.944,90.176,10
171,Grayson Allen,Phoenix Suns,SG,159,328,56,100,572.2,14,16,541.7,33,68,416.9,6,26,32,32,15,10,11,5,37,223,191,191,64,536.0202140309157,47.60047562425684,34.6064209274673,69.10642092746731,683.30677764566,523.8299643281807,676.2532699167657,101.45065398335315,10
172,Gui Santos,Golden State Warriors,F,41,109,14,26,422.5,8,9,350.0,5,10,300.0,9,21,30,9,15,2,5,2,6,80,71,50,39,148.8890532544379,122.34467455621302,15.847633136094672,4.226331360946745,552.4985207100592,479.40828402366856,171.68639053254438,188.48520710059174,9
173,Harrison Barnes,Sacramento Kings,SF,136,304,49,114,424.0,18,22,500.0,20,52,309.3,9,32,41,15,12,4,10,1,4,192,177,151,56,282.4041924213921,29.66917495296963,11.145659768879334,42.32518140284869,383.5689330825047,319.53319000268743,330.7656543939801,56.489115829078216,10
174,Harry III Giles,Brooklyn Nets,F,8,8,3,6,50.0,1,2,50.0,1,1,100.0,2,2,4,2,3,0,0,0,-12,14,12,10,6,48.3025,11.2225,3.4225000000000003,0.81,147.6225,106.09000000000002,77.44000000000001,27.040000000000003,1
175,Harry III Giles,Los Angeles Lakers,F,2,10,1,4,100.0,0,0,0.0,0,2,0.0,0,1,1,0,0,1,0,0,-15,3,3,2,1,2.005,0.545,0.045,0.020000000000000004,4.745,4.58,2.08,0.6800000000000002,2
176,Haywood Highsmith,Miami Heat,F,72,179,27,44,507.3,2,7,83.3,16,25,433.3,8,22,30,12,8,4,2,0,10,114,102,84,42,574.873510188389,50.24605920799692,9.639369473279508,34.75432525951557,1007.0903498654363,922.0,634.160707420223,85.68858131487889,10
177,Herbert Jones,New Orleans Pelicans,SF,89,328,28,62,422.4,22,25,700.0,11,33,298.3,6,26,32,33,33,15,14,17,-3,154,121,122,65,191.82737408688968,23.969242599000385,12.590926566705113,6.7439446366782,284.0891964628988,226.34256055363323,227.62552864282966,58.50865051903114,10
178,Hunter Tyson,Denver Nuggets,F,0,7,0,3,0.0,0,0,0.0,0,3,0.0,0,1,1,0,1,0,2,0,-1,1,1,0,1,13.223140495867767,0.4049586776859504,0.29752066115702475,0.5289256198347108,12.5702479338843,9.0,17.48760330578512,0.00826446280991736,1
179,I. Thomas,Phoenix Suns,G,5,8,2,4,50.0,0,0,0.0,1,2,50.0,0,0,0,1,0,0,0,0,1,6,5,6,1,12.755102040816325,0.0,0.0,0.5102040816326531,12.755102040816327,12.755102040816325,12.755102040816327,0.0,1
180,Ibou Badji,Portland Trail Blazers,C,10,41,4,5,250.0,2,4,100.0,0,0,0.0,2,4,6,4,8,0,5,3,-33,20,16,14,10,19.5625,8.0625,3.890625,0.0,52.640625,47.0,26.390625,10.765625,4
181,Immanuel Quickley,Toronto Raptors,SG,195,364,68,158,420.7,33,45,597.2,26,77,328.3,2,55,57,88,17,11,26,3,-71,340,252,283,145,477.0639999999999,39.496,197.456,20.976,930.7840000000001,541.9359999999999,785.464,317.4,10
182,Isaac Okoro,Cleveland Cavaliers,SF,77,302,30,77,385.0,5,8,175.0,12,39,341.7,9,17,26,16,25,7,12,2,-61,119,103,93,42,153.25445897740786,42.468489892984536,18.651605231866824,7.921521997621879,387.97978596908445,287.2853745541023,229.4114149821641,85.65755053507729,10
183,Isaiah Hartenstein,New York Knicks,C,98,237,42,57,783.6,14,19,530.0,0,0,0.0,29,51,80,30,31,10,10,12,125,208,178,128,110,244.656,96.916,14.1,0.0,279.9839999999999,280.644,213.076,141.936,10
184,Isaiah Jackson,Indiana Pacers,SF,89,171,36,53,744.3,17,25,608.3,0,1,0.0,23,33,56,11,26,9,9,9,26,156,145,100,67,281.80190362879233,200.97323022010707,29.121356335514573,0.0,937.2801903628792,790.1719214753125,343.639500297442,315.365258774539,10
185,Isaiah Joe,Oklahoma City Thunder,SG,82,184,29,68,403.4,4,4,200.0,20,47,393.8,2,18,20,15,13,3,4,1,13,117,102,97,35,205.3307226771093,8.056959772160912,28.572089711641155,14.91135635457458,410.9081523673905,258.71484514061945,341.39587041651833,52.75720897116411,10
186,Isaiah Mobley,Cleveland Cavaliers,F,5,33,2,7,58.3,0,0,0.0,1,4,25.0,0,4,4,2,2,0,0,0,-1,11,9,7,6,0.6799999999999997,10.880000000000003,0.72,0.6800000000000002,13.32,9.0,2.1199999999999997,14.479999999999999,2
187,Isaiah Stewart,Detroit Pistons,C,106,319,40,71,587.7,10,12,516.7,16,38,409.0,10,48,58,12,11,4,10,10,-48,176,164,118,70,131.47520661157026,49.603305785123965,9.603305785123966,12.764462809917354,245.47520661157023,193.27685950413223,178.88016528925618,64.0,10
188,Ish Smith,Charlotte Hornets,PG,18,181,8,34,236.0,0,0,0.0,2,2,200.0,1,19,20,41,16,5,6,1,-90,79,38,59,61,54.36000000000001,24.0,78.09,1.5600000000000003,170.49,69.16000000000001,134.09,123.69,9
189,Ish Wainright,Phoenix Suns,F,3,11,1,6,16.7,0,0,0.0,1,4,25.0,3,2,5,1,1,1,1,0,-3,9,8,4,6,6.25,17.361111111111114,0.6944444444444445,0.6944444444444445,56.25,44.44444444444445,11.111111111111112,25.0,1
190,Ivica Zubac,LA Clippers,C,98,272,41,62,708.6,16,19,575.0,0,0,0.0,28,56,84,14,22,7,11,11,-24,196,182,112,98,92.5,42.65363511659808,6.419753086419753,0.0,210.12071330589848,161.70919067215362,116.25308641975309,73.7318244170096,10
191,JT Thor,Charlotte Hornets,F,17,99,7,15,308.3,0,0,0.0,3,8,200.0,1,12,13,6,9,0,2,3,22,36,30,23,19,47.056640625,15.8515625,4.6640625,4.40625,77.791015625,79.369140625,49.087890625,16.90625,10
192,JaVale McGee,Sacramento Kings,C,23,49,11,19,355.0,0,3,0.0,1,2,100.0,5,10,15,1,6,2,1,0,-4,39,38,24,16,76.296786389414,15.192816635160682,0.8790170132325142,0.8790170132325142,129.4234404536862,131.53497164461245,78.01890359168242,12.238185255198486,7
193,Jabari Smith Jr.,Houston Rockets,PF,134,294,46,103,456.3,24,28,916.7,18,49,325.6,13,59,72,13,28,11,15,6,79,219,206,147,85,240.04914618908788,121.74010828821324,14.286963765097875,12.03331945022907,484.2819658475635,463.6193252811329,257.5880882965431,139.15077051228656,10
194,Jabari Walker,Portland Trail Blazers,F,82,254,32,66,475.1,13,19,606.7,5,15,266.7,13,48,61,13,33,6,6,0,-84,156,143,95,74,183.6495867768595,59.58512396694215,18.537190082644628,6.520661157024793,279.3388429752066,273.4297520661157,162.32561983471075,105.35537190082646,10
195,Jacob Gilyard,Brooklyn Nets,G,0,11,0,2,0.0,0,0,0.0,0,2,0.0,0,0,0,1,2,1,0,0,0,1,0,1,1,14.761772853185596,0.6232686980609419,3.792243767313019,1.3407202216066483,43.28254847645429,21.451523545706372,33.51800554016621,7.490304709141275,1
196,Jacob Gilyard,Memphis Grizzlies,G,67,192,23,49,431.8,1,1,100.0,20,42,431.8,1,13,14,39,10,9,12,2,-59,120,81,106,53,341.01385041551254,15.504155124653737,43.28808864265928,29.750692520775623,656.0166204986151,445.7479224376731,519.5041551246537,90.57063711911357,9
197,Jacob Toppin,New York Knicks,F,13,29,5,9,107.1,2,2,100.0,1,4,33.3,3,3,6,1,3,0,1,0,-18,20,19,14,7,78.05555555555556,8.722222222222221,0.5555555555555556,0.7222222222222223,130.22222222222223,136.55555555555554,72.5,8.5,2
198,Jaden Hardy,Dallas Mavericks,G,77,116,32,65,499.4,4,5,250.0,9,21,300.0,1,9,10,18,10,3,7,1,9,105,87,95,28,166.3671664744329,10.034602076124568,32.332179930795846,7.204536716647443,248.02345251826222,192.93233371780084,209.13994617454827,54.68512110726643,10
199,Jaden Ivey,Detroit Pistons,PG,140,308,51,135,385.8,27,33,741.7,11,50,215.1,7,27,34,42,25,9,26,6,-67,216,174,182,76,125.62629757785467,26.991157247212612,60.87812379853903,9.479046520569012,246.6889657823914,169.46635909265672,189.66474432910417,101.05344098423683,10
200,Jaden McDaniels,Minnesota Timberwolves,PF,126,309,51,113,443.9,10,17,348.8,14,46,271.2,11,34,45,9,34,10,10,6,-10,180,171,135,54,483.16598079561044,34.47530864197531,8.966392318244171,16.5,545.9012345679013,556.3161865569273,472.4753086419753,43.717421124828526,10
201,Jaden Springer,Boston Celtics,G,60,176,22,52,413.7,13,14,575.0,3,18,183.3,13,18,31,17,21,13,10,4,-19,108,91,77,48,223.46260387811634,50.5,30.390581717451518,2.5886426592797784,669.220221606648,469.7520775623268,361.19390581717454,142.62742382271472,10
202,Jae Crowder,Milwaukee Bucks,PF,61,197,24,47,467.9,2,2,100.0,11,26,383.3,5,15,20,11,16,8,2,1,-11,92,81,72,31,98.00960219478738,11.21604938271605,9.216049382716049,9.15363511659808,133.67626886145405,139.55075445816183,93.56721536351168,19.0,10
203,Jae'Sean Tate,Houston Rockets,SF,44,138,18,37,419.1,5,9,200.0,3,8,233.3,11,19,30,8,17,6,13,5,-15,82,74,52,38,94.704,32.356,5.856,2.136,219.204,175.39600000000002,120.624,56.1,10
204,Jahmi'us Ramsey,Toronto Raptors,SG,47,120,18,41,306.3,5,6,175.0,6,22,183.3,4,18,22,8,10,7,7,0,-28,77,69,55,30,69.3801652892562,36.066115702479344,3.072314049586777,3.402892561983472,97.25413223140495,108.65289256198346,77.28719008264463,19.832644628099175,7
205,Jaime Jr. Jaquez,Miami Heat,G,104,291,39,86,430.4,18,25,616.7,8,25,244.89999999999998,9,40,49,27,20,12,9,3,3,180,153,131,76,399.9229968782518,41.14984391259105,22.292403746097815,7.839750260145682,373.75650364203955,369.74921956295526,390.9687825182102,76.40374609781477,10
206,Jake LaRavia,Memphis Grizzlies,F,129,284,37,104,352.29999999999995,35,44,618.9,20,57,338.0,21,22,43,23,21,15,10,2,-49,195,172,152,66,330.38946280991735,39.276859504132226,28.447314049586776,32.41838842975207,527.8223140495868,425.9142561983471,422.198347107438,77.82334710743802,10
207,Jakob Poeltl,Toronto Raptors,C,122,251,55,101,543.9,12,20,491.7,0,0,0.0,39,53,92,31,28,10,11,19,35,245,214,153,123,161.8469387755102,127.67346938775509,30.387755102040813,0.0,516.704081632653,398.98979591836735,256.6224489795918,181.0,10
208,Jalen Brunson,New York Knicks,PG,318,333,120,248,481.7,48,56,759.1,30,83,382.7,7,26,33,64,11,9,19,2,129,415,351,382,97,1746.618013527946,14.185475258098968,42.536845852616594,16.69775720897116,1501.4656461374154,1751.5525097899608,1492.7148451406194,60.53862584549662,10
209,Jalen Duren,Detroit Pistons,C,138,276,53,82,615.6,32,40,730.0,0,0,0.0,34,97,131,21,28,8,28,7,-30,290,269,159,152,309.6333153055706,203.6392644672796,26.902650081124932,0.0,1027.0081124932394,906.4256354786371,370.6830719307734,290.0746349378042,10
210,Jalen Green,Houston Rockets,SG,305,376,106,213,491.0,48,64,796.7,45,100,434.0,10,61,71,40,16,11,24,6,149,416,376,345,111,798.7360285374555,86.5,22.502378121284185,40.66706302021403,1185.203329369798,1100.6498216409036,846.5998810939357,145.69203329369796,10
211,Jalen HoodSchifino,Los Angeles Lakers,G,5,11,1,6,33.3,2,4,100.0,1,3,50.0,0,2,2,0,1,0,1,0,-13,7,7,5,2,9.0,0.9799999999999999,0.020000000000000004,0.8200000000000001,13.32,14.180000000000001,8.42,0.72,2
212,Jalen Johnson,Atlanta Hawks,SF,178,339,71,149,485.0,19,29,568.3,17,46,399.9,13,75,88,44,19,7,16,11,35,310,266,222,132,520.0495867768595,92.6317722681359,50.47199265381084,14.673094582185492,1012.7970615243343,701.9265381083562,770.7750229568411,203.24885215794305,10
213,Jalen McDaniels,Toronto Raptors,PF,45,148,20,51,340.6,2,4,66.7,3,17,116.7,6,20,26,11,16,7,16,2,-73,82,71,56,37,168.30864197530863,93.38271604938272,14.190672153635118,4.4567901234567895,435.1330589849108,347.27160493827154,217.47050754458164,146.27297668038406,10
214,Jalen Pickett,Denver Nuggets,G,2,7,1,3,33.3,0,0,0.0,0,2,0.0,0,0,0,2,0,0,0,0,-1,4,2,4,2,3.188775510204082,0.18367346938775508,1.1479591836734693,0.0,5.89795918367347,1.8418367346938778,8.16326530612245,0.4132653061224489,1
215,Jalen Slawson,Sacramento Kings,F,2,8,1,2,50.0,0,0,0.0,0,1,0.0,1,1,2,0,2,1,0,0,3,4,4,2,2,2.339100346020761,1.9930795847750862,0.0,0.0,8.65051903114187,8.65051903114187,2.339100346020761,1.9930795847750862,1
216,Jalen Smith,Indiana Pacers,PF,84,163,30,56,504.7,14,22,350.0,10,25,345.2,21,33,54,10,22,3,2,7,14,148,138,94,64,196.44444444444446,58.40625,18.52517361111111,10.004340277777779,360.62934027777777,297.68402777777777,257.2751736111111,79.04600694444444,10
217,Jalen Suggs,Orlando Magic,SG,129,279,45,97,462.3,16,22,633.3,23,55,417.5,5,22,27,33,21,16,14,5,64,189,156,162,60,333.8192148760331,28.702479338842977,18.298553719008265,20.637396694214875,447.7396694214876,378.0051652892562,389.0619834710744,61.492768595041326,10
218,Jalen Williams,Oklahoma City Thunder,F,193,300,78,151,524.0,24,27,796.7,13,38,256.6,8,29,37,47,24,13,23,12,34,277,230,240,84,343.0717455621302,24.125,40.44082840236686,14.866863905325443,613.3284023668639,418.6390532544379,507.3764792899408,94.95044378698225,10
219,Jalen Wilson,Brooklyn Nets,F,41,131,15,37,473.3,8,9,350.0,3,14,175.0,7,19,26,9,9,1,7,0,29,76,67,50,35,108.59012345679012,28.444444444444446,7.049382716049382,2.308641975308642,236.0,188.38271604938274,136.84444444444443,54.85679012345679,10
220,Jamal Cain,Miami Heat,F,12,37,3,9,125.0,4,4,200.0,2,4,150.0,2,3,5,6,5,1,3,1,11,23,17,18,11,10.798185941043085,3.7029478458049887,6.199546485260771,1.183673469387755,34.91383219954649,20.777777777777782,27.795918367346932,7.040816326530612,4
221,Jamal Murray,Denver Nuggets,PG,227,360,87,190,450.6,33,39,861.4,20,50,410.0,10,43,53,82,18,16,22,3,51,362,280,309,135,463.3490304709141,47.16481994459834,73.01523545706371,20.02770083102493,650.9362880886429,468.5,620.0124653739612,145.95290858725764,10
222,James Bouknight,Charlotte Hornets,SG,10,13,4,10,83.3,0,0,0.0,2,7,58.3,0,0,0,0,0,1,1,0,13,10,10,10,0,18.0,0.0,0.0,0.72,18.0,18.0,18.0,0.0,2
223,James Harden,LA Clippers,SG,132,356,44,117,380.7,24,27,905.0,20,68,255.4,7,46,53,100,16,13,26,5,-38,285,185,232,153,117.06776859504133,60.285950413223134,106.97520661157023,24.84628099173554,342.84793388429756,166.59999999999994,315.8280991735537,144.7487603305785,10
224,James Johnson,Indiana Pacers,PF,4,12,1,4,33.3,2,2,100.0,0,1,0.0,0,0,0,2,3,0,1,1,-2,6,4,6,2,1.5802469135802468,0.0,0.3950617283950617,0.0,3.5555555555555554,1.5802469135802468,3.5555555555555554,0.3950617283950617,2
225,James Wiseman,Detroit Pistons,C,100,222,38,68,468.6,24,28,520.8,0,0,0.0,20,54,74,12,25,1,20,6,-91,186,174,112,86,415.15599999999995,91.3,15.604000000000001,0.0,831.6360000000001,705.216,530.896,117.584,10
226,Jamie Jr. Jaquez,Miami Heat,G,34,96,14,31,181.0,4,5,175.0,2,11,45.0,1,5,6,11,10,1,3,0,-18,51,40,45,17,58.265625,5.25,9.3125,1.0625,116.390625,96.640625,72.265625,20.3125,4
227,Jarace Walker,Indiana Pacers,F,34,141,12,34,332.2,2,2,100.0,8,20,300.0,3,25,28,17,11,5,7,6,32,79,62,51,45,127.62122788761705,47.64203954214359,62.39229968782517,7.950052029136317,489.8782518210198,291.8231009365244,265.94276795005203,169.76795005202916,10
228,Jared Butler,Washington Wizards,SG,63,206,27,69,404.7,5,5,300.0,4,25,103.4,4,17,21,42,18,10,22,3,-18,126,84,105,63,166.7530864197531,20.91111111111111,144.31111111111113,4.404938271604938,546.4197530864197,180.89382716049383,456.50123456790124,241.0,10
229,Jared Rhoden,Detroit Pistons,G,19,67,8,15,203.3,0,0,0.0,3,7,133.3,0,11,11,4,8,1,4,4,-20,34,30,23,15,30.34948096885813,8.792387543252595,6.221453287197232,0.7577854671280277,54.768166089965405,71.16262975778547,21.76124567474048,7.2076124567474045,4
230,Jaren Jackson Jr.,Memphis Grizzlies,PF,228,341,82,192,434.7,48,65,723.9,16,55,282.9,21,46,67,31,43,16,28,22,-111,326,295,259,98,455.796786389414,148.1899810964083,33.48771266540643,12.41209829867675,678.6275992438563,865.1512287334593,343.09357277882793,107.85727788279772,10
231,Jarred Vanderbilt,Los Angeles Lakers,PF,68,142,26,42,412.7,13,17,375.0,3,5,166.7,12,22,34,12,8,16,11,2,23,114,102,80,46,111.33333333333334,59.333333333333336,18.0,3.5,362.0,274.0,157.33333333333334,119.33333333333334,6
232,Jarrett Allen,Cleveland Cavaliers,C,168,317,67,101,649.6,34,42,812.4,0,0,0.0,19,86,105,24,14,4,13,7,-46,297,273,192,129,292.62128418549344,168.50951248513675,20.5,0.0,795.3156956004756,708.6432818073722,334.39714625445896,233.9060642092747,10
233,Jason Preston,Utah Jazz,G,4,25,2,6,66.6,0,0,0.0,0,0,0.0,2,4,6,7,1,0,1,0,10,17,10,11,13,1.2800000000000002,4.275555555555554,7.879999999999999,0.0,32.55555555555556,8.96888888888889,13.32,23.70222222222222,2
234,Javon Freeman-Liberty,Toronto Raptors,G,71,196,25,56,347.7,18,20,730.0,3,20,108.3,6,26,32,20,14,4,11,2,-54,123,103,91,52,230.525494276795,11.401664932362124,7.880332986472425,2.175858480749219,319.5306971904266,303.0405827263267,240.0,26.297606659729453,9
235,Javonte Green,Chicago Bulls,G,12,35,5,7,141.7,0,0,0.0,2,3,150.0,0,5,5,1,3,2,2,1,28,18,17,13,6,2.222222222222222,5.0,0.5555555555555556,0.0,2.222222222222223,0.5555555555555551,0.5555555555555558,8.88888888888889,2
236,Jaxson Hayes,Los Angeles Lakers,C,62,160,23,29,854.0,16,23,625.0,0,0,0.0,13,31,44,4,22,1,10,2,-16,110,106,66,48,122.06310013717423,97.69067215363512,4.439643347050755,0.0,294.0548696844993,296.58779149519887,122.27777777777776,99.38271604938272,10
237,Jay Huff,Denver Nuggets,C,3,5,1,2,50.0,0,0,0.0,1,2,50.0,0,0,0,0,2,0,0,0,-3,3,3,3,0,5.0625,0.2025,0.0,0.7224999999999999,3.24,3.24,5.0625,0.2025,1
238,Jaylen Brown,Boston Celtics,SG,280,354,110,215,510.3,36,58,525.9,24,66,348.6,18,37,55,29,25,17,18,2,73,364,335,309,84,599.4674556213017,118.58053911900066,20.900065746219592,17.284681130834976,1048.4444444444443,1024.3872452333992,608.5292570677185,154.47600262984878,10
239,Jaylin Williams,Oklahoma City Thunder,F,27,120,10,22,425.0,0,0,0.0,7,17,424.9,2,33,35,14,15,4,7,6,-8,76,62,41,49,39.556434818825494,44.625989171178674,30.58142440649729,2.1120366513952518,148.5814244064973,132.32569762598916,63.50978758850479,67.50978758850479,10
240,Jayson Tatum,Boston Celtics,SF,289,371,95,211,449.9,66,78,842.0,33,80,403.5,13,54,67,57,18,12,29,6,77,413,356,346,124,376.9597107438017,95.4555785123967,30.5,20.11673553719008,493.80991735537185,634.9462809917355,248.55061983471074,113.22830578512398,10
241,Jeenathan Williams,Houston Rockets,G,12,26,6,10,133.4,0,2,0.0,0,0,0.0,3,3,6,0,5,1,0,0,18,18,18,12,6,47.6734693877551,5.6772959183673475,0.03443877551020408,0.0,74.38775510204081,76.5344387755102,46.23852040816327,5.0,3
242,Jeff Dowtin,Philadelphia 76ers,G,31,81,11,19,237.1,2,2,100.0,7,14,216.7,1,9,10,16,0,4,3,1,18,57,41,47,26,144.24260355029585,15.798816568047336,33.124260355029584,5.118343195266272,386.8934911242603,201.03550295857988,297.3195266272189,81.70414201183432,6
243,Jeff Green,Houston Rockets,PF,89,191,32,70,451.4,9,11,325.0,16,39,428.3,5,25,30,7,11,2,4,4,31,126,119,96,37,280.3698979591837,36.028698979591844,2.40625,12.758290816326532,411.9183673469388,419.32461734693874,279.1511479591837,32.24744897959184,10
244,Jerami Grant,Portland Trail Blazers,SF,169,342,56,142,386.6,38,46,711.3,19,49,402.0,6,19,25,35,18,14,28,2,-77,229,194,204,60,473.98961937716257,45.9204152249135,32.71626297577855,5.083044982698962,888.6262975778548,739.6678200692041,583.0934256055364,118.49134948096886,10
245,Jeremiah Robinson-Earl,New Orleans Pelicans,F,28,92,11,25,269.6,4,7,80.0,2,10,100.0,9,12,21,10,6,3,3,1,37,59,49,38,31,81.67999999999999,38.28,29.892244897959184,1.6473469387755102,257.9208163265306,171.0,139.46938775510205,97.30367346938777,8
246,Jeremy Sochan,San Antonio Spurs,F,126,301,51,121,422.6,14,19,516.7,10,44,192.79999999999998,21,59,80,33,16,14,20,10,-20,239,206,159,113,546.4194197069808,205.26687733409938,40.8075265728239,10.103418557885664,1127.044814708417,1162.0,509.1683424303361,248.37029589198505,10
247,Jericho Sims,New York Knicks,C,11,149,5,9,266.7,1,2,50.0,0,0,0.0,16,25,41,5,11,5,5,5,17,57,52,16,46,28.11111111111111,85.88775510204081,4.86281179138322,0.0,180.06122448979593,164.23696145124717,36.132653061224495,98.55328798185941,10
248,Jerome Robinson,Golden State Warriors,SG,10,17,4,10,40.0,1,2,50.0,1,6,16.7,0,0,0,1,1,0,0,1,-2,11,10,11,1,70.56,0.09,0.6400000000000001,0.81,79.21000000000001,65.61,84.63999999999999,0.25,1
249,Jett Howard,Orlando Magic,G,0,5,0,1,0.0,0,0,0.0,0,1,0.0,0,0,0,0,1,0,0,0,-5,0,0,0,0,0.25,0.0,0.0,0.027777777777777776,0.25,0.25,0.25,0.0,1
250,Jevon Carter,Chicago Bulls,PG,45,146,18,36,398.5,1,2,50.0,8,21,241.7,1,8,9,13,10,2,4,1,14,67,54,58,22,176.5013520822066,13.188209843158464,8.119524067063278,7.670091941590049,262.2298539751217,218.65008112493237,203.63115197404002,37.75770686857761,10
251,Jimmy Butler,Miami Heat,SF,182,337,62,129,481.4,51,59,846.3,7,27,266.6,11,36,47,54,15,14,17,2,87,283,229,236,101,426.2777777777778,39.17438271604938,40.44444444444444,5.174382716049382,611.729938271605,521.5447530864196,480.5,115.58179012345678,10
252,Jock Landale,Houston Rockets,C,98,230,38,59,644.6,18,22,483.3,4,9,250.0,24,30,54,21,24,3,10,14,86,173,152,119,75,225.70000000000002,82.976,38.056000000000004,4.4639999999999995,676.3240000000001,501.556,355.63599999999997,165.864,10
253,Joe Harris,Detroit Pistons,SF,2,12,1,3,33.3,0,0,0.0,0,1,0.0,0,0,0,0,1,0,0,0,-5,2,2,2,0,0.0,0.0,0.0,0.0,0.0,0.0,0.0,0.0,1
254,Joe Ingles,Orlando Magic,SG,38,170,12,23,403.3,5,6,250.0,9,18,375.0,1,17,18,30,12,7,9,0,55,86,56,68,48,105.83884110457221,9.626075147125396,14.289723856948845,9.079674060660933,108.33227704843821,90.0,126.34495246717971,21.741964689904936,10
255,Joel Embiid,Philadelphia 76ers,C,45,61,16,38,82.8,9,12,170.0,4,10,83.3,2,12,14,5,6,2,10,0,-41,64,59,50,19,144.5,0.0,0.5,0.0,162.0,144.5,162.0,0.5,2
256,John Collins,Utah Jazz,PF,193,271,68,119,570.0,39,48,752.5,18,34,508.9,22,58,80,7,25,7,12,7,-49,280,273,200,87,378.3684585261659,95.14061943752225,7.96689213243147,12.805268778924885,702.2249911000356,680.2680669277323,382.12958348166615,121.30331078675684,10
257,John Konchar,Memphis Grizzlies,SG,57,299,19,46,385.8,8,9,266.7,11,29,391.6,19,45,64,29,20,13,17,9,-3,150,121,86,93,131.325,70.55625,15.0,7.125,291.05625,223.40625,166.425,118.10624999999999,10
258,Johnny Davis,Washington Wizards,G,35,154,15,39,354.7,2,2,100.0,3,14,83.3,3,10,13,11,11,4,0,6,-55,59,48,46,24,74.53086419753086,16.429355281207133,10.901234567901234,4.179012345679013,185.51577503429357,136.16186556927298,122.44444444444444,28.77091906721536,10
259,Johnny Juzang,Utah Jazz,G,70,179,27,55,408.3,1,1,100.0,15,39,302.5,5,15,20,9,14,0,6,0,-3,99,90,79,29,334.9218407596786,24.467494521548577,9.28926223520818,24.58948137326516,422.0021913805698,417.72680788897003,336.34404674945216,36.6099342585829,10
260,Jonas Valanciunas,New Orleans Pelicans,C,75,180,32,60,557.9,9,12,400.0,2,11,83.3,13,56,69,13,24,2,10,5,-5,157,144,88,82,195.98614958448752,50.252077562326875,20.612188365650972,1.6078793474915356,310.5235457063711,349.4958448753463,187.10249307479222,40.77562326869805,10
261,Jonathan Isaac,Orlando Magic,PF,106,180,39,59,670.3,10,13,383.4,18,29,660.0,13,39,52,5,11,8,2,16,74,163,158,111,57,298.625,24.65625,4.7250000000000005,10.90625,359.35625000000005,397.65625,269.3,20.40625,10
262,Jonathan Kuminga,Golden State Warriors,PF,202,306,78,150,521.6,38,48,706.7,8,20,300.1,9,39,48,23,32,10,20,4,15,273,250,225,71,279.6358418367347,71.72257653061224,12.28890306122449,9.707270408163264,319.1103316326531,278.1734693877551,318.33673469387753,86.24744897959184,10
263,Jontay Porter,Toronto Raptors,C,49,159,18,41,352.3,4,6,150.0,9,26,230.4,10,23,33,32,11,10,13,9,-28,114,82,81,65,215.4023668639053,32.251479289940825,58.16863905325444,15.943786982248522,472.0,275.0917159763314,386.0976331360947,116.63313609467455,10
264,Jordan Clarkson,Utah Jazz,PG,161,328,58,144,353.7,31,35,737.9,14,53,206.6,7,29,36,63,18,10,23,0,-70,260,197,224,99,1033.4444444444443,104.45816186556928,72.74211248285323,21.23456790123457,1453.7777777777774,1423.9519890260628,1051.0260631001372,189.44444444444443,10
265,Jordan Goodwin,Memphis Grizzlies,G,71,257,29,86,350.5,5,12,225.0,8,31,229.89999999999998,13,33,46,42,16,16,17,10,-68,159,117,113,88,126.34693877551021,125.45124716553288,71.55102040816327,3.927437641723356,424.77777777777777,290.328798185941,134.67346938775506,323.12471655328795,10
266,Jordan Hawkins,New Orleans Pelicans,G,33,104,12,38,331.3,3,5,116.7,6,24,165.0,1,10,11,6,5,1,2,1,20,50,44,39,17,70.8716049382716,12.960493827160493,6.404938271604938,6.419753086419753,71.11111111111111,79.6641975308642,69.5530864197531,12.130864197530865,10
267,Jordan McLaughlin,Minnesota Timberwolves,PG,62,164,21,34,594.4,4,4,200.0,16,25,511.1,5,20,25,22,6,5,2,1,66,109,87,84,47,162.8771345272803,31.1740941274469,21.92253227821741,22.768013327780093,188.3577675968346,199.7155351936693,149.0637234485631,55.552269887546856,10
268,Jordan Miller,LA Clippers,G,4,5,1,1,100.0,2,2,100.0,0,0,0.0,0,1,1,0,0,0,0,0,3,5,5,4,1,9.679012345679013,0.44444444444444453,0.0,0.0,14.271604938271604,14.271604938271604,9.679012345679013,0.44444444444444453,1
269,Jordan Nwora,Toronto Raptors,SF,103,184,42,77,541.1,8,10,416.7,11,33,334.9,1,36,37,11,10,12,18,5,-33,151,140,114,48,183.94423440453684,41.66540642722117,9.093572778827976,7.43100189035917,232.62948960302458,262.5567107750473,152.5179584120983,52.258034026465026,10
270,Jordan Poole,Washington Wizards,SG,192,318,72,163,424.2,20,21,680.0,28,80,345.8,5,25,30,53,28,9,28,2,-58,275,222,245,83,880.92448266595,36.01074979844128,96.2066648750336,19.613007256113946,1228.3872614888471,1040.6965869389949,1040.6828809459823,160.14969094329481,10
271,Jordan Walsh,Boston Celtics,G,2,27,1,4,100.0,0,0,0.0,0,2,0.0,2,4,6,1,5,2,2,1,24,9,8,3,7,2.8099173553719012,13.355371900826448,0.8347107438016528,0.0,1.1983471074380163,4.0,6.68595041322314,7.512396694214876,2
272,Jose Alvarado,New Orleans Pelicans,PG,66,206,22,58,360.1,7,10,350.0,15,33,450.4,6,19,25,23,19,8,5,1,32,114,91,89,48,184.336,40.756,32.775999999999996,14.504000000000001,467.79600000000005,312.5,293.8,119.36399999999999,10
273,Josh Giddey,Oklahoma City Thunder,SG,175,252,73,132,545.8,12,16,463.6,17,44,366.1,19,52,71,52,16,4,17,5,82,298,246,227,123,592.7777777777778,78.39550630963373,51.74515235457064,22.4016620498615,802.7436134195136,711.6762080640195,646.7685441674361,167.21729763004004,10
274,Josh Green,Dallas Mavericks,SG,67,259,28,55,498.7,4,5,80.0,7,23,270.0,11,24,35,13,16,11,9,2,-34,115,102,80,48,175.42568370986916,41.573127229488705,10.20332936979786,7.416171224732463,227.9346016646849,241.15576694411413,176.20927467300828,37.77170035671819,10
275,Josh Hart,New York Knicks,SG,93,400,37,102,368.4,13,16,458.3,6,38,137.6,25,90,115,61,24,12,17,2,111,269,208,154,176,200.5746173469388,189.12244897959184,148.00318877551018,4.814413265306122,1139.7755102040817,692.6511479591836,554.530612244898,430.2940051020408,10
276,Josh Minott,Minnesota Timberwolves,F,0,5,0,0,0.0,0,0,0.0,0,0,0.0,0,4,4,0,0,0,0,0,6,4,4,0,4,2.5600000000000005,11.902500000000002,0.010000000000000002,0.09,3.0625,3.4225000000000003,2.8899999999999997,11.2225,1
277,Josh Okogie,Phoenix Suns,SF,43,135,12,30,323.8,12,13,450.0,7,15,350.0,13,7,20,11,7,6,10,3,-9,74,63,54,31,140.65625,12.625,7.236111111111112,6.3506944444444455,202.10069444444443,191.90625,145.76736111111111,24.944444444444443,10
278,Josh Richardson,Miami Heat,SG,98,211,38,76,433.2,6,6,200.0,16,45,301.7,4,26,30,19,16,5,3,2,3,147,128,117,49,296.8888888888889,20.0,10.88888888888889,27.555555555555557,468.0,427.55555555555554,344.0,24.22222222222222,9
279,Joshua Primo,LA Clippers,G,0,5,0,1,0.0,0,0,0.0,0,0,0.0,1,0,1,0,0,0,1,0,1,1,1,0,1,0.0,0.0,0.0,0.0,0.0,0.0,0.0,0.0,1
280,Jrue Holiday,Boston Celtics,PG,115,325,45,82,560.0,4,4,200.0,21,44,548.5,9,30,39,54,12,13,16,11,105,208,154,169,93,84.5743162901308,53.014268727705115,52.40190249702734,6.909631391200951,227.60047562425686,188.40428061831153,165.0,64.18668252080856,10
281,Jules Bernard,Washington Wizards,G,40,80,15,34,366.2,3,5,200.0,7,15,335.0,6,8,14,10,6,2,3,1,12,64,54,50,24,209.5811111111111,10.247777777777776,14.194444444444445,6.03111111111111,341.52777777777777,259.0,290.0311111111111,26.52,7
282,Julian Champagnie,San Antonio Spurs,F,75,245,25,61,345.0,10,13,466.7,15,40,290.0,3,20,23,10,12,8,8,5,3,108,98,85,33,259.0523186682521,26.434007134363853,6.297265160523186,18.212247324613553,407.7384066587396,395.5077288941736,264.65279429250893,39.3614744351962,10
283,Julian Phillips,Chicago Bulls,F,39,132,13,31,272.9,7,8,266.7,6,13,283.4,6,12,18,5,12,5,3,1,-11,62,57,44,23,170.91975308641975,27.290123456790123,6.777777777777779,6.401234567901234,314.4444444444444,289.44444444444446,184.5493827160494,45.43827160493827,10
284,Julian Strawther,Denver Nuggets,G,23,49,8,22,83.0,4,4,200.0,3,15,48.6,1,4,5,5,4,1,4,0,-3,33,28,28,10,103.16446124763702,7.754253308128543,4.599243856332702,2.56710775047259,171.79773156899813,151.65973534971644,117.0,18.655954631379963,3
285,Julius Randle,New York Knicks,PF,66,99,23,48,142.2,14,14,300.0,6,11,195.0,8,17,25,18,7,1,10,0,25,109,91,84,43,98.0,2.666666666666667,14.0,2.0,140.66666666666669,120.66666666666666,126.0,8.666666666666668,3
286,Justin Champagnie,Washington Wizards,SF,53,142,17,46,209.3,10,12,250.0,9,30,158.3,11,17,28,11,11,6,8,5,-40,92,81,64,39,257.2057142857143,76.9657142857143,7.7142857142857135,9.434285714285714,667.92,596.7771428571428,304.3485714285714,108.68,7
287,Justin Holiday,Denver Nuggets,SF,39,140,15,35,299.0,0,0,0.0,9,24,216.7,1,11,12,9,13,6,1,1,11,60,51,48,21,211.48224852071004,11.678254437869823,13.363905325443787,15.284763313609467,377.61908284023673,272.75813609467457,297.5621301775148,43.82322485207101,10
288,Justin Minaya,Portland Trail Blazers,F,14,110,5,19,199.89999999999998,1,2,50.0,3,14,116.6,7,11,18,4,8,3,4,3,-44,36,32,18,22,22.409972299168977,17.03601108033241,2.8656509695290855,2.1135734072022165,50.322714681440445,55.2853185595568,18.21191135734072,19.137119113573405,10
289,Jusuf Nurkic,Phoenix Suns,C,83,266,35,69,519.5,13,32,305.4,0,0,0.0,37,76,113,33,28,7,21,9,-10,229,196,116,146,61.0,300.3819864720541,32.525097899608404,0.0,571.3965824136703,529.2310430758278,86.61943752224992,349.45318618725526,10
290,Karl-Anthony Towns,Minnesota Timberwolves,C,193,306,66,146,451.8,41,47,734.2,20,56,341.5,20,55,75,29,33,8,24,8,98,297,268,222,104,265.0493827160493,98.62345679012346,46.91975308641975,18.771604938271604,548.530864197531,414.4012345679012,362.2777777777778,182.44444444444443,10
291,Kawhi Leonard,LA Clippers,SF,222,322,85,158,536.1,37,43,815.0,15,42,360.8,13,43,56,28,10,13,21,11,46,306,278,250,84,433.14539102391836,74.58962644450416,8.696586938994894,8.613544746036013,698.5643644181673,600.9830690674551,493.4146734748723,120.59822628325719,10
292,Keegan Murray,Sacramento Kings,SF,158,352,58,130,449.3,17,22,366.7,25,70,342.7,15,48,63,17,29,9,8,10,37,238,221,175,80,188.83941396150533,86.36512496409077,14.370295891985062,37.103993105429474,339.4438379775927,243.87388681413384,271.21200804366555,113.93277793737431,10
293,Keita Bates-Diop,Brooklyn Nets,SF,35,85,12,20,615.0,6,6,300.0,5,11,350.0,3,10,13,5,1,2,5,4,-13,53,48,40,18,52.10000000000001,16.81111111111111,4.677777777777777,5.4,94.5,87.3777777777778,51.511111111111106,29.2,10
294,Keldon Johnson,San Antonio Spurs,SF,160,297,56,113,491.7,25,30,584.2,23,61,384.9,15,43,58,21,14,4,9,1,-21,239,218,181,79,302.78815840061515,57.73625528642829,24.91695501730104,28.560938100730493,346.0119184928874,366.50211457131877,321.3683198769704,43.58285274894271,10
295,Kelly Olynyk,Toronto Raptors,PF,141,290,57,99,577.4,16,21,480.0,11,27,383.3,17,40,57,59,42,10,38,8,-106,257,198,200,116,264.5,29.016,89.256,10.344000000000001,436.5000000000001,354.196,342.27600000000007,122.79999999999998,10
296,Kelly Oubre Jr.,Philadelphia 76ers,SG,160,323,61,159,379.0,27,36,502.4,11,45,196.6,20,42,62,23,26,11,19,11,-30,245,222,183,85,312.6947873799726,102.64540466392319,32.19272976680384,10.900548696844993,652.5137174211249,561.7777777777777,399.5679012345679,138.70096021947873,10
297,Kendall Brown,Indiana Pacers,SG,3,12,1,1,100.0,1,2,50.0,0,0,0.0,1,0,1,0,1,0,0,0,1,4,4,3,1,4.5765595463138,0.5463137996219282,0.3062381852551985,0.0,8.003780718336484,8.24196597353497,4.5765595463138,0.6143667296786388,2
298,Kenneth Lofton Jr.,Philadelphia 76ers,F,2,5,1,4,25.0,0,0,0.0,0,2,0.0,0,1,1,0,0,0,0,0,-4,3,3,2,1,0.0,0.0,0.0,0.0,0.0,0.0,0.0,0.0,1
299,Kenrich Williams,Oklahoma City Thunder,SF,51,154,21,45,414.6,2,2,100.0,7,22,250.0,19,26,45,14,19,10,2,1,29,110,96,65,59,102.90311418685121,54.113417916186094,8.991157247212609,6.2079969242599,224.05690119184928,175.70857362552866,129.00845828527488,85.34755863129567,10
300,Kentavious Caldwell-Pope,Denver Nuggets,SG,76,316,28,63,413.40000000000003,5,6,300.0,15,38,343.3,4,22,26,28,20,14,12,9,56,130,102,104,54,187.29797080811676,24.462798148807405,31.719473122107512,10.892488430046281,282.8159487362051,262.9590601637593,187.48451406194374,75.85261658953364,10
301,Kenyon Martin Jr.,Philadelphia 76ers,F,47,162,18,37,486.1,8,12,400.0,3,8,250.0,11,22,33,13,31,4,7,3,6,93,80,60,46,119.9889053254438,130.125,18.125,2.109467455621302,553.065828402367,437.82544378698225,205.4792899408284,178.0,10
302,Keon Ellis,Sacramento Kings,G,89,291,33,63,524.1,5,7,300.0,18,41,422.1,5,30,35,17,29,19,6,10,71,141,124,106,52,321.764,40.804,30.115999999999996,19.364,624.4359999999999,468.0,442.816,106.304,10
303,Keon Johnson,Brooklyn Nets,G,12,26,3,8,73.3,4,4,100.0,2,4,133.3,2,1,3,2,2,2,2,0,-9,17,15,14,5,18.88888888888889,0.5555555555555556,2.2222222222222223,0.22222222222222227,27.222222222222225,13.888888888888888,34.0,1.0,2
304,Kessler Edwards,Sacramento Kings,SF,33,83,12,27,306.7,1,2,50.0,8,18,311.7,4,13,17,4,10,5,1,1,6,54,50,37,21,137.0,20.0,2.605442176870748,10.998299319727892,196.65306122448982,183.0,140.4625850340136,32.795918367346935,9
305,Kevin Durant,Phoenix Suns,PF,232,353,93,172,532.1999999999999,22,26,646.7,24,55,440.4,4,65,69,36,14,10,33,15,16,337,301,268,105,566.0494110887676,76.0376328641195,34.68026429187016,21.191611605860384,926.1950588911233,777.8256248204539,670.8055156564205,154.331226659006,10
306,Kevin Huerter,Sacramento Kings,SG,72,231,29,79,330.1,2,4,100.0,12,45,205.0,6,24,30,25,23,8,11,2,5,127,102,97,55,288.7933884297521,30.44995408631772,4.61248852157943,16.24793388429752,456.10743801652893,441.77777777777777,290.6730945821855,47.51239669421488,10
307,Kevin Knox II,Detroit Pistons,SF,22,89,9,26,148.9,3,3,200.0,1,11,33.3,3,11,14,4,9,2,6,0,21,40,36,26,18,115.33333333333334,19.333333333333336,3.3333333333333335,0.8333333333333335,167.33333333333331,188.0,101.33333333333334,16.0,6
308,Kevin Love,Miami Heat,PF,88,158,30,62,483.6,10,14,208.3,18,45,387.4,10,55,65,19,20,3,10,3,31,172,153,107,84,362.530612244898,61.03061224489795,13.244897959183673,16.97959183673469,574.7448979591837,534.5,405.0,72.05102040816325,10
309,Kevon Looney,Golden State Warriors,F,38,114,16,26,635.0,6,11,225.0,0,0,0.0,6,31,37,9,18,1,5,4,33,84,75,47,46,50.35625,53.0,2.95625,0.0,140.5,148.50625,44.5,53.80625,10
310,Keyontae Johnson,Oklahoma City Thunder,F,5,39,2,8,66.7,0,0,0.0,1,2,100.0,2,4,6,2,4,0,2,0,-15,13,11,7,8,20.0,7.0,1.2653061224489797,0.8163265306122451,29.69387755102041,35.0,17.26530612244898,5.6938775510204085,5
311,Keyonte George,Utah Jazz,G,152,326,51,142,350.9,36,39,845.8,14,65,217.5,0,31,31,53,17,6,39,2,-124,236,183,205,84,439.1488033298647,35.20343392299688,39.09937565036421,20.924557752341315,395.26742976066595,398.58116545265347,477.53642039542143,32.60145681581686,10
312,Khris Middleton,Milwaukee Bucks,SF,136,298,54,119,484.2,11,13,430.0,17,48,431.2,10,48,58,63,37,8,27,4,10,257,194,199,121,266.36762688614544,66.16186556927298,64.75034293552812,4.111111111111111,469.0,276.2688614540467,425.45816186556925,164.55281207133058,10
313,Killian Hayes,Detroit Pistons,PG,18,79,7,14,209.6,1,3,33.3,3,6,100.0,0,15,15,20,4,0,5,2,-12,53,33,38,35,27.0,18.75,54.0,2.75,252.75,74.75,153.0,124.75,4
314,Kira Lewis Jr.,Utah Jazz,PG,17,45,6,15,94.4,3,4,75.0,2,5,83.3,2,4,6,7,1,0,4,0,-25,30,23,24,13,100.40484429065745,17.885813148788927,13.207612456747404,1.2214532871972321,273.45674740484435,200.88927335640136,152.69896193771623,51.36678200692042,4
315,Klay Thompson,Golden State Warriors,SG,199,292,72,161,442.4,14,15,550.0,41,101,401.8,5,21,26,24,13,6,16,4,24,249,225,223,50,371.9696789536266,27.384661117717002,40.42330558858502,15.551129607609989,458.3912009512485,404.85017835909633,434.0077288941736,59.310939357907245,10
316,Kobe Brown,LA Clippers,G,6,32,3,7,200.0,0,0,0.0,0,2,0.0,4,6,10,2,5,0,3,0,-20,18,16,8,12,13.569526627218936,13.585798816568047,1.7218934911242607,0.007396449704142013,27.25,20.587278106508876,11.75887573964497,23.781065088757394,5
317,Kobe Bufkin,Atlanta Hawks,G,27,81,11,31,158.4,1,2,50.0,4,14,115.0,1,10,11,14,6,3,4,1,21,52,38,41,25,72.63265306122449,3.9795918367346945,14.959183673469388,2.836734693877551,134.6326530612245,95.83673469387756,113.83673469387753,16.53061224489796,5
318,Kobi Simmons,Toronto Raptors,G,9,41,4,12,66.7,0,0,0.0,1,5,50.0,1,2,3,6,4,5,1,1,-24,18,12,15,9,12.5,0.5,18.0,0.5,0.0,18.0,0.5,12.5,2
319,Kris Dunn,Utah Jazz,G,55,218,24,51,429.9,0,0,0.0,7,19,300.0,8,23,31,31,27,9,10,6,-37,117,86,86,62,116.50104123281966,44.38775510204081,31.008329862557268,6.157017909204498,312.9516867971679,233.96751353602667,192.4881299458559,78.39316951270304,10
320,Kris Murray,Portland Trail Blazers,F,93,322,37,92,344.2,6,10,233.4,13,46,220.8,16,33,49,22,20,11,15,6,-80,164,142,115,71,411.45095404461165,31.419242139209892,16.22090835796829,16.904326793872613,474.20693361999463,519.3775866702499,368.74469228701963,45.17575920451491,10
321,Kristaps Porzingis,Boston Celtics,C,210,309,73,157,475.7,40,44,900.0,24,61,397.5,26,44,70,20,26,9,14,16,78,300,280,230,90,76.2075298438935,99.28925619834712,8.918273645546371,21.017447199265384,311.05785123966933,294.95684113865934,101.90082644628097,98.61524334251607,10
322,Kyle Anderson,Minnesota Timberwolves,SF,88,285,35,74,445.1,17,24,535.0,1,3,50.0,12,32,44,56,21,11,8,7,74,188,132,144,100,120.52748942714341,16.422145328719722,24.193771626297575,0.9323337178008457,149.3487120338331,155.21030372933487,107.06728181468665,48.21453287197232,10
323,Kyle Kuzma,Washington Wizards,SF,226,358,88,184,498.4,38,49,741.7,12,44,228.6,3,63,66,52,24,7,33,7,-43,344,292,278,118,496.57844990548205,34.43194706994329,55.629489603024574,18.933837429111534,727.8610586011342,546.8327032136106,661.289224952741,106.37901701323253,10
324,Kyle Lowry,Philadelphia 76ers,PG,86,279,28,68,372.9,14,17,550.0,16,45,328.3,2,24,26,35,21,10,14,2,-48,147,112,121,61,394.0,22.607896160086533,68.56625202812332,12.47809626825311,519.5018929150892,443.677663601947,429.58950784207684,131.4088696592753,10
325,Kyrie Irving,Dallas Mavericks,PG,243,352,95,185,516.4,26,28,583.3,27,71,370.6,7,39,46,62,20,14,20,3,96,351,289,305,108,392.984,37.3,117.664,18.5,753.636,442.004,655.496,204.084,10
326,LaMelo Ball,Charlotte Hornets,PG,32,55,12,37,66.1,5,6,150.0,3,17,34.7,1,5,6,15,10,3,7,0,-49,53,38,47,21,2.0,2.0,0.5,0.5,4.5,8.0,0.5,0.5,2
327,Lamar Stevens,Memphis Grizzlies,PF,120,214,47,101,489.6,21,23,533.3,5,19,325.0,10,28,38,9,16,7,9,6,-29,167,158,129,47,241.024,34.176,9.8,2.824,381.496,294.736,326.74399999999997,45.016000000000005,10
328,Landry Shamet,Washington Wizards,SG,55,184,20,55,273.1,7,7,300.0,8,35,104.1,4,10,14,8,12,4,9,2,-68,77,69,63,22,330.90000000000003,22.5,5.700000000000001,15.624999999999998,463.7,413.80000000000007,373.0,35.99999999999999,10
329,Larry Nance Jr.,New Orleans Pelicans,PF,70,255,28,46,570.3,11,14,383.4,3,7,183.3,16,32,48,21,14,14,2,1,32,139,118,91,69,194.87943786982248,78.71967455621302,10.965236686390533,2.109467455621302,365.6397928994083,351.29289940828403,213.36686390532546,85.54437869822485,10
330,Lauri Markkanen,Utah Jazz,PF,223,347,68,170,401.2,57,60,956.7,30,80,363.3,20,49,69,26,14,11,18,4,-42,318,292,249,95,341.32140248356467,129.1373265157049,45.68298027757487,34.11687363038715,662.3710737764792,525.5471146822498,454.7107377647918,198.25493060628196,10
331,LeBron James,Los Angeles Lakers,SF,247,358,87,159,545.0,59,71,847.0,14,40,316.6,7,82,89,94,10,7,41,3,68,430,336,341,183,483.82041587901705,92.61342155009451,36.593572778827976,10.215500945179583,478.04253308128546,354.8175803402646,617.8015122873346,118.45085066162568,10
332,Leaky Black,Charlotte Hornets,F,27,151,8,25,232.1,7,10,275.0,4,10,150.0,5,21,26,13,12,2,3,2,-31,66,53,40,39,88.0,30.96,8.41,8.25,118.49000000000001,84.96000000000001,110.40999999999998,50.49,9
333,Leonard Miller,Minnesota Timberwolves,F,0,5,0,1,0.0,0,0,0.0,0,0,0.0,0,0,0,2,0,0,0,0,8,2,0,2,2,0.017777777777777778,0.1111111111111111,1.44,0.0,0.5377777777777779,0.2177777777777778,1.1377777777777778,0.7511111111111112,1
334,Lester Quinones,Golden State Warriors,G,52,148,18,49,323.7,9,13,325.0,7,29,200.0,7,17,24,12,16,2,5,0,-30,88,76,64,36,234.625,22.475308641975307,13.736111111111112,10.104938271604938,332.4938271604938,356.71141975308655,224.94444444444449,21.674382716049383,10
335,Lindy Waters III,Oklahoma City Thunder,F,35,78,12,30,373.3,1,1,100.0,10,23,316.6,3,15,18,4,7,1,3,2,-38,57,53,39,22,113.12960760998811,32.284185493460164,4.3115338882283,12.84304399524376,229.88941736028536,197.07609988109394,132.02615933412602,50.512485136741965,9
336,Lonnie Walker IV,Brooklyn Nets,G,46,132,18,58,333.8,2,2,100.0,8,37,139.0,1,14,15,5,8,0,6,3,-35,66,61,51,20,365.0603915035402,18.959183673469386,3.2590587255310286,22.0,526.5755935027072,484.00791336942933,401.44731361932526,28.39900041649313,10
337,Luguentz Dort,Oklahoma City Thunder,G,107,281,34,78,457.1,20,20,800.0,19,50,376.7,7,23,30,19,27,9,11,1,43,156,137,126,49,125.14342874730684,25.628193290243154,17.365650969529085,15.226531240381656,139.85041551246536,86.29085872576178,184.44444444444443,37.252385349338255,10
338,Luka Doncic,Dallas Mavericks,PG,294,370,96,222,436.8,63,80,805.6,39,106,363.2,11,86,97,102,19,17,42,3,107,493,391,396,199,460.5397923875432,60.141868512110726,135.60553633217992,32.273356401384085,549.8650519031142,635.6089965397923,337.6262975778547,232.91695501730104,10
339,Luka Garza,Minnesota Timberwolves,C,45,61,16,35,240.8,6,8,200.0,7,20,233.3,8,6,14,1,8,2,3,1,-7,60,59,46,15,43.8125,20.0,0.9349489795918369,1.863520408163265,112.97959183673467,105.8125,49.26530612244898,22.649234693877553,5
340,Luka Samanic,Utah Jazz,F,42,117,13,39,288.8,12,16,450.0,4,19,178.3,5,24,29,5,10,1,5,4,-49,76,71,47,34,154.44444444444443,61.74444444444444,5.4,2.8000000000000007,400.50000000000006,344.5,194.64444444444445,82.94444444444443,10
341,Luke Kennard,Memphis Grizzlies,SG,124,269,39,78,499.6,18,20,571.4,28,59,476.40000000000003,2,23,25,40,10,8,18,0,-65,189,149,164,65,418.7712665406427,7.29867674858223,89.46313799621927,24.192816635160682,601.7599243856333,437.31758034026467,557.0359168241965,122.93950850661625,10
342,Luke Kornet,Boston Celtics,C,57,189,23,36,642.7,11,12,350.0,0,0,0.0,23,27,50,18,9,4,3,11,60,125,107,75,68,176.2575826165686,180.07243096423718,43.33906745133545,0.0,782.4395654142146,564.5436849253056,303.4436396559529,314.12132186509734,10
343,M. Pereira,Memphis Grizzlies,F,7,25,3,9,100.0,0,1,0.0,1,4,50.0,3,5,8,0,2,2,1,0,5,15,15,7,8,13.32,12.807500000000001,0.0,0.6699999999999999,38.1875,38.1875,13.32,12.807500000000001,3
344,Malachi Flynn,Detroit Pistons,PG,84,163,31,72,386.7,10,15,391.7,12,34,307.9,6,18,24,20,8,9,10,1,-91,128,108,104,44,315.051754907793,23.633551457465792,22.663890541344436,9.908387864366448,571.9559785841761,487.37537180249853,390.8352171326592,55.09458655562166,10
345,Malaki Branham,San Antonio Spurs,G,64,173,25,69,347.9,7,10,216.7,7,31,226.6,4,10,14,14,8,2,8,1,-44,92,78,78,28,260.15625,20.989795918367346,12.90625,11.110331632653061,369.3469387755102,315.1103316326531,306.5,41.78890306122449,10
346,Malcolm Brogdon,Portland Trail Blazers,PG,102,218,37,83,266.20000000000005,17,19,433.3,11,30,202.89999999999998,7,22,29,40,13,4,17,2,4,171,131,142,69,100.0,28.833333333333336,7.333333333333334,6.833333333333334,113.5,66.83333333333334,151.33333333333331,31.5,6
347,Malik Beasley,Milwaukee Bucks,SG,131,313,46,110,416.4,7,7,300.0,32,86,360.6,3,32,35,10,17,4,8,3,7,176,166,141,45,299.3,20.564,10.196,27.636,304.404,298.544,314.93600000000004,20.984,10
348,Malik Monk,Sacramento Kings,SG,157,272,57,138,394.0,31,33,730.0,12,58,166.1,6,27,33,44,31,6,17,2,13,234,190,201,77,644.8005912389143,24.100241870464927,14.415479709755441,11.600107497984414,859.5802203708681,810.7519484009675,680.0249932813759,52.11959150765923,10
349,Mamadi Diakite,New York Knicks,F,0,5,0,0,0.0,0,0,0.0,0,0,0.0,0,1,1,0,1,1,0,0,0,1,1,0,1,0.0,0.25,0.0,0.0,0.25,0.25,0.0,0.25,1
350,MarJon Beauchamp,Milwaukee Bucks,F,30,42,10,16,350.0,7,8,175.0,3,7,200.0,2,9,11,1,4,1,3,0,-17,42,41,31,12,64.50666666666666,13.240000000000002,0.8933333333333334,2.0400000000000005,123.75999999999999,112.33333333333331,72.36000000000001,17.706666666666667,6
351,Marcus Morris Sr.,Cleveland Cavaliers,SF,42,108,15,34,274.7,4,6,200.0,8,18,300.0,3,17,20,7,6,1,6,1,-20,69,62,49,27,110.74074074074075,31.34156378600823,6.851851851851852,9.34156378600823,188.04526748971193,202.47736625514403,99.0,35.50205761316872,6
352,Marcus Morris Sr.,Philadelphia 76ers,SF,40,98,16,38,166.7,4,4,200.0,4,13,103.3,0,14,14,3,5,2,6,1,-21,57,54,43,17,103.82716049382715,5.06721536351166,3.2716049382716053,2.3511659807956105,140.8820301783265,127.08367626886145,117.0,8.964334705075446,4
353,Marcus Sasser,Detroit Pistons,G,86,261,30,86,372.9,13,14,290.0,13,41,376.3,1,25,26,43,18,6,17,1,-59,155,112,129,69,319.2265625,17.934027777777775,36.1015625,6.108506944444444,452.94444444444434,322.2126736111111,445.65625,58.337673611111114,10
354,Markelle Fultz,Orlando Magic,PG,58,168,28,63,423.6,2,2,100.0,0,2,0.0,9,16,25,17,13,5,10,3,20,100,83,75,42,179.66732412886256,52.9750164365549,30.442472057856676,0.006574621959237343,340.3182117028271,294.284681130835,223.82840236686388,85.28994082840237,10
355,Markieff Morris,Dallas Mavericks,PF,5,11,2,3,150.0,0,0,0.0,1,2,50.0,0,2,2,0,0,0,0,0,4,7,7,5,2,0.8024691358024691,2.098765432098766,0.617283950617284,0.8024691358024691,5.5432098765432105,4.555555555555555,2.283950617283951,2.2222222222222223,2
356,Marques Bolden,Charlotte Hornets,C,0,13,0,1,0.0,0,0,0.0,0,0,0.0,0,1,1,0,1,0,1,0,2,1,1,0,1,0.0,0.7551020408163267,0.0,0.0,0.7551020408163267,0.7551020408163267,0.0,0.7551020408163267,2
357,Marvin Bagley III,Washington Wizards,PF,142,257,61,97,617.9,14,17,633.3,6,9,450.0,32,50,82,11,9,4,8,11,-8,235,224,153,93,262.90625,124.337890625,16.125,4.4140625,285.728515625,277.322265625,240.65625,171.119140625,10
358,Mason Jones,Sacramento Kings,G,7,18,2,6,66.7,1,2,50.0,2,5,66.7,1,4,5,5,0,1,1,0,3,17,12,12,10,18.055555555555557,6.5,6.5,2.8888888888888893,0.722222222222223,2.8888888888888893,2.8888888888888893,26.0,2
359,Mason Plumlee,LA Clippers,C,52,117,19,30,603.3,14,21,450.0,0,0,0.0,13,34,47,8,14,3,11,5,7,107,99,60,55,74.35813456746172,98.11356354574582,9.606977572089711,0.0,240.29725881096476,242.18618725525099,79.25952296190815,100.93022427910287,10
360,Matisse Thybulle,Portland Trail Blazers,SG,67,209,25,53,398.9,5,7,200.0,12,31,335.0,7,24,31,20,14,17,12,7,-23,118,98,87,51,323.1224489795918,37.52244897959184,20.29387755102041,12.122448979591834,677.8938775510204,530.0,441.83265306122445,87.0,10
361,Matt Ryan,New Orleans Pelicans,F,28,65,10,26,233.3,0,0,0.0,8,20,194.4,1,8,9,2,7,0,2,0,-8,39,37,30,11,184.88888888888889,16.755102040816325,1.5555555555555558,17.160997732426303,310.2154195011338,299.6439909297052,194.8888888888889,18.882086167800452,8
362,Matthew Hurt,Memphis Grizzlies,F,32,110,12,33,215.9,3,3,200.0,5,19,233.4,9,7,16,4,8,3,2,3,-7,52,48,36,20,163.8343195266272,34.95857988165681,4.934911242603551,5.335798816568047,360.0,296.6272189349112,213.72781065088756,53.37278106508876,7
363,Max Christie,Los Angeles Lakers,G,31,106,12,24,569.4,1,2,50.0,6,12,350.0,1,14,15,4,3,0,4,0,-1,50,46,35,19,78.65754437869822,6.533284023668639,2.591715976331361,4.400147928994082,130.5,109.70710059171597,95.61020710059171,12.965236686390533,10
364,Max Strus,Cleveland Cavaliers,SG,128,304,45,97,431.3,13,16,416.7,25,65,345.2,11,19,30,40,26,9,20,4,-42,198,158,168,70,320.62399999999997,30.816,39.056,38.504000000000005,393.744,392.784,335.056,56.400000000000006,10
365,Maxi Kleber,Dallas Mavericks,PF,25,161,8,20,341.7,4,6,200.0,5,16,266.7,4,20,24,14,16,6,2,3,55,63,49,39,38,76.27020291918832,32.451406194375224,16.616589533641868,6.757208971164115,137.09825560697757,92.27732289070843,128.0800996796013,42.07903168387327,10
366,Maxwell Lewis,Los Angeles Lakers,F,0,5,0,1,0.0,0,0,0.0,0,1,0.0,0,0,0,2,0,0,0,0,-3,2,0,2,2,0.030245746691871453,0.0,2.449905482041588,0.0,1.935727788279773,0.030245746691871453,1.935727788279773,2.449905482041588,1
367,Micah Potter,Utah Jazz,C,26,99,9,16,300.0,3,3,200.0,5,10,250.0,5,14,19,2,5,0,2,1,-3,47,45,28,21,122.0,9.337950138504153,1.5013850415512464,6.127423822714681,140.21883656509695,122.96952908587257,138.65927977839337,11.429362880886426,8
368,Michael Porter Jr.,Denver Nuggets,SF,189,322,71,128,549.1,19,22,780.0,28,63,444.0,15,53,68,17,12,8,11,3,51,274,257,206,85,412.6817602040817,25.747448979591834,20.15625,13.707270408163264,368.0331632653061,450.1715561224489,331.5612244897959,44.8858418367347,10
369,Mikal Bridges,Brooklyn Nets,SF,177,352,60,140,414.59999999999997,20,24,635.7,37,84,439.6,11,34,45,34,13,14,20,3,-24,256,222,211,79,307.2270408163265,34.61479591836735,22.758290816326532,34.31441326530612,332.14604591836735,304.12244897959187,319.65625,72.96747448979592,10
370,Mike Conley,Minnesota Timberwolves,PG,150,293,53,106,480.2,20,23,696.7,24,57,379.5,6,18,24,51,20,12,11,3,19,225,174,201,75,525.1280276816609,25.01038062283737,40.90465205690119,38.61053440984237,614.7085736255286,582.0,560.7431757016533,63.0084582852749,10
371,Mike Muscala,Oklahoma City Thunder,C,26,121,9,32,234.2,1,2,50.0,7,23,250.0,6,14,20,6,6,3,1,1,36,52,46,32,26,107.99123447772097,22.54784514243974,7.672753834915997,12.18626734842951,242.8970051132213,208.18699780861945,129.37326515704893,43.548575602629654,10
372,Miles Bridges,Charlotte Hornets,SF,201,388,81,172,471.9,23,37,501.1,16,60,244.3,16,55,71,35,12,9,24,3,-109,307,272,236,106,253.125,45.18639053254438,30.559171597633135,17.323224852071004,309.6693786982249,296.6190828402367,252.91494082840237,89.00591715976331,10
373,Miles McBride,New York Knicks,PG,131,334,47,95,413.2,11,12,383.3,26,59,295.8,8,14,22,26,27,10,5,1,79,179,153,157,48,1039.390306122449,17.65625,36.75829081632653,86.40816326530613,1416.9183673469388,1116.3144132653063,1318.110331632653,76.2984693877551,10
374,Mitchell Robinson,New York Knicks,C,15,32,6,12,133.3,3,6,100.0,0,0,0.0,8,6,14,0,3,0,4,2,4,29,29,15,14,0.5555555555555558,55.55555555555556,0.0,0.0,45.0,45.0,0.5555555555555558,55.55555555555556,2
375,Mo Bamba,Philadelphia 76ers,C,77,213,29,49,574.5,9,13,325.0,10,22,440.0,17,45,62,11,30,8,8,14,-24,150,139,88,73,143.25238534933825,54.42782394582949,16.922437673130194,4.692520775623269,286.0221606648199,267.2493074792244,174.15266235764852,59.222837796244995,10
376,Monte Morris,Minnesota Timberwolves,PG,45,145,17,40,505.0,3,5,200.0,8,17,316.7,3,8,11,22,3,7,3,1,19,78,56,67,33,74.0493435943866,5.141240380262562,43.6260751471254,7.608872793119058,168.07876867360795,83.41330918967859,161.27342688999548,46.20869171570847,10
377,Moritz Wagner,Orlando Magic,C,85,148,34,56,585.6,13,17,560.0,4,13,183.3,12,25,37,18,10,4,12,2,33,140,122,103,55,213.11136260751476,68.51561792666365,36.10864644635582,4.446355817111815,404.31598008148484,389.2539610683567,211.59031235853328,121.207333635129,10
378,Moses Brown,Portland Trail Blazers,C,34,79,14,27,393.3,6,21,140.8,0,0,0.0,12,11,23,4,10,1,4,4,-13,61,57,38,27,73.12,25.342222222222222,6.080000000000002,0.0,148.88888888888889,118.70222222222222,89.92,44.80888888888889,8
379,Moses Moody,Golden State Warriors,SG,79,170,29,65,485.7,13,15,433.3,8,29,263.3,13,19,32,10,18,7,7,5,27,121,111,89,42,164.51604938271603,83.4567901234568,12.123456790123457,15.841975308641974,468.78271604938266,389.84444444444443,237.03456790123454,102.0,10
380,Mouhamadou Gueye,Toronto Raptors,F,11,49,5,17,208.3,1,4,25.0,0,1,0.0,6,2,8,1,4,1,5,5,-42,20,19,12,9,1.8620037807183367,6.516068052930057,0.8034026465028354,0.0,13.0,11.542533081285445,2.385633270321361,8.253308128544424,5
381,Moussa Diabate,LA Clippers,F,2,7,1,1,100.0,0,2,0.0,0,0,0.0,1,3,4,0,0,1,0,1,1,6,6,2,4,0.0,0.0,0.0,0.0,0.0,0.0,0.0,0.0,1
382,Myles Turner,Indiana Pacers,C,160,272,60,120,484.9,19,27,608.4,21,48,397.6,10,46,56,16,26,4,9,19,28,232,216,176,72,462.2582908163265,46.625,21.387755102040817,27.778698979591834,517.90625,534.7940051020408,480.65625,32.72704081632653,10
383,Naji Marshall,New Orleans Pelicans,SF,75,211,31,68,435.3,2,2,100.0,11,31,392.1,4,40,44,18,11,9,5,0,58,137,119,93,62,166.8429355281207,49.03429355281207,9.626886145404665,12.939643347050751,389.58367626886144,340.8100137174211,200.27777777777777,74.0,10
384,Nassir Little,Phoenix Suns,SF,18,64,7,18,258.3,0,0,0.0,4,11,250.0,0,11,11,5,7,0,1,2,-9,34,29,23,16,39.44444444444444,15.75,4.444444444444445,2.1111111111111116,71.75,62.19444444444446,47.0,22.19444444444444,7
385,Nate Hinton,Houston Rockets,G,12,22,4,7,110.0,2,3,66.7,2,3,66.7,1,5,6,3,4,1,1,2,10,21,18,15,9,48.05555555555556,6.722222222222221,1.3888888888888884,2.5,97.38888888888886,75.55555555555557,65.0,13.0,2
386,Nathan Mensah,Charlotte Hornets,C,4,59,2,5,66.7,0,0,0.0,0,0,0.0,4,6,10,1,13,2,1,4,-17,15,14,5,11,13.75,9.9375,0.859375,0.0,41.359375,44.4375,13.484375,7.984375,7
387,Naz Reid,Minnesota Timberwolves,C,183,293,67,143,465.6,20,25,559.2,29,72,350.0,8,62,70,24,26,9,15,13,31,277,253,207,94,703.0724698042482,99.34943773427739,24.343190337359434,59.52394835485214,965.0258225739276,875.0683048729695,771.7913369429403,144.93127863390254,10
388,Neemias Queta,Boston Celtics,C,39,80,19,26,443.4,1,2,100.0,0,0,0.0,12,17,29,4,8,3,4,6,63,72,68,43,33,78.9375,55.24609375,2.12109375,0.0,228.734375,238.96484375,76.33984375,49.734375,7
389,Nic Claxton,Brooklyn Nets,C,118,311,51,81,655.8,16,31,563.3,0,1,0.0,33,72,105,23,25,8,11,14,-37,246,223,141,128,229.6734693877551,111.0389030612245,16.622448979591837,0.0,331.3858418367347,369.1103316326531,215.8877551020408,103.72257653061224,10
390,Nick Jr. Smith,Charlotte Hornets,G,53,164,17,59,301.1,8,9,187.5,11,32,275.0,2,10,12,17,19,4,5,0,8,82,65,70,29,256.53086419753083,13.402777777777777,25.660493827160494,16.77777777777778,372.625,279.6188271604938,322.2777777777777,66.32253086419753,10
391,Nick Richards,Charlotte Hornets,C,96,289,39,59,663.5,18,24,525.0,0,0,0.0,26,72,98,8,22,3,10,6,-36,202,194,104,106,141.95309496347556,169.7362552864283,9.600153787004999,0.0,265.6186082276048,304.42214532871975,124.0,158.48596693579393,10
392,Nickeil Alexander-Walker,Minnesota Timberwolves,SG,100,268,36,78,412.2,7,9,183.3,21,46,401.2,8,18,26,22,15,6,8,5,76,148,126,122,48,567.8573388203017,42.84567901234567,28.29149519890261,25.82235939643347,846.1783264746227,724.019890260631,645.5260631001372,115.62688614540465,10
393,Nicolas Batum,Philadelphia 76ers,PF,40,272,15,42,292.9,1,2,50.0,9,31,225.0,13,35,48,18,15,9,8,5,-3,106,88,58,66,142.76505205975553,54.10864644635582,22.10864644635582,10.902218198279765,348.7043911272069,239.6260751471254,219.6260751471254,108.43458578542328,10
394,Nikola Jokic,Denver Nuggets,C,268,365,107,186,586.9,47,56,861.7,7,23,211.6,24,91,115,74,19,18,28,9,90,457,383,342,189,554.082276047674,126.31487889273356,87.5447904652057,9.0,887.645136485967,777.1099577085737,635.6901191849288,242.78700499807763,10
395,Nikola Jovic,Miami Heat,F,79,218,29,67,445.8,6,7,250.0,15,43,350.2,3,34,37,19,17,8,10,4,35,135,116,98,56,107.73484295105916,70.96785975164353,19.28926223520818,11.305332359386414,326.5164353542732,254.96566837107378,142.72315558802046,126.81957633308986,10
396,Nikola Vucevic,Chicago Bulls,C,169,330,72,138,531.7,15,20,475.0,10,37,243.3,23,77,100,32,21,5,17,10,-51,301,269,201,132,363.2874730686365,169.15173899661434,29.689750692520775,6.196983687288396,506.7728531855954,575.2603878116342,315.86365035395505,177.77777777777777,10
397,Noah Clowney,Brooklyn Nets,F,24,102,9,25,166.2,1,4,50.0,3,13,108.3,7,14,21,6,7,3,2,2,10,51,45,30,27,70.52000000000001,27.99111111111111,6.541111111111111,1.7200000000000002,149.44777777777776,156.6977777777778,67.60777777777777,30.194444444444443,7
398,Norman Powell,LA Clippers,G,163,280,58,111,538.0,27,33,675.0,20,55,386.9,4,22,26,11,18,6,10,2,-20,200,189,174,37,265.18379357175195,40.52240832956089,6.983703033046627,10.366681756450884,423.3001358080579,413.3349932095971,266.55138071525573,56.10366681756451,10
399,O.G. Anunoby,New York Knicks,SF,83,194,33,70,262.7,9,14,243.3,8,28,138.3,3,24,27,12,12,16,13,5,107,122,110,95,39,431.93491124260356,55.0,6.0,8.757396449704142,260.7810650887574,260.7810650887574,441.9349112426035,51.0,6
400,Obi Toppin,Indiana Pacers,PF,73,177,29,48,647.0,6,8,350.0,9,22,393.3,9,26,35,14,14,5,6,3,9,122,108,87,49,56.09681126113186,30.66159149669635,12.664751508187301,9.241309968399886,121.15943694340707,123.36569951163457,44.30422292444699,52.912668773341,10
401,Ochai Agbaji,Toronto Raptors,G,80,272,34,80,355.6,6,12,225.0,6,27,178.3,20,20,40,17,19,11,11,5,-102,137,120,97,57,199.7484381507705,76.00416493127864,26.83673469387755,4.453977509371096,518.2736359850062,444.0024989587672,245.90878800499792,130.95168679716784,10
402,Olivier Sarr,Oklahoma City Thunder,C,11,22,4,7,125.0,3,5,116.7,0,1,0.0,4,4,8,0,3,0,1,1,-14,19,19,11,8,34.92,6.920000000000002,0.0,0.0,59.68000000000001,59.68000000000001,34.92,6.920000000000002,3
403,OlivierMaxence Prosper,Dallas Mavericks,F,10,36,3,6,150.0,4,7,57.1,0,2,0.0,2,6,8,0,1,1,1,1,-14,18,18,10,8,30.560000000000002,15.111111111111114,0.0,0.0,87.80444444444444,87.80444444444444,30.560000000000002,15.111111111111114,4
404,Omer Yurtseven,Utah Jazz,C,43,86,19,28,326.1,4,7,200.0,1,3,50.0,12,15,27,5,10,1,3,6,-14,75,70,48,32,166.87500000000003,36.907407407407405,10.171296296296296,0.8333333333333335,344.01851851851853,278.0046296296296,217.18518518518516,62.782407407407405,6
405,Onuralp Bitim,Chicago Bulls,SF,50,153,22,45,454.4,0,0,0.0,6,21,166.7,5,12,17,9,14,2,3,1,-38,76,67,59,26,265.59999999999997,50.10123456790123,4.9111111111111105,6.800000000000002,509.441975308642,476.05679012345684,285.57777777777784,68.41975308641976,10
406,Onyeka Okongwu,Atlanta Hawks,PF,147,296,61,89,703.8000000000001,16,22,492.9,9,19,466.6,32,44,76,11,28,7,5,15,4,234,223,158,87,308.4240362811791,185.95918367346937,9.244897959183675,5.6893424036281175,807.5192743764171,822.7913832199548,307.3560090702948,181.0,10
407,Orlando Robinson,Miami Heat,C,13,59,4,11,108.3,4,5,175.0,1,2,100.0,8,9,17,5,4,1,3,0,4,35,30,18,22,51.221938775510196,22.07908163265306,2.836734693877551,0.8367346938775512,88.26530612244896,74.0,68.21173469387756,22.19132653061224,6
408,Oscar Tshiebwe,Indiana Pacers,C,3,5,1,3,33.3,1,2,50.0,0,0,0.0,2,0,2,0,1,0,0,1,8,5,5,3,2,0.25,0.0,0.0,0.0,0.25,0.25,0.25,0.0,1
409,Oshae Brissett,Boston Celtics,SF,46,179,15,33,477.2,12,23,288.3,4,12,283.3,16,24,40,15,13,3,4,2,61,101,86,61,55,112.4,62.400000000000006,21.80625,2.40625,335.90625,238.79999999999998,193.70625,100.00625000000001,10
410,Ousmane Dieng,Oklahoma City Thunder,F,28,90,10,25,324.4,4,4,200.0,4,14,220.0,1,7,8,14,3,3,6,3,16,50,36,42,22,122.49704142011836,6.0,21.124260355029588,4.295857988165681,242.1183431952663,164.49704142011836,196.11834319526628,31.124260355029584,8
411,P.J. Tucker,LA Clippers,PF,19,147,7,19,183.3,0,0,0.0,5,12,283.4,7,21,28,4,12,4,4,4,-22,51,47,23,32,63.509641873278234,39.25619834710744,4.28099173553719,4.225895316804408,168.67768595041323,129.4986225895317,85.28374655647383,60.94214876033057,9
412,P.J. Washington,Dallas Mavericks,PF,86,320,32,91,370.9,9,16,300.0,13,52,248.3,9,55,64,12,20,10,4,10,78,162,150,98,76,200.74489795918365,96.40051020408163,8.298469387755102,14.836734693877553,378.05102040816337,327.97193877551024,216.46173469387756,139.0612244897959,10
413,Paolo Banchero,Orlando Magic,PF,202,348,73,155,531.0,41,55,616.7,15,47,424.0,7,59,66,57,20,9,36,7,-12,325,268,259,123,201.47160493827155,74.44444444444444,75.79012345679011,8.777777777777777,373.6716049382717,333.9456790123457,238.14567901234562,153.28641975308642,10
414,Pascal Siakam,Indiana Pacers,PF,235,313,93,168,541.9,44,64,636.5,5,14,250.0,23,79,102,37,21,11,14,5,70,374,337,272,139,422.5351910370583,106.0,26.16345877621373,5.592358517667337,523.6575696638896,527.111462223499,389.79316288422865,161.45159436943408,10
415,Pat Connaughton,Milwaukee Bucks,SG,67,232,24,51,501.8,8,9,450.0,11,32,409.3,7,21,28,24,10,2,6,2,15,119,95,91,52,208.36351165980795,31.95679012345679,64.84567901234568,11.345679012345679,320.67626886145405,341.3038408779149,198.93347050754457,85.60493827160494,10
416,Patrick Baldwin Jr.,Washington Wizards,F,42,156,15,49,275.9,5,7,260.0,7,30,171.9,6,31,37,12,12,8,7,7,-56,91,79,54,49,151.9340277777778,67.02517361111111,19.61111111111111,6.15625,382.8168402777778,260.1640625,223.1840277777778,138.0390625,10
417,Patrick Beverley,Milwaukee Bucks,PG,32,185,9,39,191.7,9,12,383.4,5,22,200.0,3,19,22,16,21,5,5,7,-26,70,54,48,38,115.625,23.587673611111114,37.15017361111111,5.350694444444445,241.40625,138.69184027777777,196.67100694444446,82.40625,10
418,Patrick Williams,Chicago Bulls,PF,6,24,2,9,22.2,2,2,100.0,0,5,0.0,0,6,6,2,5,0,2,2,-11,14,12,8,8,0.0,0.0,0.0,0.0,0.0,0.0,0.0,0.0,1
419,Patty Mills,Miami Heat,PG,56,180,20,66,264.7,9,9,300.0,7,43,137.5,4,8,12,19,12,11,7,0,57,87,68,75,31,264.72218917311125,9.70493753718025,15.271267102914933,6.117192147531231,295.98631766805477,263.65615704937534,288.25758477096963,33.77096966091612,10
420,Paul George,LA Clippers,F,238,346,85,161,537.7,33,33,700.0,35,73,481.9,3,44,47,33,26,15,19,9,25,318,285,271,80,279.73168629704105,52.12094225797185,38.25308819304798,20.87991956334387,515.364550416547,345.93593794886533,427.24705544383795,112.28727377190462,10
421,Paul Reed,Philadelphia 76ers,SF,75,229,27,60,461.8,19,24,600.0,2,9,150.0,31,40,71,12,24,13,14,15,-3,158,146,87,83,145.52190271432409,9.067723730180058,14.270894920720236,1.6904058048911583,200.61542596076322,202.4176296694437,139.4488040849234,27.609513571620536,10
422,Payton Pritchard,Boston Celtics,PG,134,297,51,109,447.9,9,11,400.0,23,57,403.0,8,29,37,59,13,4,10,0,77,230,171,193,96,396.323224852071,46.125,147.02440828402365,28.14792899408284,947.4119822485206,481.81360946745565,803.8254437869822,251.24556213017752,10
423,Peyton Watson,Denver Nuggets,F,50,171,21,54,357.8,6,11,350.0,2,14,200.0,8,30,38,8,21,3,5,8,-20,96,88,58,46,105.09141274238226,43.61772853185596,7.726069559864573,1.696522006771314,272.32994767620806,217.41828254847644,144.70852570021546,66.63835026161897,10
424,Precious Achiuwa,New York Knicks,PF,76,223,31,53,568.2,12,19,375.0,2,7,133.3,30,49,79,16,21,6,15,12,-20,171,155,92,95,278.1817602040816,136.98979591836735,16.814413265306122,1.6460459183673473,676.704081632653,652.436862244898,311.38775510204084,144.8654336734694,10
425,Quentin Grimes,Detroit Pistons,SG,82,213,26,80,296.2,19,24,525.0,11,50,200.0,2,27,29,19,13,7,9,4,-12,130,111,101,48,312.44628099173553,35.19834710743802,14.900826446280991,10.900826446280991,442.06611570247935,483.0495867768595,277.6942148760331,43.86776859504132,10
426,R. Rupert,Portland Trail Blazers,G,45,212,16,40,447.5,8,9,450.0,5,17,133.3,6,23,29,25,24,3,12,2,-36,99,74,70,54,78.64938271604939,29.256790123456792,27.464197530864197,8.649382716049383,230.63456790123456,174.44444444444446,111.78271604938271,79.77777777777777,10
427,RJ Barrett,Toronto Raptors,SG,208,328,85,152,559.5,20,43,406.1,18,37,425.0,9,42,51,46,22,5,28,4,-39,305,259,254,97,255.64444444444445,58.24444444444445,50.577777777777776,15.777777777777777,454.77777777777777,307.8,398.8,112.64444444444445,10
428,Reggie Bullock,Houston Rockets,SF,26,120,9,22,449.9,0,0,0.0,8,20,466.6,3,26,29,2,6,5,2,1,8,57,55,28,31,26.577777777777776,51.93827160493827,1.6000000000000003,3.6444444444444444,128.1753086419753,132.5753086419753,23.777777777777775,51.93827160493827,10
429,Reggie Jackson,Denver Nuggets,PG,100,210,36,90,395.5,17,20,372.7,11,33,382.7,5,7,12,43,18,7,16,1,24,155,112,143,55,320.2326869806094,15.734072022160664,82.41397353031702,5.082486919052016,515.739919975377,304.1385041551246,487.44444444444446,142.53770390889503,10
430,Richaun Holmes,Washington Wizards,F,88,241,35,62,516.4,18,21,591.7,0,2,0.0,31,52,83,9,31,7,8,8,-2,180,171,97,92,287.40277777777777,265.23611111111114,6.9765625,0.004340277777777778,970.4765625,900.5,323.5251736111111,306.06684027777777,10
431,Ricky IV Council,Philadelphia 76ers,G,55,88,17,38,431.6,17,24,483.3,4,12,233.3,2,8,10,6,5,0,2,1,-1,71,65,61,16,244.38775510204084,16.089795918367344,4.530612244897958,5.575510204081633,402.4612244897959,352.80408163265304,291.0,23.66530612244898,10
432,Robin Lopez,Milwaukee Bucks,C,6,23,3,9,37.5,0,0,0.0,0,2,0.0,1,0,1,1,3,1,0,2,-16,8,7,7,2,21.92,0.52,0.6800000000000002,0.0,24.48,29.0,18.28,0.32000000000000006,2
433,Royce O'Neale,Phoenix Suns,PF,65,196,26,55,482.7,0,0,0.0,13,36,408.4,7,35,42,21,14,2,9,3,-8,128,107,86,63,294.27942925089184,21.538644470868014,18.900118906064208,22.55529131985731,312.2187871581451,360.4958382877527,246.35909631391206,40.082045184304405,10
434,Rudy Gobert,Minnesota Timberwolves,C,144,374,57,82,699.2,30,47,651.7,0,0,0.0,42,101,143,17,40,6,17,24,57,304,287,161,160,322.981738495252,43.867786705624546,14.100073046018993,0.0,280.3988312636961,360.16727538349164,261.45434623813003,39.72680788897004,10
435,Rui Hachimura,Los Angeles Lakers,PF,163,314,64,113,571.7,17,20,608.3,18,39,389.2,7,46,53,13,17,0,5,4,26,229,216,176,66,352.74489795918373,152.22257653061226,6.544005102040817,37.90625,652.6734693877552,664.0286989795918,347.65625,152.5,10
436,Russell Westbrook,LA Clippers,PG,88,197,33,95,359.6,20,26,656.7,2,22,45.0,12,13,25,34,15,10,13,0,-10,147,113,122,59,190.54221165279426,24.569560047562423,52.36623067776456,1.8097502972651607,457.4803804994055,307.26159334126044,296.90606420927463,120.79072532699169,10
437,Ryan Arcidiacono,New York Knicks,G,0,5,0,1,0.0,0,0,0.0,0,1,0.0,0,0,0,0,1,1,0,0,3,0,0,0,0,0.0,0.0625,0.0,0.0,0.0625,0.0625,0.0,0.0625,1
438,Saben Lee,Phoenix Suns,G,35,98,9,28,194.29999999999998,15,20,416.7,2,9,83.3,3,15,18,17,6,4,2,0,11,70,53,52,35,190.68,24.479999999999997,5.720000000000001,1.5200000000000005,336.32,336.0,189.68,31.519999999999996,8
439,Saddiq Bey,Atlanta Hawks,SF,146,337,48,125,372.4,31,35,800.0,19,59,298.4,29,32,61,14,7,4,10,4,-23,221,207,160,75,398.90000000000003,67.125,9.625,14.9,439.4000000000001,478.32500000000005,362.225,74.5,10
440,Sam Hauser,Boston Celtics,SF,134,246,47,92,506.3,0,0,0.0,40,79,498.9,3,32,35,11,8,10,2,7,74,180,169,145,46,732.6911157024795,32.68595041322314,9.111570247933884,75.16219008264463,922.5092975206611,922.1167355371899,732.4803719008265,42.40082644628099,10
441,Sam Merrill,Cleveland Cavaliers,SG,105,248,32,77,400.3,10,11,566.7,31,75,396.1,3,24,27,31,12,2,6,2,38,163,132,136,58,236.0115702479339,41.0,76.99999999999999,26.28925619834711,347.9024793388429,319.4842975206612,276.4297520661157,106.00000000000001,10
442,Samardo Samuels,Houston Rockets,F,0,6,0,1,0.0,0,0,0.0,0,0,0.0,1,1,2,0,0,0,0,0,-5,2,2,0,2,1.44,1.9599999999999997,0.0,0.0,0.03999999999999998,0.03999999999999998,1.44,1.9599999999999997,1
443,Sandro Mamukelashvili,San Antonio Spurs,PF,31,55,15,23,368.1,0,1,0.0,1,4,50.0,9,5,14,5,5,2,1,0,27,50,45,36,19,103.72853185595568,14.077562326869808,7.675900277008311,0.9584487534626039,181.28808864265926,151.73961218836564,119.0,36.03047091412743,7
444,Santi Aldama,Memphis Grizzlies,PF,131,328,47,100,472.1,15,22,550.0,22,58,347.0,12,56,68,28,12,11,8,16,-90,227,199,159,96,381.6360946745562,88.85207100591715,35.64275147928995,27.87352071005917,718.2078402366864,569.1863905325445,516.9948224852071,138.15754437869822,10
445,Sasha Vezenkov,Sacramento Kings,F,9,22,2,7,28.6,3,3,100.0,2,4,50.0,0,1,1,1,4,1,0,0,24,11,10,10,2,4.5,0.5,0.5,2.0,4.5,2.0,8.0,0.0,2
446,Scoot Henderson,Portland Trail Blazers,G,153,293,57,147,383.5,26,32,785.0,13,43,278.3,6,31,37,53,35,15,42,2,-138,243,190,206,90,358.61652892561983,38.61652892561983,42.107438016528924,8.16694214876033,736.1074380165289,478.0,582.8,114.64793388429752,10
447,Scottie Barnes,Toronto Raptors,SF,179,333,70,155,460.1,33,39,674.9,6,36,159.89999999999998,28,63,91,75,18,13,31,14,21,345,270,254,166,391.6640625,102.8515625,85.6640625,4.8515625,827.2890625,587.40625,576.65625,243.40625,10
448,Scotty Pippen Jr.,Memphis Grizzlies,G,121,254,41,85,461.7,20,32,440.4,19,36,555.0,10,21,31,47,31,16,25,6,-53,199,152,168,78,260.456,15.223999999999998,49.864,6.936,264.136,287.504,226.97599999999997,75.19999999999999,10
449,Seth Curry,Charlotte Hornets,SG,81,181,29,67,372.5,14,15,566.7,9,31,256.6,4,15,19,17,7,5,7,3,-33,117,100,98,36,233.0,12.900826446280993,16.140495867768593,4.900826446280991,334.3388429752066,276.08264462809916,269.8677685950413,50.429752066115704,10
450,Shai Gilgeous-Alexander,Oklahoma City Thunder,PG,268,342,98,195,502.5,58,73,786.8,14,47,267.6,8,46,54,55,22,18,25,7,72,377,322,323,109,556.8735101883891,69.11111111111111,37.62283737024221,18.444444444444446,824.0795847750866,675.4878892733564,704.4848135332564,107.71434063821606,10
451,Shake Milton,New York Knicks,SG,49,126,21,46,431.1,2,3,66.7,5,12,250.0,9,19,28,15,12,4,5,2,-6,92,77,64,43,149.3,80.50000000000001,17.125,8.600000000000001,513.8249999999999,406.2,213.425,141.125,10
452,Simone Fontecchio,Detroit Pistons,F,158,307,55,116,455.5,19,21,616.7,29,65,413.2,8,41,49,16,20,10,13,5,5,223,207,174,65,506.0,36.90963139120095,14.430439952437576,30.11296076099881,589.4708680142687,547.3923900118907,538.8442330558859,60.574316290130795,10
453,Skylar Mays,Los Angeles Lakers,SG,8,34,4,10,170.0,0,0,0.0,0,3,0.0,0,1,1,3,2,3,2,1,-3,12,9,11,4,13.760000000000002,0.7600000000000002,3.1100000000000003,0.0,11.61,15.0,11.75,2.49,4
454,Spencer Dinwiddie,Los Angeles Lakers,PG,78,258,21,54,354.8,23,26,638.9,13,30,431.7,1,18,19,20,24,5,10,7,8,117,97,98,39,546.2441700960219,33.04938271604938,34.573388203017835,10.126886145404663,838.1577503429356,673.2277091906723,717.4375857338821,61.3593964334705,10
455,Stanley Umude,Detroit Pistons,G,49,150,16,39,260.4,8,9,366.7,9,25,243.3,5,16,21,3,15,4,4,2,-32,73,70,52,24,177.08,44.0,1.9200000000000002,10.88,278.68,272.78,180.88,48.02,8
456,Stephen Curry,Golden State Warriors,PG,229,314,80,185,439.4,28,30,755.0,41,110,385.6,8,38,46,47,9,3,15,1,79,322,275,276,93,434.6398891966759,84.42413050169283,51.603262542320714,15.542320714065864,797.2963988919668,714.0686365035396,495.88673437980907,158.00831024930747,10
457,Svi Mykhailiuk,Boston Celtics,SG,52,135,18,43,560.4,1,1,100.0,15,37,413.3,2,15,17,14,2,4,2,0,77,83,69,66,31,54.09688581314879,26.62629757785467,12.899653979238753,8.716262975778546,206.7231833910035,139.0,106.39446366782008,54.95155709342561,10
458,T. Vukcevic,Washington Wizards,PF,6,9,2,5,40.0,0,0,0.0,2,4,50.0,0,3,3,0,2,0,1,0,-5,9,9,6,3,15.07266435986159,1.384083044982699,0.0,1.6747404844290654,25.5916955017301,25.5916955017301,15.07266435986159,1.384083044982699,1
459,T.J. McConnell,Indiana Pacers,PG,136,195,60,113,536.7,9,10,400.0,7,13,550.0,4,21,25,45,7,9,19,1,18,206,161,181,70,63.93176020408163,18.614795918367346,32.18622448979591,2.3698979591836733,136.6358418367347,120.68686224489797,97.57971938775509,33.102040816326536,10
460,T.J. Warren,Minnesota Timberwolves,SF,29,105,13,34,301.2,1,2,50.0,2,11,83.3,5,12,17,7,11,3,4,1,23,53,46,36,24,47.43055555555555,14.88888888888889,7.0,1.5,69.875,72.625,38.34722222222222,28.22222222222222,8
461,Taj Gibson,Detroit Pistons,F,3,11,1,2,50.0,0,0,0.0,1,2,50.0,0,2,2,0,1,1,0,0,-3,5,5,3,2,2.5600000000000005,0.03999999999999998,0.16000000000000003,0.36,1.9599999999999997,3.2399999999999993,1.44,0.04000000000000007,1
462,Taj Gibson,New York Knicks,F,2,68,0,9,0.0,2,2,100.0,0,2,0.0,4,6,10,4,8,1,3,0,2,16,12,6,14,8.2,10.200000000000001,1.6,0.8000000000000002,15.600000000000001,12.400000000000002,6.6000000000000005,16.599999999999998,5
463,Talen Horton-Tucker,Utah Jazz,SG,64,154,19,65,304.2,16,18,566.7,10,30,384.9,3,17,20,23,12,6,3,5,-48,107,84,87,43,48.55775234131114,54.66389177939646,30.887617065556714,2.3746097814776275,217.0,150.01664932362124,106.43808532778357,94.65452653485953,10
464,Taurean Prince,Los Angeles Lakers,PF,86,203,31,62,559.6,8,11,266.7,16,39,470.3,2,24,26,8,12,3,8,6,-9,120,112,94,34,102.0,32.89965397923876,8.737408688965782,6.407535563244906,153.23106497500962,129.48788927335642,115.83544790465206,51.54479046520569,10
465,Taylor Hendricks,Utah Jazz,F,84,270,30,70,468.3,9,11,325.0,15,44,370.2,10,53,63,8,29,5,4,13,-74,155,147,92,71,98.5121107266436,80.2725874663591,3.688581314878893,4.716262975778546,226.54709727028066,200.10649750096115,118.0,90.91387927720108,10
466,Taze Moore,Portland Trail Blazers,G,2,5,1,1,100.0,0,0,0.0,0,0,0.0,0,0,0,1,0,0,1,0,7,3,2,3,1,1.44,0.0,0.6400000000000001,0.0,4.0,1.44,4.0,0.6400000000000001,1
467,Terance Mann,LA Clippers,SG,102,261,36,76,472.4,16,17,650.0,14,35,548.8,8,20,28,9,19,9,5,4,-40,139,130,111,37,232.52080856123663,40.03151010701546,15.841854934601663,2.8424494649227108,373.3656361474435,298.35969084423306,324.9001189060642,38.5,10
468,Terquavion Smith,Philadelphia 76ers,G,40,59,14,34,241.1,2,3,100.0,10,26,216.6,0,2,2,10,3,7,4,0,9,52,42,50,12,186.96296296296296,1.4074074074074074,17.185185185185183,17.185185185185183,177.40740740740742,184.66666666666663,179.62962962962965,18.666666666666668,6
469,Terry Rozier,Miami Heat,SG,173,329,69,164,422.2,16,19,472.7,19,58,269.6,5,42,47,36,14,9,12,3,36,256,220,209,83,130.05372761349437,28.460224906289046,61.80674718867139,44.90004164931278,190.87963348604745,159.6992919616826,169.8496459808413,81.65139525197834,10
470,Terry Taylor,Chicago Bulls,F,11,46,4,8,275.0,1,2,50.0,2,3,150.0,2,10,12,3,1,1,0,0,-17,26,23,14,15,18.067776456599287,35.99286563614745,3.202140309155767,1.7431629013079668,119.04161712247324,96.76932223543402,26.033293697978596,53.50178359096314,4
471,Thaddeus Young,Phoenix Suns,F,16,53,8,14,225.0,0,2,0.0,0,0,0.0,12,9,21,4,5,3,2,0,16,41,37,20,25,8.053254437869821,53.94674556213018,4.852071005917159,0.0,73.55621301775149,64.45562130177514,21.331360946745562,54.62130177514793,4
472,Thaddeus Young,Phoenix Suns,PF,41,128,20,28,469.9,1,3,50.0,0,2,0.0,11,18,29,14,12,2,4,1,-24,84,70,55,43,161.15680473372782,30.30473372781065,29.89349112426035,0.0,444.91124260355036,260.1065088757396,308.1508875739645,98.00887573964496,6
473,Thanasis Antetokounmpo,Milwaukee Bucks,SF,10,48,5,11,266.7,0,2,0.0,0,1,0.0,2,1,3,4,8,1,3,1,-18,17,13,14,7,15.09375,1.5,1.5,0.0,20.34375,18.59375,16.84375,3.0,6
474,Theo Maledon,Phoenix Suns,PG,5,10,1,2,50.0,3,3,100.0,0,0,0.0,0,1,1,0,3,0,3,0,-11,6,6,5,1,14.0625,0.5625,0.0,0.0,20.25,20.25,14.0625,0.5625,1
475,Thomas Bryant,Miami Heat,C,89,144,32,58,486.6,21,23,750.0,4,16,233.3,12,39,51,7,16,4,2,7,41,147,140,96,58,532.4375456537618,112.66398831263696,8.10591672753835,4.410518626734843,1016.4273192111029,969.3089846603359,582.6574141709277,117.66837107377648,10
476,Tim Hardaway Jr.,Dallas Mavericks,SF,95,205,33,84,308.40000000000003,10,15,441.7,19,51,300.6,2,21,23,24,7,9,5,1,56,142,118,119,47,675.2448979591836,60.288903061224495,30.972576530612244,33.48979591836734,1220.4183673469388,985.8960459183675,892.40625,108.62244897959184,10
477,Tobias Harris,Philadelphia 76ers,PF,144,344,58,140,397.5,16,21,668.3,12,43,252.8,9,65,74,24,12,11,14,8,-50,242,218,168,98,423.8561384532179,104.60789616008654,15.030827474310438,15.704705246078962,708.8426176311519,594.3147647376961,528.3082747431043,129.71444023796647,10
478,Torrey Craig,Chicago Bulls,SF,72,200,26,54,478.3,4,6,200.0,16,37,413.8,5,21,26,14,19,5,6,3,-51,112,98,86,40,121.72778827977315,28.658790170132324,8.67296786389414,14.409262759924387,272.0538752362949,237.62287334593574,152.42722117202268,41.06332703213611,10
479,Tosan Evbuomwan,Detroit Pistons,F,64,210,22,43,552.3,13,20,341.7,7,19,373.3,6,27,33,4,16,3,6,2,-87,101,97,68,37,188.60408163265305,66.32244897959184,4.530612244897959,6.151020408163266,456.20816326530615,407.8734693877551,216.26122448979592,91.53061224489795,10
480,Toumani Camara,Portland Trail Blazers,F,88,292,35,67,507.2,8,9,350.0,10,26,336.6,19,23,42,22,26,8,13,8,-36,152,130,110,64,287.6210696049449,51.986562751948405,28.5907014243483,8.00268744961032,547.7635044342919,471.95915076592314,351.3007256113948,92.70196183821552,10
481,Trae Young,Atlanta Hawks,PG,235,370,76,173,432.4,45,55,813.4,38,93,399.0,2,18,20,109,22,11,45,2,-38,364,255,344,129,758.2361111111111,12.069444444444445,83.0,45.06944444444444,786.5,622.5,926.4027777777778,90.90277777777777,10
482,Trayce JacksonDavis,Golden State Warriors,F,117,266,54,75,728.8,9,21,378.3,0,1,0.0,31,48,79,20,17,8,6,19,15,216,196,137,99,195.95198902606307,118.61865569272975,25.512345679012345,0.0,471.51234567901236,386.0,246.99108367626886,178.60425240054866,10
483,Tre Jones,San Antonio Spurs,PG,115,313,42,74,508.6,17,19,650.0,14,26,297.1,7,33,40,64,14,11,16,0,6,219,155,179,104,506.5,26.29726516052319,39.142092746730086,27.086801426872768,547.0,520.2455410225922,520.1938168846611,78.5,10
484,Tre Mann,Charlotte Hornets,PG,123,321,49,101,492.4,13,19,317.1,12,37,298.4,8,37,45,52,15,14,19,1,-62,220,168,175,97,216.55292570677187,38.77777777777778,58.28402366863905,7.940828402366864,412.10913872452335,331.0401051939513,328.750164365549,65.9335963182117,10
485,Trendon Watford,Brooklyn Nets,PF,73,140,25,53,454.3,17,22,475.7,6,14,200.0,10,22,32,7,17,5,8,5,-25,112,105,80,39,326.2985537190082,49.59194214876033,16.11673553719008,6.40185950413223,566.220041322314,484.47107438016525,400.3305785123967,73.42561983471074,10
486,Trent Forrest,Atlanta Hawks,G,22,131,9,26,323.3,4,4,200.0,0,3,0.0,3,11,14,36,4,3,6,2,-20,72,36,58,50,35.68336483931947,12.400756143667296,62.53780718336484,0.0,141.60302457466918,26.5,135.60680529300566,90.11814744801512,10
487,Trevelin Queen,Orlando Magic,SG,0,13,0,3,0.0,0,0,0.0,0,2,0.0,0,1,1,1,1,0,0,0,-17,2,1,1,2,0.0,0.5555555555555556,0.5555555555555556,0.0,0.22222222222222227,0.5555555555555556,0.5555555555555556,0.22222222222222227,2
488,Trey Jemison,Memphis Grizzlies,C,82,232,36,58,546.0,10,12,500.0,0,0,0.0,27,24,51,11,29,3,15,7,-11,144,133,93,62,463.5086505190312,21.519031141868517,6.922145328719723,0.0,530.5415224913496,590.3287197231834,406.40311418685127,25.759515570934255,10
489,Trey Lyles,Sacramento Kings,PF,53,186,18,46,392.9,12,16,625.0,5,22,236.7,11,28,39,8,19,0,7,3,1,100,92,61,47,103.99173553719008,15.06198347107438,7.640495867768594,7.148760330578514,183.88429752066114,131.55785123966942,140.88016528925618,38.14049586776859,10
490,Trey Murphy III,New Orleans Pelicans,SG,157,324,51,120,425.7,26,30,760.7,29,82,363.1,7,57,64,29,10,5,10,6,15,250,221,186,93,331.24298469387753,73.74744897959184,22.64604591836735,30.918367346938776,429.91836734693874,390.65625,332.86989795918373,134.02869897959184,10
491,Tristan Thompson,Cleveland Cavaliers,C,18,69,8,14,258.4,2,6,100.0,0,0,0.0,10,14,24,8,8,3,4,3,-8,50,42,26,32,36.39958376690947,22.253902185223723,1.4505723204994796,0.0,77.46305931321541,88.55150884495318,30.283038501560874,18.732570239334024,6
492,Troy Brown Jr.,Detroit Pistons,SF,37,173,12,47,255.4,7,9,230.0,6,26,174.89999999999998,4,24,28,9,6,3,7,0,-61,74,65,46,37,52.27777777777778,33.89660493827161,9.06327160493827,4.444444444444445,184.27777777777777,144.5817901234568,83.93364197530865,51.0,10
493,TyTy Washington Jr.,Milwaukee Bucks,G,0,8,0,2,0.0,0,0,0.0,0,1,0.0,0,0,0,1,0,0,0,0,-4,1,0,1,1,0.0,0.0,0.44444444444444453,0.0,0.44444444444444453,0.0,0.44444444444444453,0.44444444444444453,1
494,Tyler Herro,Miami Heat,PG,183,325,71,166,433.4,10,13,333.4,31,80,406.0,3,46,49,50,11,0,13,1,35,282,232,233,99,148.11111111111111,40.94444444444444,28.069444444444443,12.944444444444445,309.7361111111111,207.61111111111111,206.125,113.125,10
495,Tyrese Haliburton,Indiana Pacers,PG,176,329,65,146,450.8,22,25,696.7,24,75,320.3,4,40,44,94,16,19,22,8,51,314,220,270,138,182.0,49.180165289256195,90.30413223140496,24.519008264462812,268.8495867768595,148.70743801652895,340.7404958677686,100.88595041322314,10
496,Tyrese Maxey,Philadelphia 76ers,PG,235,380,85,199,429.8,37,45,650.0,28,79,365.6,2,30,32,59,18,9,17,4,-10,326,267,294,91,601.8821644713421,58.147383410466354,85.25133499466003,21.609113563545748,865.0729797080811,888.871840512638,533.9522961908152,187.52972588109645,10
497,Tyus Jones,Washington Wizards,PG,91,313,36,84,402.0,4,4,300.0,15,43,360.8,3,22,25,97,4,9,13,2,-70,213,116,188,122,345.04336734693874,43.53316326530612,160.5,20.959183673469386,776.265306122449,542.0510204081633,542.9719387755102,240.3188775510204,10
498,Udoka Azubuike,Phoenix Suns,C,2,11,1,3,33.3,0,2,0.0,0,0,0.0,2,4,6,0,1,0,0,0,-3,8,8,2,6,1.7777777777777781,13.444444444444443,0.0,0.0,25.0,25.0,1.7777777777777781,13.444444444444443,1
499,Vasilije Micic,Charlotte Hornets,G,131,313,49,96,494.8,19,22,652.8,14,36,313.3,4,18,22,63,16,9,28,3,-82,216,153,194,85,483.464,28.304000000000002,114.644,24.516000000000002,573.2360000000001,434.536,585.716,179.396,10
500,Victor Wembanyama,San Antonio Spurs,C,215,316,76,166,454.9,45,63,686.1,18,64,280.6,29,90,119,46,25,9,46,37,12,380,334,261,165,988.5086505190311,179.33141099577085,30.40984236831988,13.729334871203383,2170.462898885044,1872.3683198769704,1222.9000384467513,273.44444444444446,10
501,Vince Williams Jr.,Memphis Grizzlies,G,127,336,42,92,459.70000000000005,30,38,723.3,13,34,328.8,8,54,62,61,30,12,34,9,-54,250,189,188,123,231.93628808864267,72.8808864265928,35.61495844875347,18.00831024930748,492.2326869806094,474.07479224376726,226.76454293628805,131.82548476454295,10
502,Vit Krejci,Atlanta Hawks,G,71,302,27,54,532.6,4,5,150.0,13,33,305.4,5,20,25,25,29,5,11,5,31,121,96,96,50,174.95002974419987,28.929803688280785,10.513384889946462,16.164782867340868,299.1998810232005,280.58655562165376,190.41165972635338,42.594883997620464,10
503,Walker Kessler,Utah Jazz,C,68,238,29,39,747.5,10,12,500.0,0,0,0.0,24,59,83,10,17,3,13,11,-65,161,151,78,93,139.01350186727953,66.80810112036771,4.0,0.0,250.43924159724216,220.4392415972422,151.0135018672795,88.80810112036771,10
504,Wendell Carter Jr.,Orlando Magic,C,87,248,34,76,436.0,12,22,450.0,7,32,190.0,27,52,79,22,15,9,17,6,-24,188,166,109,101,194.2958412098299,109.39603024574667,12.091682419659735,6.387523629489603,375.61531190926274,352.73345935727787,228.6899810964083,109.97542533081284,10
505,Wendell Moore Jr.,Minnesota Timberwolves,G,2,5,1,1,100.0,0,0,0.0,0,0,0.0,0,2,2,0,1,0,0,0,8,4,4,2,2,3.1604938271604937,2.96604938271605,0.0030864197530864196,0.0,11.8641975308642,12.25,2.96604938271605,2.777777777777778,1
506,Wenyen Gabriel,Memphis Grizzlies,F,17,81,8,22,168.3,0,5,0.0,1,6,50.0,7,18,25,3,10,2,8,2,-16,45,42,20,28,59.72702331961591,43.6159122085048,4.060356652949245,0.879286694101509,182.2098765432099,171.6858710562414,60.574759945130324,57.352537722908096,5
507,Wesley Matthews,Atlanta Hawks,SG,48,143,16,37,476.0,2,3,100.0,14,26,561.7,4,19,23,7,10,4,2,7,-26,78,71,55,30,108.2382271468144,41.0,14.180055401662047,6.559556786703601,211.617728531856,198.9224376731302,117.67036011080334,58.443213296398895,10
508,Xavier Moon,LA Clippers,G,2,11,1,6,33.3,0,0,0.0,0,2,0.0,1,1,2,0,1,1,1,0,-20,4,4,2,2,2.133194588969823,2.5327783558792927,0.9177939646201871,0.0,0.35171696149843923,0.13319458896982309,3.7502601456815823,2.052029136316337,2
509,Xavier Tillman,Boston Celtics,F,32,162,13,30,418.3,3,4,150.0,3,17,183.3,10,27,37,9,8,5,3,3,30,78,69,41,46,49.89660493827161,30.382716049382715,5.063271604938271,2.277777777777778,116.32716049382715,129.125,40.91975308641975,31.625,10
510,Yuta Watanabe,Memphis Grizzlies,SF,22,97,10,24,250.0,0,2,0.0,2,12,64.3,0,11,11,5,6,5,4,0,-36,38,33,27,16,115.08000000000001,11.27,3.75,1.4800000000000004,136.28,131.43,116.23000000000002,18.72,7
511,Zach Collins,San Antonio Spurs,PF,85,181,32,67,456.3,17,24,541.7,4,14,300.0,12,30,42,20,35,7,18,10,-51,147,127,105,62,204.19876970396004,75.60553633217994,28.753556324490578,4.481353325643982,350.2179930795848,365.4490580545944,201.0968858131488,92.22991157247213,10
512,Zeke Nnaji,Denver Nuggets,PF,18,100,6,17,350.0,6,8,300.0,0,2,0.0,7,10,17,4,10,2,2,10,-19,39,35,22,21,50.40625,16.277777777777775,7.350694444444445,0.0,130.125,94.18402777777779,73.06944444444443,36.90625,10
513,Ziaire Williams,Memphis Grizzlies,F,103,270,39,94,389.0,13,16,421.4,12,46,213.7,6,38,44,20,15,12,15,0,-39,167,147,123,64,552.1,32.4,24.0,17.599999999999998,788.1,632.1,714.1,50.4,10
514,Zion Williamson,New Orleans Pelicans,PF,265,335,101,157,627.1,63,86,678.4,0,0,0.0,17,51,68,43,26,13,36,7,38,376,333,308,111,785.5919067215364,27.44581618655693,70.74417009602196,0.003429355281207133,978.4252400548698,925.5864197530865,883.0864197530864,53.534293552812066,10
