,First Last Name,team,position,points,minutes,fgm,fga,fgp,ftm,fta,ftp,tpm,tpa,tpp,offReb,defReb,totReb,assists,pFouls,steals,turnovers,blocks,plusMinus,Points_Rebounds_Assist,Points_Rebounds,Points_Assist,Rebounds_Assist,points_deviation,totReb_deviation,assists_deviation,tpm_deviation,Points_Rebounds_Assist_deviation,Points_Rebounds_deviation,Points_Assist_deviation,Rebounds_Assist_deviation,count
0,A. Flagler,Oklahoma City Thunder,F,3,15,1,7,25.0,0,0,0.0,1,6,33.3,0,0,0,4,0,0,0,0,0,7,3,7,4,6.12,0.0,2.7200000000000006,0.6800000000000002,17.0,6.12,17.0,2.7200000000000006,2
1,A.J. Green,Milwaukee Bucks,G,38,150,13,37,316.2,3,4,200.0,9,30,206.7,1,12,13,4,10,4,5,2,30,55,51,42,17,94.825,22.1390625,4.4390625,14.4015625,211.725,169.6015625,125.42656249999999,38.099999999999994,10
2,A.J. Lawson,Dallas Mavericks,G,40,98,17,45,378.5,4,8,200.0,2,16,100.0,4,16,20,8,6,1,3,1,-21,68,60,48,28,150.60880270852567,45.31055709449061,7.17205293936596,1.8719606032625422,334.24376731301936,273.8387196060326,183.36226531240382,80.13419513696522,10
3,AJ Griffin,Atlanta Hawks,F,7,29,3,9,66.6,0,0,0.0,1,4,100.0,0,4,4,1,0,0,1,1,-15,12,11,8,5,1.2469135802469125,8.617283950617283,0.5555555555555556,0.5555555555555556,8.024691358024691,4.506172839506172,0.3950617283950621,13.54320987654321,2
4,Aaron Gordon,Denver Nuggets,PF,140,320,51,92,564.3,31,42,694.6,7,25,266.6,25,41,66,50,24,5,14,4,82,256,206,190,116,236.1636019469984,34.809356408869654,41.56300703082747,6.5,209.4299621416982,264.45538128718226,174.73796646836126,82.7725797728502,10
5,Aaron Holiday,Houston Rockets,G,62,145,24,53,338.1,6,6,200.0,8,26,213.3,5,8,13,14,18,5,6,0,-8,89,75,76,27,374.5340234818836,24.10011362201742,7.480873627067288,7.747254134578967,606.365736649413,545.4547405630602,423.8076000504987,43.21840676682237,10
6,Aaron Nesmith,Indiana Pacers,SF,114,309,42,87,522.1,17,17,700.0,13,47,290.8,8,36,44,21,31,5,8,5,71,179,158,135,65,115.08985338946145,7.321817390042094,36.98606474089127,17.415154594280736,166.9268398896792,145.61678037451009,131.76324575410075,48.944549281463196,10
7,Aaron Wiggins,Oklahoma City Thunder,SG,114,219,44,83,607.4,17,19,816.7,9,18,483.3,6,25,31,24,18,15,8,3,32,169,145,138,55,495.61883656509696,26.71745152354571,28.304709141274234,7.022160664819944,688.4703601108032,548.8326869806094,655.5047091412742,34.773961218836575,10
8,Adama Sanogo,Chicago Bulls,C,26,51,10,23,84.4,6,9,66.7,0,0,0.0,16,11,27,0,5,1,4,0,9,53,53,26,27,375.48582230623816,291.3213610586011,0.0,0.0,1324.9168241965976,1324.9168241965976,375.48582230623816,291.3213610586011,3
9,Admiral Schofield,Orlando Magic,SF,8,18,3,6,116.7,0,0,0.0,2,4,150.0,0,4,4,1,1,1,0,0,-20,13,12,9,5,15.948870392390013,0.8763376932223544,0.6682520808561238,0.8097502972651605,22.0,19.15101070154578,17.428061831153386,2.914387633769322,3
10,Al Horford,Boston Celtics,C,107,253,42,76,567.9,4,6,200.0,19,43,485.0,12,49,61,18,6,5,8,7,54,186,168,125,79,280.10532544378697,39.710059171597635,10.366863905325445,14.928994082840235,330.40236686390534,334.28402366863907,275.4,50.90059171597633,10
11,Alec Burks,New York Knicks,SG,57,130,17,59,227.7,13,16,471.4,10,32,259.9,1,17,18,11,3,5,6,0,-2,86,75,68,29,289.8632088148347,18.807847352862133,13.03547433485622,8.526740123622682,476.8589088954582,432.7350174684225,332.3961300725611,33.43429185702768,10
12,Aleksej Pokusevski,Charlotte Hornets,F,84,194,27,62,478.9,19,27,475.0,11,28,356.6,6,42,48,12,8,4,8,6,9,144,132,96,60,110.53157753292125,40.54985219027143,9.67696855683956,5.434291857027682,191.7790916420317,220.88578339156143,95.43402311206665,36.217683418435904,10
13,Alex Caruso,Chicago Bulls,SG,88,311,31,69,468.5,3,4,150.0,23,47,474.4,7,33,40,53,21,17,17,6,-39,181,128,141,93,237.4768166089965,28.167474048442905,50.96539792387543,28.11695501730103,421.04844290657445,338.5467128027682,287.36401384083047,111.74740484429066,10
14,Alex Fudge,Dallas Mavericks,F,11,26,5,9,55.6,0,0,0.0,1,3,33.3,2,1,3,0,1,3,1,0,-19,14,14,11,3,60.5,0.5,0.0,0.5,72.0,72.0,60.5,0.5,2
15,Alex Len,Sacramento Kings,C,12,104,5,10,400.0,2,4,50.0,0,0,0.0,9,18,27,18,20,1,6,7,38,57,39,30,45,31.633136094674555,36.72225576621181,12.212051684579157,0.0,52.7555850742664,69.64533268928874,20.55524695085135,43.12244897959184,10
16,Alondes Williams,Miami Heat,G,0,6,0,1,0.0,0,0,0.0,0,1,0.0,0,1,1,0,0,0,1,0,-2,1,1,0,1,0.8975069252077561,0.8975069252077563,0.0,0.0,0.0,0.0,0.8975069252077561,0.8975069252077563,1
17,Alperen Sengun,Houston Rockets,C,209,324,81,157,512.7,43,68,622.9,4,12,200.0,39,68,107,45,36,16,26,7,2,361,316,254,152,847.1723356009071,197.81632653061226,123.77551020408163,4.408163265306122,1935.0226757369614,1622.4580498866212,993.7777777777778,487.5510204081633,10
18,Amari Bailey,Charlotte Hornets,G,18,39,6,15,123.3,5,5,200.0,1,5,50.0,4,3,7,5,2,3,3,0,6,30,25,23,12,81.21301775147928,18.633136094674555,10.325443786982248,0.7633136094674556,257.8520710059172,176.43786982248525,139.66863905325448,51.917159763313606,3
19,Amen Thompson,Houston Rockets,F,136,310,53,95,605.0,30,40,733.3,0,4,0.0,42,54,96,42,23,16,17,5,26,274,232,178,138,344.2716049382716,170.44938271604937,67.7,0.019753086419753086,1311.3,949.1999999999999,582.7716049382716,361.7493827160494,10
20,Amir Coffey,LA Clippers,SG,92,281,33,90,414.8,12,15,466.7,14,48,279.1,6,28,34,10,20,8,5,3,-29,136,126,102,44,311.2312210751157,42.590423638305445,5.353684585261659,10.496262014951942,547.7111071555714,518.37878248487,340.35315058739764,48.15450338198647,10
21,Andre Drummond,Chicago Bulls,C,83,164,34,59,576.3,15,23,263.4,0,0,0.0,29,68,97,4,19,12,9,8,51,184,180,87,101,194.7871315192744,242.1045918367347,8.402777777777779,0.0,804.9719387755102,746.172335600907,241.19387755102042,262.90022675736964,10
22,Andre Jr. Jackson,Milwaukee Bucks,G,17,91,7,18,400.0,0,0,0.0,3,9,200.0,6,16,22,9,11,4,6,2,-20,48,39,26,31,29.0641975308642,13.777777777777775,7.108641975308641,2.1604938271604937,72.9530864197531,67.12345679012344,35.145679012345674,20.63456790123457,10
23,Andrew Funk,Chicago Bulls,G,0,7,0,2,0.0,0,0,0.0,0,2,0.0,0,0,0,0,0,0,0,1,0,0,0,0,0,0.0,0.0,0.0,0.0,0.0,0.0,0.0,0.0,1
24,Andrew Nembhard,Indiana Pacers,PG,92,282,35,70,485.5,12,15,460.0,10,29,298.3,6,15,21,39,25,7,9,1,59,152,113,131,60,191.1164933837429,9.093572778827978,37.01346880907372,6.231568998109641,267.9395085066163,247.27622873345936,215.87618147448015,42.010633270321364,10
25,Andrew Wiggins,Golden State Warriors,SF,161,286,55,130,419.1,33,41,658.3,18,50,325.8,9,39,48,19,17,6,19,10,3,228,209,180,67,337.52318339100344,21.06020761245675,51.426297577854676,13.712110726643598,545.447750865052,373.76539792387547,472.30449826989616,109.38754325259517,10
26,Anfernee Simons,Portland Trail Blazers,SG,234,361,80,177,436.7,36,39,757.1,38,94,405.4,4,33,37,64,19,7,30,1,-38,335,271,298,101,935.5240670632775,28.301243915630067,125.20497566252028,19.635478637101134,1764.6960519199567,1205.978907517577,1461.0362358031368,186.71119524067063,10
27,Anthony Black,Orlando Magic,G,42,152,16,36,485.0,2,7,58.3,8,17,341.7,4,10,14,7,10,4,6,2,-2,63,56,49,21,99.52606310013716,20.151577503429355,4.215363511659808,10.735939643347052,195.2716049382716,164.41700960219478,129.08161865569275,25.665980795610423,10
28,Anthony Davis,Los Angeles Lakers,PF,256,349,94,163,570.6,65,78,731.5,3,21,150.0,31,95,126,24,29,12,28,22,73,406,382,280,150,845.4012419077817,124.0832342449465,36.4256837098692,2.5719381688466116,1486.5023120623596,1412.4444444444443,938.5578015589906,141.41022592152203,10
29,Anthony Edwards,Minnesota Timberwolves,SG,243,343,80,180,419.5,59,66,856.4,24,72,275.3,7,42,49,53,21,16,28,2,18,345,292,296,102,1199.5619834710744,68.77879808182837,34.48005305581063,40.431996735027035,1525.4664830119377,1334.1442709927558,1408.0346903377208,86.10835629017447,10
30,Anthony Gill,Washington Wizards,PF,94,232,39,84,450.8,12,14,460.0,4,20,136.6,16,24,40,14,29,6,5,4,-58,148,134,108,54,262.0,85.34693877551022,15.216326530612246,2.4020408163265303,595.6897959183673,559.9183673469388,286.8734693877551,111.46122448979592,10
31,Ashton Hagans,Portland Trail Blazers,G,43,175,15,38,303.3,7,8,350.0,6,17,250.0,9,18,27,32,20,7,18,3,-6,102,70,75,59,118.125,20.2,17.7,6.425,182.225,173.225,127.725,37.3,10
32,Ausar Thompson,Detroit Pistons,F,103,314,42,87,508.0,11,25,325.0,8,29,195.3,15,44,59,21,26,17,14,11,-6,183,162,124,80,121.7,31.399999999999995,24.125,8.5,347.72499999999997,237.7,200.02499999999998,87.225,10
33,Austin Reaves,Los Angeles Lakers,SG,137,323,51,110,467.5,14,19,483.4,21,58,356.6,8,28,36,38,23,5,17,7,-22,211,173,175,74,279.51728446480627,60.051020408163275,62.48667221990838,8.963348604748022,625.3373594335694,427.0289462723866,397.50791336942933,202.8554768846314,10
34,Ayo Dosunmu,Chicago Bulls,SG,154,369,61,121,521.7,14,17,491.7,18,47,416.1,8,24,32,37,31,12,19,8,-47,223,186,191,69,199.81406249999992,19.756249999999998,23.5390625,15.200000000000001,328.9062500000001,243.87656250000006,273.7999999999999,54.339062500000004,10
35,Bam Adebayo,Miami Heat,C,160,331,67,119,578.7,21,29,625.0,5,18,225.0,17,61,78,31,23,7,15,8,51,269,238,191,109,292.499248468031,155.429760665973,43.530697190426636,4.548849577985894,735.4444444444443,611.2977222800323,371.34732338998725,244.25910509885531,10
36,Ben Sheppard,Indiana Pacers,G,56,196,20,60,332.79999999999995,3,3,200.0,13,42,286.79999999999995,6,17,23,14,17,7,7,0,39,93,79,70,37,102.07271809115011,13.533770988511552,8.74788536800909,9.139881328115138,123.58982451710645,117.10377477591214,111.54626941042797,19.294154778437065,10
37,Ben Simmons,Brooklyn Nets,PG,53,168,24,38,521.1,5,11,150.0,0,0,0.0,15,39,54,46,20,9,12,4,-5,153,107,99,100,134.88888888888889,64.0,78.88888888888889,0.0,382.0,162.8888888888889,300.0,196.88888888888889,9
38,Bennedict Mathurin,Indiana Pacers,SG,139,275,44,115,340.3,35,45,614.5,16,44,245.0,10,33,43,23,24,7,17,4,-18,205,182,162,66,753.4765625,123.6015625,38.125,30.4140625,1418.90625,1097.65625,970.9140625,265.5390625,10
39,Bilal Coulibaly,Washington Wizards,SG,90,289,30,76,451.5,19,27,633.3,11,39,238.3,9,30,39,18,22,12,8,7,-98,147,129,108,57,127.37777777777777,38.5,16.0,13.177777777777775,337.8777777777778,291.7444444444444,166.31111111111107,61.699999999999996,10
40,Bismack Biyombo,Oklahoma City Thunder,C,16,66,6,11,183.3,4,8,150.0,0,0,0.0,5,12,17,2,7,1,4,3,11,35,33,18,19,43.52777777777778,41.0,1.7152777777777775,0.0,167.9375,167.52777777777777,44.4375,42.21527777777778,7
41,Blake Wesley,San Antonio Spurs,G,54,186,19,43,403.3,12,18,516.7,4,14,191.7,3,23,26,34,16,3,17,0,-18,114,80,88,60,281.2136105860113,41.25992438563327,29.948015122873343,4.403827977315689,481.98487712665406,469.3468809073724,296.2807183364839,68.77882797731569,10
42,Boban Marjanovic,Houston Rockets,C,16,19,7,9,175.0,2,5,83.3,0,0,0.0,0,11,11,1,0,1,3,1,6,28,27,17,12,87.80718336483932,40.7882797731569,0.5765595463137996,0.0,265.9243856332704,244.00189035916827,101.78638941398869,49.30812854442344,2
43,Bobby Portis,Milwaukee Bucks,F,169,273,74,141,515.1,7,8,366.7,14,30,376.7,23,70,93,21,20,10,16,7,16,283,262,190,114,450.0657880752471,44.885216282282926,9.740780104155597,20.415347008183655,438.3716654267191,423.4256562865342,466.2378573706027,53.39993623126795,10
44,Bogdan Bogdanovic,Atlanta Hawks,SG,189,331,63,141,477.0,34,35,890.0,29,78,457.2,5,33,38,35,27,11,19,8,-43,262,227,224,73,542.4555785123966,75.6955061983471,42.9661673553719,14.918646694214877,1018.9297520661156,930.8814566115703,640.0818698347107,109.08367768595042,10
45,Bojan Bogdanovic,New York Knicks,SF,104,171,38,85,438.9,12,16,475.0,16,39,466.6,4,20,24,7,8,2,7,0,1,135,128,111,31,166.08623811679493,49.83431416930738,5.064961521050249,4.446355817111815,278.791760977818,307.8309189678588,145.0,46.94635581711182,10
46,Bol Bol,Phoenix Suns,C,46,113,17,27,419.2,5,6,175.0,7,11,275.0,4,25,29,4,8,4,4,5,-19,79,75,50,33,274.5698775407145,22.90556747885368,2.403231915162227,12.123343012245927,484.97879055674787,438.6139376341371,312.12624668602444,34.11728317131676,10
47,Bones Hyland,LA Clippers,PG,103,197,39,96,342.6,7,9,325.0,18,55,259.4,2,30,32,43,18,12,16,2,-39,178,135,146,75,1264.8424494649225,69.12306777645661,116.42865636147442,38.916171224732466,2415.6414982164088,1601.4708680142687,2008.542211652794,256.02259215219976,10
48,Bradley Beal,Phoenix Suns,SG,197,361,77,136,561.2,15,16,466.7,28,43,586.2,16,38,54,48,25,12,23,10,18,299,251,245,102,865.3356722498868,60.69827976459936,32.424852874603886,47.5663196016297,829.9993209597102,935.8483476686284,774.4006337709371,78.20914440923495,10
49,Brandin Podziemski,Golden State Warriors,G,90,256,37,70,537.3,3,3,200.0,13,24,506.6,16,46,62,32,11,6,10,1,23,184,152,122,94,181.663726219577,58.85768944627485,29.892868530130727,8.529386757359974,291.16250398554575,173.85928366457648,298.9807630991604,88.73674141779148,10
50,Brandon Boston Jr.,LA Clippers,SG,90,194,36,87,459.0,11,19,441.7,7,29,155.5,10,22,32,7,21,9,17,4,-48,129,122,97,39,405.1128985923584,58.54467107153117,10.687446136167766,8.404768744613618,902.9184142487791,744.8618213157138,521.3849468543522,111.01666187877046,10
51,Brandon Clarke,Memphis Grizzlies,PF,68,134,33,59,329.5,1,7,50.0,1,6,100.0,13,19,32,9,8,5,3,6,-8,109,100,77,41,87.60640000000001,33.3344,9.5024,0.8335999999999999,105.19839999999999,89.6416,91.16,54.84,6
52,Brandon Ingram,New Orleans Pelicans,SF,158,310,63,139,459.0,25,28,721.7,7,24,273.3,5,45,50,39,22,5,22,8,-61,247,208,197,89,238.78889284442866,10.800996796012814,48.531505873976506,4.6924172303310785,399.51833392666424,311.5863296546813,327.7760768956923,58.27732289070843,10
53,Brandon Miller,Charlotte Hornets,F,207,335,73,154,470.8,27,30,796.7,34,85,396.1,7,35,42,23,24,8,19,8,-74,272,249,230,65,579.0,28.320141003044384,18.16359557763179,42.66527800032046,769.8763018746996,753.3960903701329,578.2522031725686,63.71174491267425,10
54,Brandon Williams,Dallas Mavericks,G,33,72,12,38,146.4,8,10,183.3,1,10,16.7,2,6,8,7,3,0,5,0,-50,48,41,40,15,351.66666666666663,20.204081632653057,9.0,0.8367346938775512,621.4421768707482,515.6802721088435,437.33333333333326,49.29931972789115,6
55,Braxton Key,Denver Nuggets,F,2,6,1,1,100.0,0,1,0.0,0,0,0.0,1,1,2,0,1,0,0,0,2,4,4,2,2,0.41868512110726636,0.6782006920415224,0.08650519031141869,0.08650519031141869,1.3840830449826986,2.1626297577854676,0.12456747404844296,0.28027681660899645,1
56,Brice Sensabaugh,Utah Jazz,F,116,237,38,96,383.5,20,21,583.3,20,53,339.7,7,33,40,23,20,7,17,4,-98,179,156,139,63,538.2486457920464,26.011890606420927,22.120095124851368,49.411547100013216,724.5597833267274,664.4119434535605,572.365570088519,74.1629013079667,10
57,Brook Lopez,Milwaukee Bucks,C,146,284,55,108,499.1,11,15,408.4,25,56,398.1,18,23,41,15,19,2,11,21,-59,202,187,161,56,334.8241285649615,61.46423721140788,16.866681756450884,39.45178813942961,474.25645088275235,483.7596197374378,338.38162064282477,65.27025803531009,10
58,Bruce Brown,Toronto Raptors,SF,102,254,42,75,563.7,10,19,483.3,8,17,375.0,7,23,30,27,20,7,17,0,-133,159,132,129,57,208.6089965397924,41.351643598615915,43.0,9.833910034602077,550.125,315.625,406.9031141868512,120.55752595155708,10
59,Bruno Fernando,Atlanta Hawks,PF,84,196,30,53,513.8,24,34,590.1,0,0,0.0,7,31,38,17,35,2,10,3,-96,139,122,101,55,165.90726643598617,43.82975778546714,14.57370242214533,0.0,243.4,248.75017301038062,170.57093425605535,48.38961937716264,10
60,Bryce McGowens,Charlotte Hornets,G,53,140,16,39,301.2,17,22,391.7,4,14,183.3,1,14,15,10,9,3,5,4,-39,78,68,63,25,267.4237211407877,8.52829334540516,17.018560434585783,4.4001810774105925,479.0194658216388,347.33906745133544,388.76459936622916,35.886373924852876,10
61,Buddy Boeheim,Detroit Pistons,F,25,69,7,21,133.3,5,7,160.0,6,19,126.19999999999999,2,6,8,3,5,0,0,1,12,36,33,28,11,110.28634039444852,10.690284879474069,7.5799853907962005,7.5573411249086915,245.34112490869248,175.53469685902115,170.18772826880937,28.17531044558072,5
62,Buddy Hield,Philadelphia 76ers,SG,78,183,26,76,302.0,10,11,450.0,16,49,269.9,9,16,25,16,14,6,11,1,21,119,103,94,41,409.15008672584435,46.97163554739312,49.33129272523212,27.484338332823185,889.1303948576677,700.9753086419753,578.9535761656973,114.65452504846445,10
63,CJ McCollum,New Orleans Pelicans,SG,226,368,87,187,456.0,10,11,375.0,42,93,425.8,8,33,41,50,19,9,26,6,-30,317,267,276,91,789.9773776981808,13.385710246017533,20.008483363182204,83.2312187765105,996.2996512395135,935.8494674333114,856.5559430672071,27.26581204637572,10
64,Cade Cunningham,Detroit Pistons,PG,241,313,92,212,430.3,40,44,808.3,17,55,297.1,9,44,53,75,18,11,31,2,-38,369,294,316,128,702.373472159348,53.42462652784065,52.55545495699411,12.217745586238117,842.2865550022635,783.9945676776822,690.806699864192,175.83884110457223,10
65,Caleb Houstan,Orlando Magic,G,37,135,12,33,368.3,2,2,100.0,11,31,360.0,5,5,10,3,9,3,1,1,-1,50,47,40,13,98.28890306122449,6.25829081632653,2.1734693877551017,9.038903061224488,103.10204081632652,102.05102040816325,95.06441326530613,12.707270408163264,10
66,Caleb Martin,Miami Heat,SF,95,298,37,85,436.3,7,11,260.0,14,37,474.9,12,25,37,22,20,7,7,7,46,154,132,117,59,461.5665394843335,10.470459012602614,23.681581685744018,18.969823100936527,435.13423517169616,436.9053069719043,456.2477743091687,37.699734073303276,10
67,Cam Reddish,Los Angeles Lakers,SF,21,143,6,25,153.3,5,8,116.7,4,13,166.6,7,5,12,1,7,3,1,3,-37,34,33,22,13,75.05328798185941,17.91043083900227,0.9036281179138321,2.418367346938775,69.18934240362812,75.0,71.70975056689342,16.346938775510203,10
68,Cam Thomas,Brooklyn Nets,SG,280,364,93,211,436.1,64,71,921.4,30,77,364.2,4,31,35,34,23,5,20,4,-25,349,315,314,69,591.6071111111112,47.864,56.544000000000004,26.624000000000002,863.0337777777779,550.3617777777778,920.8871111111112,87.8,10
69,Cam Whitmore,Houston Rockets,F,129,222,46,111,405.4,17,24,488.3,20,56,339.9,11,26,37,15,15,7,10,6,7,181,166,144,52,250.29659763313606,30.59763313609467,37.835059171597635,12.059171597633135,568.4082840236687,393.57174556213016,387.76331360946745,105.80251479289942,10
70,Cameron Johnson,Brooklyn Nets,SF,108,244,35,86,416.4,19,22,650.0,19,52,360.6,6,30,36,16,14,8,9,2,-48,160,144,124,52,173.71267361111114,34.35069444444444,13.684027777777779,12.125,428.0460069444444,306.3515625,261.44184027777777,82.0,10
71,Cameron Payne,Philadelphia 76ers,PG,71,197,27,66,516.2,0,0,0.0,17,40,451.7,5,17,22,34,21,10,10,2,28,127,93,105,56,388.3927621690369,91.06532547115275,33.08613712567927,24.105098855359,656.3922996878252,530.8506185686207,437.5665394843335,200.51936640073995,10
72,Caris LeVert,Cleveland Cavaliers,SG,142,286,51,105,474.90000000000003,25,29,685.7,15,37,404.2,6,37,43,33,16,13,21,4,16,218,185,175,76,472.961937716263,36.73979238754325,92.69550173010381,8.973702422145328,712.5633217993079,657.8359861591696,492.8062283737024,164.318339100346,10
73,Cason Wallace,Oklahoma City Thunder,G,58,202,23,54,428.6,4,4,100.0,8,24,300.0,8,14,22,22,14,16,7,5,33,102,80,80,44,172.48899999999998,13.961,18.201,9.044,208.20100000000002,172.404,205.024,35.424,10
74,Cedi Osman,San Antonio Spurs,SF,70,175,27,53,472.5,1,2,50.0,15,32,373.7,2,23,25,12,17,3,5,2,-40,107,95,82,37,235.14724245577526,36.54162330905307,29.950052029136323,16.565036420395423,418.56711758584805,316.12591050988556,295.82986472424557,108.2502601456816,10
75,Charlie Brown Jr.,New York Knicks,G,3,27,1,5,20.0,0,0,0.0,1,3,33.3,1,1,2,0,4,0,0,1,-6,5,5,3,2,6.12,2.7200000000000006,0.0,0.6800000000000002,17.0,17.0,6.12,2.7200000000000006,2
76,Chet Holmgren,Oklahoma City Thunder,PF,168,262,60,117,518.4,32,42,779.7,16,45,315.0,17,66,83,15,23,7,17,21,66,266,251,183,98,275.344,22.999999999999996,8.899999999999999,12.724000000000002,323.84400000000005,308.264,284.724,38.10000000000001,10
77,Chimezie Metu,Detroit Pistons,PF,114,314,45,91,493.0,11,11,600.0,13,36,346.6,14,53,67,17,18,19,19,5,-53,198,181,131,84,323.1092643890428,63.13850415512465,12.113573407202217,19.27146814404432,576.9615266235764,522.7777777777778,363.99661434287475,88.54847645429363,10
78,Chris Boucher,Toronto Raptors,PF,69,120,25,35,573.3,15,18,500.0,4,12,216.7,13,27,40,5,11,1,9,5,7,114,109,74,45,142.20987654320987,47.580246913580254,5.913580246913581,4.0246913580246915,410.0,329.0246913580247,192.69135802469134,83.98765432098766,8
79,Chris Duarte,Sacramento Kings,SG,39,120,14,42,302.5,4,4,200.0,7,27,239.3,6,10,16,5,8,4,5,3,-35,60,55,44,21,171.20266466504034,20.868455620191405,6.5042221805216744,6.21711390504785,339.6888722086695,268.02420716832427,222.77838243572901,47.46162507036967,10
80,Chris Livingston,Milwaukee Bucks,F,6,20,3,5,100.0,0,0,0.0,0,2,0.0,1,5,6,1,7,0,2,0,-11,13,12,7,7,24.48,16.988799999999998,0.9232,0.0,78.86879999999998,80.7328,22.7152,17.8128,2
81,Chris Paul,Golden State Warriors,PG,89,257,37,87,416.09999999999997,2,2,100.0,13,38,349.9,0,31,31,54,20,14,17,3,34,174,120,143,85,85.90404993467847,34.976484250254025,69.24952823341559,4.122078676150385,320.5402816083611,126.02061257076497,236.36681666424738,148.2829147916969,10
82,Christian Braun,Denver Nuggets,G,88,248,34,72,476.3,8,13,233.3,12,31,383.3,15,31,46,26,16,7,7,5,75,160,134,114,72,204.46260585654525,70.14876033057851,56.5011733496582,10.506070809101114,528.0,384.8850117334965,339.4214876033058,134.80604019997958,10
83,Christian Wood,Los Angeles Lakers,F,59,133,22,51,477.0,11,14,450.0,4,19,225.0,6,28,34,6,12,5,5,2,-14,99,93,65,40,153.90277777777777,54.402777777777786,4.625,2.4444444444444446,305.125,285.0,156.7777777777778,76.27777777777777,10
84,Chuma Okeke,Orlando Magic,PF,2,40,0,6,0.0,2,2,100.0,0,5,0.0,0,5,5,2,2,2,3,0,-23,9,7,4,7,3.5770686857760943,3.086533261222282,1.4256354786371008,0.0032449972958355864,7.598161168199027,6.833423472147107,3.3693888588426173,5.484586262844781,6
85,Clint Capela,Atlanta Hawks,C,129,297,57,89,634.9,15,27,267.9,0,0,0.0,39,79,118,21,14,6,12,10,9,268,247,150,139,238.4039262343843,100.29892920880428,13.632956573468174,0.0,505.47798929208807,410.332242712671,292.3367043426532,155.1448542534206,10
86,Coby White,Chicago Bulls,PG,185,345,72,148,469.40000000000003,23,28,525.7,18,56,258.2,4,32,36,40,24,8,18,1,-4,261,221,225,76,964.510014420766,43.17288896010255,37.012978689312604,22.507610959782088,1573.760134593815,1317.3496234577792,1190.9221278641244,110.18426534209262,10
87,Cody Martin,Charlotte Hornets,SF,69,285,28,76,367.2,6,7,250.0,7,30,228.2,6,44,50,42,15,11,20,7,-28,161,119,111,92,111.0,28.18685121107267,64.68512110726644,2.6816608996539792,183.02076124567472,112.9515570934256,173.33217993079583,100.60899653979239,10
88,Cody Zeller,New Orleans Pelicans,C,9,40,4,7,300.0,1,2,50.0,0,0,0.0,5,11,16,5,6,2,3,0,15,30,25,14,21,4.760416666666666,10.708333333333332,5.208333333333333,0.0,28.760416666666675,21.59375,12.34375,15.5,6
89,Colby Jones,Sacramento Kings,G,17,63,7,23,199.89999999999998,2,4,100.0,1,9,16.7,6,9,15,10,13,3,3,3,28,42,32,27,25,29.502958579881653,15.704142011834321,12.412721893491126,0.8875739644970416,137.3239644970414,75.3491124260355,73.7381656804734,45.856508875739635,7
90,Cole Anthony,Orlando Magic,PG,63,164,23,70,286.3,12,12,600.0,5,24,141.6,2,21,23,16,9,5,12,2,-30,102,86,79,39,515.7324832723141,48.59348567100114,41.34730463325338,15.696376720111097,931.3983082944072,715.8707233935111,702.793712915036,118.407145562429,10
91,Cole Swider,Miami Heat,F,19,44,6,16,104.7,2,2,100.0,5,13,116.7,0,5,5,1,1,0,4,0,-18,25,24,20,6,140.88109393579074,3.0047562425683716,0.8192627824019023,12.148632580261594,173.99405469678956,175.93579072532705,138.66111771700355,4.102259215219976,5
92,Colin Castleton,Los Angeles Lakers,C,0,12,0,2,0.0,0,0,0.0,0,0,0.0,0,1,1,0,3,1,2,0,-16,1,1,0,1,1.314828341855369,0.5821767713659605,0.0,0.0,1.239590942293645,1.239590942293645,1.314828341855369,0.5821767713659605,2
93,Collin Gillespie,Denver Nuggets,G,53,125,19,43,306.4,4,7,200.0,11,25,283.3,0,15,15,18,12,7,9,0,24,86,68,71,33,240.98573127229488,12.9833531510107,37.600475624256845,15.451843043995245,401.7074910820452,279.602853745541,336.38168846611177,77.29250891795482,8
94,Collin Sexton,Utah Jazz,PG,208,319,78,161,480.5,41,49,859.9,11,39,239.89999999999998,11,19,30,60,20,8,27,4,-116,298,238,268,90,229.79733560090702,22.409580498866216,38.02267573696145,13.719104308390023,417.60204081632656,315.6383219954649,339.953798185941,52.23951247165533,10
95,Corey Kispert,Washington Wizards,SF,184,382,68,133,508.79999999999995,16,23,575.0,32,77,412.3,5,34,39,33,23,6,17,2,-68,256,223,217,72,411.81234567901237,35.93827160493827,76.2,40.864197530864196,585.2444444444444,613.4444444444443,395.21234567901246,100.53827160493827,10
96,Cory Joseph,Golden State Warriors,PG,27,71,10,16,316.7,0,0,0.0,7,11,316.7,2,9,11,6,6,0,1,0,9,44,38,33,17,31.2,10.8,2.8000000000000003,3.2,28.8,47.2,21.2,5.2,5
97,Craig Jr. Porter,Cleveland Cavaliers,G,62,138,26,50,425.3,5,6,300.0,5,12,175.0,6,19,25,24,5,3,8,3,-18,111,87,86,49,378.80400000000003,43.38399999999999,21.616,9.655999999999999,743.3,599.876,502.8039999999999,84.42399999999998,10
98,D'Angelo Russell,Los Angeles Lakers,PG,180,368,64,152,413.4,14,14,400.0,38,96,353.1,0,29,29,58,17,9,21,4,87,267,209,238,87,440.4395085066162,39.32514177693762,94.67793005671078,61.78757088846881,442.0210302457468,481.35822306238185,362.30931001890366,172.7960775047259,10
99,D.J. Carton,Toronto Raptors,G,8,31,2,7,83.3,3,4,150.0,1,4,50.0,2,1,3,3,1,1,1,0,-30,14,11,11,6,8.666666666666668,2.0,2.0,0.6666666666666667,8.666666666666666,2.6666666666666665,18.666666666666668,0.0,3
100,D.J. Wilson,Philadelphia 76ers,F,10,14,4,6,66.7,0,0,0.0,2,2,100.0,1,1,2,2,1,0,0,2,4,14,12,12,4,19.75308641975309,0.7901234567901234,0.7901234567901234,0.7901234567901234,38.71604938271605,28.444444444444443,28.444444444444443,3.1604938271604937,1
101,DaQuan Jeffries,New York Knicks,SG,0,7,0,2,0.0,0,0,0.0,0,2,0.0,0,0,0,3,0,0,1,0,7,3,0,3,3,0.39889196675900274,0.0,5.609418282548476,0.04432132963988919,3.0166204986149587,0.39889196675900274,3.0166204986149587,5.609418282548476,1
102,Daishen Nix,Minnesota Timberwolves,SG,5,12,2,5,66.7,0,0,0.0,1,3,50.0,0,1,1,3,1,2,1,0,13,9,6,8,4,13.509695290858724,0.5124653739612188,5.110803324099724,0.5346260387811634,4.1024930747922435,9.246537396121884,5.191135734072022,8.797783933518007,2
103,Dalano Banton,Portland Trail Blazers,G,215,354,80,199,402.7,33,40,757.2,22,87,268.6,7,52,59,54,11,13,30,7,-117,328,274,269,113,708.6311519740402,111.99161709031911,89.55543537047053,20.26636019469984,1506.0251487290427,1068.7455381287182,1146.8161168199028,200.6416982152515,10
104,Dalen Terry,Chicago Bulls,F,47,157,20,47,338.9,4,8,50.0,3,17,100.0,8,17,25,15,23,6,8,10,13,87,72,62,40,276.21984856679285,46.586533261222286,50.66360194699838,4.101946998377501,633.8718226068146,402.6122228231476,484.24148188209847,120.48810167658193,10
105,Damian Jones,Cleveland Cavaliers,C,60,123,24,39,594.6,11,13,550.0,1,7,50.0,11,20,31,3,13,4,6,5,-53,94,91,63,34,200.5390625,70.42100694444443,2.1293402777777777,0.9027777777777777,406.2960069444445,390.3506944444444,202.43402777777774,86.60069444444443,10
106,Damian Lillard,Milwaukee Bucks,PG,243,372,73,181,398.2,67,76,764.9,30,85,337.2,5,43,48,56,25,6,30,3,-16,347,291,299,104,793.0765625,10.426562499999998,63.2765625,34.756249999999994,993.7390624999999,854.90625,930.2062500000001,75.40625,10
107,Daniel Gafford,Dallas Mavericks,C,85,205,41,56,668.9,3,9,100.0,0,0,0.0,11,35,46,18,26,5,10,18,-11,149,131,103,64,503.60018903591686,229.56450850661625,23.704395085066164,0.0,1298.5047258979207,1115.2535444234404,570.0134688090737,370.1068052930057,10
108,Daniel Theis,LA Clippers,C,62,162,25,48,406.4,6,6,300.0,6,16,283.3,12,35,47,9,15,2,8,8,12,118,109,71,56,339.625,69.48291015625,7.556640625,6.5,722.79931640625,677.65478515625,371.275390625,90.53369140625,10
109,Danilo Gallinari,Milwaukee Bucks,PF,34,101,10,22,404.2,12,14,375.0,2,10,200.0,3,10,13,8,8,4,7,1,-30,55,47,42,21,108.5,12.102040816326532,9.600907029478458,1.777777777777778,156.5907029478458,160.17346938775512,103.71995464852608,22.900226757369616,10
110,Dante Exum,Dallas Mavericks,G,49,201,19,44,336.3,3,4,150.0,8,19,350.0,5,27,32,24,12,1,11,1,55,105,81,73,56,292.2140625,58.0,36.6640625,10.576562500000001,518.1,402.8140625,407.7,94.4640625,10
111,Danuel House Jr.,Philadelphia 76ers,SF,42,143,14,30,276.3,13,15,466.7,1,11,33.3,6,11,17,7,16,7,3,3,-26,66,59,49,24,42.0,11.714285714285715,8.0,0.8571428571428572,41.714285714285715,51.714285714285715,40.0,11.714285714285715,7
112,Dario Saric,Golden State Warriors,PF,29,101,12,30,281.7,3,5,75.0,2,14,100.0,5,15,20,14,3,1,15,1,-26,63,49,43,34,128.86159169550172,32.13840830449827,10.754325259515571,2.1816608996539792,246.84775086505192,230.48096885813146,130.78546712802768,57.33564013840831,10
113,Darius Bazley,Utah Jazz,F,48,141,18,29,408.1,10,12,360.0,2,8,83.3,8,19,27,5,3,6,7,7,-32,80,75,53,32,77.5296,30.769599999999997,4.833600000000001,1.3504,199.3184,185.5984,82.2864,44.5664,6
114,Darius Garland,Cleveland Cavaliers,PG,157,335,60,136,432.0,13,17,460.0,24,57,387.0,3,27,30,70,17,16,33,2,9,257,187,227,100,438.807076446281,20.046487603305785,76.06327479338843,20.40625,505.81095041322317,513.2161673553719,403.2933884297521,124.21823347107438,10
115,David Duke Jr.,San Antonio Spurs,G,23,48,9,17,200.0,3,3,200.0,2,5,66.7,2,8,10,4,4,2,3,0,7,37,33,27,14,94.99489795918366,26.096938775510207,10.693877551020407,2.6734693877551017,173.24489795918365,147.77551020408163,91.52551020408163,65.7295918367347,3
116,David Roddy,Phoenix Suns,F,61,130,25,53,522.0,6,10,241.7,5,20,143.3,4,15,19,11,5,1,10,0,-72,91,80,72,30,489.88820301783267,54.65157750342936,20.327160493827158,9.61111111111111,944.7421124828531,751.4931412894375,661.7750342935527,96.34087791495199,10
117,Davion Mitchell,Sacramento Kings,PG,93,235,35,88,397.3,6,9,250.0,17,45,402.1,7,20,27,29,12,1,7,0,74,149,120,122,56,173.469,40.989,24.296,15.236000000000002,350.824,257.61600000000004,233.00099999999995,98.961,10
118,Davis Bertans,Charlotte Hornets,SF,101,224,34,78,424.8,7,7,400.0,26,67,373.0,2,17,19,8,21,10,8,4,-38,128,120,109,27,149.64511009720292,17.466574092441974,13.606427296171395,20.914104344376117,227.13628248363423,236.4372148383257,150.62348740329298,20.79369172783178,10
119,Day'Ron Sharpe,Brooklyn Nets,C,49,129,22,47,507.3,5,7,166.7,0,3,0.0,30,32,62,10,19,1,14,7,-16,121,111,59,72,63.769319161160574,203.98276357368573,10.485492674518817,0.025854639471416266,424.04740017236423,360.0606147658719,95.90721057167481,246.31715024418273,10
120,De'Aaron Fox,Sacramento Kings,PG,281,383,106,233,465.9,31,42,693.6,38,103,379.9,6,44,50,53,25,22,23,3,57,384,331,334,103,512.1734693877551,34.10849645980842,39.31882548937942,48.669720949604326,624.9656393169514,621.7805081216161,488.1482715535194,100.63765097875887,10
121,De'Andre Hunter,Atlanta Hawks,SF,151,350,53,137,355.8,25,35,607.1,20,68,277.5,5,44,49,24,23,5,19,1,-65,224,200,175,73,424.78713151927434,171.77551020408163,18.622448979591834,18.11479591836735,932.3211451247165,892.2395124716553,444.23611111111114,211.03061224489798,10
122,De'Anthony Melton,Philadelphia 76ers,SG,31,64,10,32,130.5,4,4,200.0,7,21,145.0,1,8,9,9,5,6,1,1,2,49,40,40,18,149.25,5.0,5.0,9.3125,235.25,187.25,187.25,20.0,5
123,DeAndre Jordan,Denver Nuggets,C,36,96,15,27,411.8,6,6,300.0,0,0,0.0,12,28,40,7,13,2,4,4,-33,83,76,43,47,172.41209829867674,89.89035916824197,10.122873345935727,0.0,502.77693761814743,440.60491493383745,210.16824196597355,124.42911153119093,10
124,DeJon Jarreau,Memphis Grizzlies,F,43,150,17,50,308.3,5,11,250.0,4,13,141.7,8,36,44,26,14,6,9,2,-24,113,87,69,70,98.3598615916955,111.6805074971165,54.768166089965405,4.376009227220299,497.42445213379466,248.86851211072664,221.79238754325257,291.5720876585928,9
125,DeMar DeRozan,Chicago Bulls,SF,279,392,105,200,523.8,57,71,811.6,12,30,300.0,2,40,42,59,19,11,30,5,14,380,321,338,101,374.1360946745562,31.901461176186448,62.920057964014006,18.701364569496437,402.05385822968253,396.10687115082726,391.24381113392093,83.66078975969086,10
126,Dean Wade,Cleveland Cavaliers,PF,46,178,15,35,260.2,5,7,216.7,11,31,233.4,4,27,31,7,8,3,1,9,-23,84,77,53,38,468.50000000000006,35.125,6.125,31.525000000000006,718.8,714.725,466.12499999999994,47.699999999999996,10
127,Deandre Ayton,Portland Trail Blazers,C,212,329,100,186,522.8,12,15,263.9,0,7,0.0,30,81,111,16,13,10,18,7,-110,339,323,228,127,695.6772268135904,167.16345270890724,6.415518824609735,0.03673094582185492,1495.6483011937557,1409.2768595041323,755.623507805326,200.00413223140498,10
128,Dejounte Murray,Atlanta Hawks,SG,232,381,91,215,424.1,22,30,666.7,28,85,332.4,12,49,61,78,26,12,33,2,-58,371,293,310,139,844.5324499729584,98.42644672796106,138.0746349378042,21.371822606814494,1390.96106003245,1117.6727961060033,1039.708220659816,314.61357490535426,10
129,Delon Wright,Miami Heat,SG,69,211,23,46,517.9,8,8,300.0,15,24,583.3,7,15,22,25,9,16,1,3,62,116,91,94,47,181.0575509346776,29.10859063222012,23.29867674858223,18.85717286284394,243.02835538752362,177.8090737240076,246.08149548414195,52.60260449485402,10
130,Deni Avdija,Washington Wizards,SF,182,360,62,127,470.2,46,58,825.9,12,41,288.2,8,77,85,45,22,7,28,9,-6,312,267,227,130,493.84693877551024,124.84489795918367,71.67551020408163,8.122448979591837,1223.6,973.2755102040817,680.4448979591837,260.2469387755102,10
131,Dennis Schroder,Brooklyn Nets,PG,158,333,57,139,411.8,25,26,787.5,19,54,394.5,12,40,52,64,22,5,17,5,25,274,210,222,116,565.4933378310002,38.601450497554396,61.52268510710069,34.90285039635689,853.900826446281,618.4483049418114,767.8080620678023,133.2619328723225,10
132,Dennis Smith Jr.,Brooklyn Nets,PG,58,167,21,46,487.1,8,11,383.3,8,22,348.3,5,13,18,28,22,16,11,0,3,104,76,86,46,78.47147022074135,17.85339441899209,40.0,4.21990837151187,181.54768846314036,139.3027905039567,112.87963348604748,65.69012911286964,10
133,Dereck II Lively,Dallas Mavericks,C,70,185,31,47,670.3,8,19,250.0,0,0,0.0,16,44,60,6,14,4,5,11,-26,136,130,76,66,165.99375650364203,70.0936524453694,4.45993756503642,0.0,396.09781477627473,352.58896982310097,193.65244536940688,90.40374609781477,10
134,Derrick Jones Jr.,Dallas Mavericks,SF,69,244,25,65,377.4,12,18,383.3,7,27,168.60000000000002,13,19,32,9,21,5,10,12,9,110,101,78,41,239.2567901234568,35.2,12.900000000000002,6.130864197530864,307.4679012345679,336.3679012345679,221.95679012345678,36.5,10
135,Derrick Rose,Memphis Grizzlies,PG,49,95,20,37,377.7,5,6,266.7,4,8,233.3,0,15,15,21,3,1,9,0,-9,85,64,70,36,70.0,14.857142857142858,12.0,3.7142857142857144,188.85714285714286,116.85714285714286,128.0,40.857142857142854,7
136,Derrick White,Boston Celtics,PG,140,338,48,100,468.90000000000003,15,16,766.7,29,72,406.8,6,28,34,47,20,8,14,5,9,221,174,187,81,369.47419778570094,77.57778194783262,47.48752111090261,17.139613435916683,822.8705197973354,647.1071495590168,532.3375867892662,137.96528429348848,10
137,Desmond Bane,Memphis Grizzlies,SG,93,165,30,80,183.4,19,21,366.7,14,40,172.9,2,14,16,34,14,5,13,2,-54,143,109,127,50,267.2,8.8,114.79999999999998,4.8,701.1999999999999,362.8,587.2,142.0,5
138,Devin Booker,Phoenix Suns,SG,261,385,82,173,437.8,70,76,931.6,27,76,304.8,8,19,27,69,32,12,34,2,21,357,288,330,96,1493.2118605703938,35.97306473517428,63.38026256224536,60.853327297419646,1532.6222272521504,1435.4660479855136,1588.0181077410593,101.70325939339068,10
139,Devin Vassell,San Antonio Spurs,SG,193,373,77,163,440.2,18,21,691.7,21,61,312.3,0,33,33,47,16,12,18,1,-43,273,226,240,80,806.4410104810535,25.71969900564364,52.6495565708143,24.90217683418436,1079.5020155872078,846.0,1027.3222252082774,90.99005643644182,10
140,Devonte' Graham,San Antonio Spurs,PG,79,210,27,77,363.0,7,8,350.0,18,60,327.9,3,17,20,30,10,6,14,1,-3,129,99,109,50,287.4330755502677,12.214158239143368,34.3807257584771,18.428316478286735,450.24449732302196,320.9238548483046,406.18262938726946,57.16597263533611,10
141,Dillon Brooks,Houston Rockets,SF,117,315,42,109,361.0,14,17,319.0,19,57,356.79999999999995,8,25,33,15,39,9,11,3,-48,165,150,132,48,681.6047578794831,28.20444390774061,19.166888056997948,23.043473010505977,933.4588817775631,746.8163265306123,851.7751479289941,63.84349716217848,10
142,Domantas Sabonis,Sacramento Kings,PF,181,357,70,132,526.7,39,55,747.5,2,11,66.7,41,98,139,72,33,14,33,6,33,392,320,253,211,199.684,120.26899999999999,33.444,3.625,538.641,364.081,317.256,210.701,10
143,Dominick Barlow,San Antonio Spurs,F,57,150,21,38,506.6,15,18,416.6,0,1,0.0,19,22,41,15,19,4,4,3,10,113,98,72,56,290.46020761245677,81.13667820069205,45.74567474048443,0.0,715.5397923875432,590.5,425.3581314878893,117.0242214532872,10
144,Donovan Mitchell,Cleveland Cavaliers,SG,201,337,69,171,386.4,35,40,745.7,28,84,327.8,7,29,36,50,18,20,24,7,-19,287,237,251,86,712.1686797167846,41.34693877551021,47.2036651395252,14.282382340691377,808.5510204081634,817.8304872969595,697.1224489795918,94.31736776343192,10
145,Donte DiVincenzo,New York Knicks,SG,184,364,64,136,460.7,18,19,580.0,38,88,421.4,5,35,40,31,17,14,18,5,7,255,224,215,71,451.5408651291317,10.239132745243916,17.0,39.22478478052928,565.1825911361462,498.0588797959401,516.9738548198534,28.92985439472845,10
146,Dorian Finney-Smith,Brooklyn Nets,PF,59,287,23,61,357.5,7,10,350.0,6,35,181.6,12,34,46,16,15,11,9,5,-50,121,105,75,62,170.87530233808116,38.64767535608708,6.6374630475678575,5.748454716474066,204.79252889008333,170.7446922870196,212.60816984681537,37.60010749798441,10
147,Doug McDermott,Indiana Pacers,SF,39,111,14,34,279.1,0,0,0.0,11,29,315.4,0,3,3,6,12,3,2,0,-8,48,42,45,9,184.6487603305785,3.231404958677686,8.698347107438018,14.900826446280991,262.19834710743805,191.29338842975207,255.9917355371901,11.491735537190083,10
148,Draymond Green,Golden State Warriors,PF,85,306,34,60,494.9,7,11,325.0,10,22,271.4,13,57,70,67,34,21,29,7,30,222,155,152,137,360.89012345679015,71.87777777777778,89.97777777777777,24.653086419753087,573.841975308642,297.2716049382716,586.104938271605,213.2111111111111,10
149,Drew Eubanks,Phoenix Suns,PF,29,134,12,31,283.3,5,6,175.0,0,0,0.0,12,27,39,5,16,4,5,6,-26,73,68,34,44,93.8,69.27922437673129,5.11191135734072,0.0,172.4493074792244,157.94238227146812,96.34349030470915,86.35457063711911,10
150,Drew Peterson,Boston Celtics,F,8,20,3,5,75.0,0,0,0.0,2,4,66.7,0,1,1,0,0,2,1,0,6,9,9,8,1,35.55555555555556,0.5555555555555556,0.0,2.2222222222222223,27.222222222222218,27.222222222222218,35.55555555555556,0.5555555555555556,2
151,Duncan Robinson,Miami Heat,F,76,213,26,66,343.9,6,7,250.0,18,53,267.4,3,22,25,13,26,5,15,1,-51,114,101,89,38,678.9964328180737,14.5,26.01307966706302,39.54815695600475,1054.1076099881095,777.4964328180737,944.6076099881094,51.51307966706302,10
152,Duop Reath,Portland Trail Blazers,C,77,168,30,80,359.6,8,10,275.0,9,37,251.7,11,29,40,9,14,5,3,5,-40,126,117,86,49,202.55600189035917,22.112712665406427,22.95463137996219,5.382088846880908,336.81758034026467,272.8742911153119,259.55127599243855,52.01535916824196,10
153,Dwight Powell,Dallas Mavericks,C,23,125,9,15,516.7,5,10,300.0,0,1,0.0,19,20,39,10,18,3,6,2,-64,72,62,33,49,42.34379809172052,113.86365035395505,13.628193290243152,0.0,344.19144352108344,246.88027085257,77.45429362880886,189.69252077562328,10
154,Dylan Windler,Atlanta Hawks,G,28,67,10,18,163.8,0,0,0.0,8,16,142.1,3,7,10,3,3,2,2,0,-17,41,38,31,13,136.02615933412602,8.092746730083235,2.9072532699167657,13.467300832342453,201.36385255648037,182.92033293697978,146.07491082045183,19.394768133174793,4
155,Dylan Windler,Los Angeles Lakers,G,3,14,1,4,25.0,0,0,0.0,1,4,25.0,0,1,1,2,1,0,0,0,-7,6,4,5,3,14.702734839476815,3.011890606420927,0.4019024970273484,1.1474435196195003,19.181926278240194,24.83947681331748,11.05469678953627,1.4042806183115344,2
156,Dyson Daniels,New Orleans Pelicans,G,64,226,26,55,387.5,2,3,150.0,10,25,336.6,8,39,47,26,17,11,6,4,-23,137,111,90,73,243.9074380165289,60.94380165289256,51.14380165289256,14.476033057851241,565.307438016529,361.0,370.10247933884295,190.20000000000002,10
157,Emoni Bates,Cleveland Cavaliers,F,23,51,9,24,127.9,0,2,0.0,5,13,120.0,0,4,4,4,0,0,7,0,-22,31,27,27,8,33.94921875,5.48046875,5.0,3.76171875,62.6875,44.1875,44.07421875,18.85546875,3
158,Eric Gordon,Phoenix Suns,SG,60,214,21,66,300.9,6,7,366.7,12,48,218.3,1,9,10,12,7,14,7,3,-7,82,70,72,22,257.00492362075494,10.667844969069563,8.676429743719227,14.533013508395406,280.53705340234814,293.34553717964906,242.50069435677312,21.040020199469765,10
159,Eugene Omoruyi,Washington Wizards,F,63,142,24,53,407.7,8,16,291.7,7,18,230.0,9,11,20,9,16,6,6,4,-72,92,83,72,29,317.98890532544385,22.299556213017752,11.284763313609467,16.426775147928996,395.64275147928987,336.78402366863907,382.1686390532545,28.263313609467453,10
160,Evan Fournier,Detroit Pistons,SG,77,213,29,81,309.8,11,15,350.0,8,42,171.7,1,17,18,14,12,8,5,4,-57,109,95,91,32,435.24845679012344,13.61304012345679,19.187114197530864,9.946373456790123,561.9027777777778,558.0667438271605,429.6871141975309,42.19753086419753,10
161,Evan Mobley,Cleveland Cavaliers,PF,163,309,62,115,548.9,30,38,755.1,9,24,325.0,20,50,70,29,21,9,16,15,20,262,233,192,99,206.3810553633218,80.98269896193771,29.671712802768166,4.903114186851211,348.93598615916954,294.9969723183391,262.88754325259515,108.08693771626298,10
162,Frank Ntilikina,Charlotte Hornets,PG,5,39,1,8,50.0,2,2,100.0,1,7,50.0,1,4,5,3,4,0,0,0,0,13,10,8,8,19.0,7.0,6.84,0.7600000000000002,24.439999999999998,14.0,18.64,24.640000000000004,4
163,Franz Wagner,Orlando Magic,SF,189,319,66,142,471.1,46,56,830.1,11,42,253.3,12,38,50,28,24,10,14,7,38,267,239,217,78,149.9727175735406,30.440481633897274,15.488492607834173,8.925621094345374,179.18655692729766,206.73997866178934,154.24340801707058,14.1048620637098,10
164,Fred VanVleet,Houston Rockets,PG,208,376,71,171,428.4,33,39,715.0,33,88,351.0,8,34,42,70,39,23,15,6,-13,320,250,278,112,1160.8407606328929,48.871824647989556,54.606474089127595,62.113949775003626,1447.6771664973146,1484.0150965307012,1159.1197561329657,68.86137320365802,10
165,Furkan Korkmaz,Philadelphia 76ers,SG,41,116,13,29,278.6,7,10,241.7,8,18,258.3,3,12,15,12,6,3,2,2,22,68,56,53,27,292.875,14.875,10.0,20.0,404.0,340.0,363.875,17.875,8
166,GG Jackson,Memphis Grizzlies,F,187,330,67,163,396.4,27,35,685.7,26,77,335.5,9,42,51,21,16,10,19,4,-64,259,238,208,72,1089.9496384297522,135.51368801652893,17.513688016528924,28.509297520661153,1397.3525309917356,1503.1373966942147,1013.1373966942149,124.05475206611571,10
167,Gabe Vincent,Los Angeles Lakers,PG,16,130,6,25,115.0,1,1,100.0,3,17,75.0,3,7,10,9,11,5,5,0,21,35,26,25,19,83.42039542143601,11.0,2.0,4.104058272632674,145.77523413111345,145.77523413111345,85.42039542143601,11.0,9
168,Garrett Temple,Toronto Raptors,SF,50,193,18,53,402.4,7,10,300.0,7,27,253.3,13,18,31,18,22,7,9,3,-92,99,81,68,49,140.73350694444446,31.7265625,33.625,8.2265625,238.94444444444443,214.90277777777777,136.08767361111111,94.0390625,10
169,Garrison Mathews,Atlanta Hawks,SG,78,192,26,58,466.09999999999997,6,8,266.7,20,49,455.0,3,11,14,6,16,4,3,1,-37,98,92,84,20,175.2,14.4,14.84567901234568,10.653086419753087,265.9567901234568,231.2,198.7567901234568,40.44567901234568,10
170,Gary Harris,Orlando Magic,SG,60,309,21,60,304.2,3,3,200.0,15,44,318.7,7,16,23,17,19,14,5,2,6,100,83,77,40,294.6634527089073,27.40036730945822,29.557851239669418,20.520661157024794,570.3507805325987,432.20615243342513,410.25436179981637,79.5119375573921,10
171,Gary Payton II,Golden State Warriors,SG,67,174,30,45,679.0,3,5,200.0,4,11,216.7,6,17,23,14,22,9,6,7,46,104,90,81,37,149.61325687299714,44.781413391803,38.67633665036262,4.40006746500253,205.04773148928993,143.1037274413898,135.08939112835216,159.92561983471074,10
172,Gary Trent Jr.,Toronto Raptors,SG,200,317,75,175,428.6,26,29,633.3,24,75,319.1,6,30,36,28,17,15,8,0,-65,264,236,228,64,467.06198347107437,34.4485766758494,28.7089072543618,37.47107438016529,682.793388429752,607.2213039485766,529.4568411386593,76.33471074380166,10
173,Georges Niang,Cleveland Cavaliers,SF,60,197,22,66,302.6,6,8,225.0,10,43,211.3,1,23,24,10,25,8,8,2,-9,94,84,70,34,384.8542936288088,25.46481994459834,6.070914127423823,27.63324099722992,457.5346260387812,434.6382271468144,401.201108033241,38.08531855955678,10
174,Giannis Antetokounmpo,Milwaukee Bucks,PF,282,365,114,193,601.8,53,86,543.3,1,11,50.0,40,95,135,72,29,9,37,16,18,489,417,354,207,457.31103515625,205.884765625,50.06494140625,1.42041015625,1149.837890625,1028.18212890625,528.7890625,306.12744140625,10
175,Goga Bitadze,Orlando Magic,C,32,108,13,25,496.7,6,8,350.0,0,3,0.0,11,15,26,9,13,4,11,9,-36,67,58,41,35,56.99683114531462,65.24400181077412,10.416025350837485,0.0,261.9633318243549,195.61068356722498,90.82616568583069,108.18334087822547,10
176,Gordon Hayward,Oklahoma City Thunder,SF,57,160,22,41,423.4,9,13,233.4,4,10,166.7,3,18,21,11,5,7,6,2,44,89,78,68,32,274.725,26.9140625,9.8765625,5.2265625,304.90625,296.4265625,265.63906249999997,54.35625,10
177,Gradey Dick,Toronto Raptors,G,142,305,54,124,437.7,13,16,346.4,21,58,352.9,4,26,30,5,15,6,11,0,-105,177,172,147,35,301.2390625,50.6890625,9.80625,25.0,323.10625,382.0,259.3640625,43.4765625,10
178,Grant Williams,Charlotte Hornets,PF,151,318,57,103,554.7,19,27,691.7,18,40,540.3,13,41,54,49,36,6,15,4,-66,254,205,200,103,251.66481994459832,40.56959833795014,91.99722991689751,3.84106648199446,381.7108725761772,306.09452908587264,273.72299168975076,186.125,10
179,Grayson Allen,Phoenix Suns,SG,119,298,40,95,402.6,19,22,512.5,20,61,371.1,11,40,51,21,17,11,13,3,52,191,170,140,72,455.29583521955635,59.71140787686736,33.0,24.21118153010412,673.6165685830692,584.1910366681757,560.8277501131734,76.60502489814397,10
180,Gui Santos,Golden State Warriors,F,50,130,17,34,372.5,10,11,450.0,6,15,320.0,10,23,33,12,17,3,5,2,6,95,83,62,45,254.08284023668642,136.82117028270875,16.322156476002633,4.669296515450362,777.6416831032216,677.41288625904,299.7777777777778,207.67718606180142,10
181,Harrison Barnes,Sacramento Kings,SF,113,283,35,88,340.3,28,36,551.4,15,43,308.3,11,28,39,19,8,7,6,1,47,171,152,132,58,488.725,41.576,26.836,13.524000000000001,963.925,723.801,690.7610000000001,106.5,10
182,Harry III Giles,Brooklyn Nets,F,8,8,3,6,50.0,1,2,50.0,1,1,100.0,2,2,4,2,3,0,0,0,-12,14,12,10,6,52.5625,11.031887755102039,3.582908163265306,0.8622448979591837,155.35841836734693,111.75510204081633,83.59183673469387,27.18877551020408,1
183,Harry III Giles,Los Angeles Lakers,F,2,10,1,4,100.0,0,0,0.0,0,2,0.0,0,1,1,0,0,1,0,0,-15,3,3,2,1,2.125,0.5637755102040817,0.022959183673469385,0.01020408163265306,4.502551020408163,4.5102040816326525,2.040816326530612,0.6632653061224489,2
184,Haywood Highsmith,Miami Heat,F,58,258,24,55,376.6,1,5,50.0,9,34,211.2,15,28,43,14,19,9,8,4,18,115,101,72,57,203.19113573407205,70.93795013850416,14.649307479224376,15.094182825484765,292.2254847645429,269.6504155124654,203.25207756232686,108.10138504155125,10
185,Henri Drell,Chicago Bulls,F,9,23,3,7,42.9,1,2,50.0,2,4,50.0,0,2,2,1,5,2,1,1,7,12,11,10,3,49.0,1.3313609467455618,0.0059171597633136015,2.863905325443787,65.23668639053254,66.48520710059171,47.92899408284024,1.1597633136094674,1
186,Herbert Jones,New Orleans Pelicans,SF,103,339,34,76,415.3,17,20,650.0,18,45,379.2,6,32,38,28,29,13,20,2,6,169,141,131,66,260.9171513110907,42.593204775022954,29.923273135394346,16.149168452198754,259.1265177022753,288.9085807570656,197.0683603713907,106.583205795327,10
187,Hunter Tyson,Denver Nuggets,F,0,7,0,3,0.0,0,0,0.0,0,3,0.0,0,1,1,0,1,0,2,0,-1,1,1,0,1,3.6337890625,0.765625,0.0244140625,0.1181640625,1.41015625,1.0634765625,4.25390625,0.5166015625,1
188,I. Thomas,Phoenix Suns,G,8,13,3,7,83.3,0,0,0.0,2,4,100.0,0,0,0,2,0,0,0,0,-4,10,8,10,2,17.520408163265305,0.0,0.5739795918367346,1.0204081632653061,24.06377551020408,17.520408163265305,24.06377551020408,0.5739795918367346,2
189,Ibou Badji,Portland Trail Blazers,C,12,51,5,7,300.0,2,4,100.0,0,0,0.0,2,4,6,4,10,1,6,3,-29,22,18,16,10,15.051652892561982,7.365702479338842,4.440082644628099,0.0,39.018595041322314,35.25619834710744,20.487603305785125,10.132231404958679,5
190,Immanuel Quickley,Toronto Raptors,SG,215,338,66,155,420.6,58,66,782.2,25,74,329.5,3,48,51,75,24,11,28,2,-66,341,266,290,126,606.3961068356723,76.92394748755093,77.20733363512902,14.691263014938885,1224.5165233137168,844.6853779990946,911.4875509280217,228.87098234495247,10
191,Isaac Okoro,Cleveland Cavaliers,SF,76,240,26,55,480.5,13,19,458.3,11,27,316.2,6,15,21,10,13,7,7,2,1,107,97,86,31,148.7765625,25.65625,39.90625,13.2515625,418.6015625,253.3515625,286.5890625,93.0,10
192,Isaiah Hartenstein,New York Knicks,C,106,264,43,59,756.9,20,31,488.1,0,0,0.0,35,43,78,42,26,14,16,14,43,226,184,148,120,192.40123456790124,115.02716049382717,57.82345679012345,0.0,544.1827160493827,493.7444444444444,224.0,191.69012345679013,10
193,Isaiah Jackson,Indiana Pacers,SF,67,150,27,41,707.2,13,17,575.0,0,0,0.0,27,23,50,11,20,7,5,11,42,128,117,78,61,122.84852071005918,159.66863905325442,32.20710059171598,0.0,686.8331360946745,501.6059171597633,206.9514792899409,293.00000000000006,10
194,Isaiah Joe,Oklahoma City Thunder,SG,80,189,28,59,470.4,7,8,275.0,17,41,416.4,6,21,27,20,9,9,7,4,45,127,107,100,47,182.18337673611111,12.032335069444446,41.40625,12.251085069444443,343.125,241.40625,270.60525173611114,66.73546006944446,10
195,Isaiah Mobley,Cleveland Cavaliers,F,16,48,7,15,120.8,0,1,0.0,2,7,58.3,2,5,7,2,2,1,1,0,-10,25,23,18,9,66.50692520775623,14.0,1.6121883656509695,1.1551246537396125,109.0,107.34903047091412,65.0,18.77008310249307,3
196,Isaiah Stewart,Detroit Pistons,C,106,319,40,71,587.7,10,12,516.7,16,38,409.0,10,48,58,12,11,4,10,10,-48,176,164,118,70,131.47520661157026,49.603305785123965,9.603305785123966,12.764462809917354,245.47520661157023,193.27685950413223,178.88016528925618,64.0,10
197,Ish Smith,Charlotte Hornets,PG,18,181,8,34,236.0,0,0,0.0,2,2,200.0,1,19,20,41,16,5,6,1,-90,79,38,59,61,54.36000000000001,24.0,78.09,1.5600000000000003,170.49,69.16000000000001,134.09,123.69,9
198,Ish Wainright,Phoenix Suns,F,3,11,1,6,16.7,0,0,0.0,1,4,25.0,3,2,5,1,1,1,1,0,-3,9,8,4,6,6.890625,19.140625,0.765625,0.765625,62.015625,49.0,12.25,27.5625,1
199,Ivica Zubac,LA Clippers,C,148,287,63,107,628.2,22,27,460.0,0,0,0.0,30,80,110,13,22,5,12,12,38,271,258,161,123,263.6111111111111,145.83827160493826,8.179012345679013,0.0,656.6086419753087,651.130864197531,257.7160493827161,165.3901234567901,10
200,JD Davison,Boston Celtics,SG,8,27,3,9,42.9,1,2,50.0,1,4,33.3,1,6,7,9,3,1,2,1,15,24,15,17,16,23.397959183673464,8.5,26.469387755102034,0.5,151.0204081632653,51.04081632653061,97.23469387755101,61.11224489795917,2
201,JT Thor,Charlotte Hornets,F,53,151,22,34,504.4,3,5,200.0,6,16,200.0,2,24,26,10,13,3,2,6,6,89,79,63,36,334.4361111111111,81.77777777777777,15.111111111111112,10.8,896.5250000000001,727.3027777777777,454.7694444444445,145.77777777777777,10
202,JaVale McGee,Sacramento Kings,C,32,57,15,26,412.1,1,5,50.0,1,3,100.0,8,14,22,3,7,2,3,0,-5,57,54,35,25,116.88581314878891,39.121107266435985,4.03114186851211,0.9100346020761246,298.0865051903114,258.0138408304498,143.5847750865052,56.525951557093435,8
203,Jabari Smith Jr.,Houston Rockets,PF,164,341,59,126,480.9,20,26,658.3,26,67,412.2,11,52,63,26,20,4,7,13,-63,253,227,190,89,459.05164954029203,44.17766360194699,19.526500811249324,17.336127636560303,586.2955651703624,524.3564088696593,520.2866414277988,64.40832882639265,10
204,Jabari Walker,Portland Trail Blazers,F,102,313,35,94,399.4,24,33,570.9,8,24,283.3,28,77,105,14,26,2,8,1,-100,221,207,116,119,265.8241121780216,428.75308641975306,24.53467459228776,7.718030787989636,1260.7655845145555,1141.9654016156073,365.8533760097546,472.0586800792562,10
205,Jack White,Memphis Grizzlies,F,6,64,2,16,28.6,0,0,0.0,2,10,40.0,4,8,12,1,3,4,2,1,-28,19,18,7,13,27.4792899408284,4.023668639053255,0.7514792899408284,3.0532544378698225,19.0,19.289940828402365,25.17751479289941,6.78698224852071,4
206,Jacob Gilyard,Brooklyn Nets,G,0,34,0,6,0.0,0,0,0.0,0,6,0.0,1,2,3,3,4,2,1,0,-23,6,3,3,6,25.579199999999997,6.0767999999999995,10.068800000000001,2.3232,72.08000000000001,28.8528,64.3808,20.5712,3
207,Jacob Gilyard,Memphis Grizzlies,G,61,171,21,45,298.5,1,1,100.0,18,39,281.8,1,11,12,34,8,8,11,2,-52,107,73,95,46,408.4448,12.779200000000001,39.267199999999995,35.7408,766.12,519.0032,630.9952000000001,76.6128,7
208,Jacob Toppin,New York Knicks,F,13,29,5,9,107.1,2,2,100.0,1,4,33.3,3,3,6,1,3,0,1,0,-18,20,19,14,7,78.05555555555556,8.722222222222221,0.5555555555555556,0.7222222222222223,130.22222222222223,136.55555555555554,72.5,8.5,2
209,Jaden Hardy,Dallas Mavericks,G,69,143,25,63,398.9,10,12,233.3,9,26,231.6,5,20,25,16,18,4,14,0,-50,110,94,85,41,425.1937716262976,45.586851211072656,23.069896193771626,7.191003460207611,798.9896193771626,698.6615916955018,504.0712802768166,90.10726643598616,10
210,Jaden Ivey,Detroit Pistons,PG,158,304,56,151,370.0,23,33,629.9,23,62,335.1,7,26,33,48,16,7,23,3,-57,239,191,206,81,534.6665598461785,30.40073706136837,50.482294504085885,41.242268867168725,663.8764621054319,611.1345938150937,571.7849703573145,96.5064893446563,10
211,Jaden McDaniels,Minnesota Timberwolves,PF,102,306,41,84,474.9,12,14,525.0,8,30,200.0,10,26,36,16,24,8,12,8,31,154,138,118,52,282.6744209774513,47.2939495969799,8.958677685950413,11.057851239669423,566.9458218549128,504.4058769513315,337.82777267625755,63.63922048770534,10
212,Jaden Springer,Boston Celtics,G,60,180,22,48,465.0,14,15,575.0,2,15,150.0,12,19,31,17,19,15,9,5,17,108,91,77,48,199.07958477508652,56.955401768550566,39.21837754709727,1.6001537870049982,709.9307958477508,447.44444444444434,375.34525182622065,182.39446366782008,10
213,Jae Crowder,Milwaukee Bucks,PF,50,194,16,54,280.5,10,12,330.0,8,33,185.0,11,18,29,8,6,3,3,3,-21,87,79,58,37,133.09212313263922,15.052286102308736,8.605024898143956,6.353327297419647,163.64531462200094,163.54504300588502,130.37483023992758,26.474875509280217,10
214,Jae'Sean Tate,Houston Rockets,SF,39,131,17,32,440.5,3,5,150.0,2,7,133.3,8,19,27,7,15,5,14,5,6,73,66,46,34,92.96667562483202,21.52512765385649,6.129266326256383,1.6001074979844128,191.7621607094867,145.35608707336738,121.80596613813492,45.221177102929325,10
215,Jahmi'us Ramsey,Toronto Raptors,SG,47,120,18,41,306.3,5,6,175.0,6,22,183.3,4,18,22,8,10,7,7,0,-28,77,69,55,30,69.3801652892562,36.066115702479344,3.072314049586777,3.402892561983472,97.25413223140495,108.65289256198346,77.28719008264463,19.832644628099175,7
216,Jaime Jr. Jaquez,Miami Heat,G,104,291,39,86,430.4,18,25,616.7,8,25,244.89999999999998,9,40,49,27,20,12,9,3,3,180,153,131,76,399.9229968782518,41.14984391259105,22.292403746097815,7.839750260145682,373.75650364203955,369.74921956295526,390.9687825182102,76.40374609781477,10
217,Jake LaRavia,Memphis Grizzlies,F,175,321,54,122,415.7,38,45,668.9,29,67,406.0,14,27,41,25,22,10,25,4,5,241,216,200,66,1008.4555765595462,31.064272211720226,25.071833648393195,69.1722327242176,1423.5066162570888,1236.0,1199.187145557656,52.91115311909263,10
218,Jakob Poeltl,Toronto Raptors,C,122,251,55,101,543.9,12,20,491.7,0,0,0.0,39,53,92,31,28,10,11,19,35,245,214,153,123,161.8469387755102,127.67346938775509,30.387755102040813,0.0,516.704081632653,398.98979591836735,256.6224489795918,181.0,10
219,Jalen Brunson,New York Knicks,PG,322,373,111,249,447.8,75,87,848.6,25,68,324.1,8,34,42,79,18,8,24,0,65,443,364,401,121,680.370083102493,57.84376731301939,85.38337950138505,45.111911357340716,697.6415512465373,652.4277008310249,758.4581717451524,110.35290858725759,10
220,Jalen Duren,Detroit Pistons,C,124,254,46,88,476.9,32,37,802.3,0,1,0.0,21,75,96,14,23,8,22,5,-68,234,220,138,110,327.6291257243638,192.8989669942051,16.790123456790123,0.0,984.3456790123457,904.0,376.7755102040817,240.8883849836231,10
221,Jalen Green,Houston Rockets,SG,183,327,64,164,366.5,31,40,644.6,24,85,265.1,6,52,58,46,18,9,32,2,-67,287,241,229,104,1092.9674060660932,51.67315527387958,51.89950203712087,28.485287460389316,1641.239022181983,1512.8469895880487,1216.4857401539157,108.44635581711181,10
222,Jalen HoodSchifino,Los Angeles Lakers,G,5,11,1,6,33.3,2,4,100.0,1,3,50.0,0,2,2,0,1,0,1,0,-13,7,7,5,2,9.0,0.9799999999999999,0.020000000000000004,0.8200000000000001,13.32,14.180000000000001,8.42,0.72,2
223,Jalen Johnson,Atlanta Hawks,SF,177,316,70,142,520.2,19,26,379.0,18,43,494.9,12,75,87,49,16,13,20,5,21,313,264,226,136,616.676,158.356,67.604,11.636,1274.2440000000001,838.0,943.1840000000001,335.69599999999997,10
224,Jalen McDaniels,Toronto Raptors,PF,45,155,18,52,261.5,9,11,425.0,0,10,0.0,5,14,19,14,14,2,8,2,-104,78,64,59,33,136.1634349030471,54.933518005540165,24.904278239458293,0.11080332409972297,433.48045552477686,334.797783933518,205.78608802708524,108.89781471221914,10
225,Jalen Pickett,Denver Nuggets,G,2,7,1,3,33.3,0,0,0.0,0,2,0.0,0,0,0,2,0,0,0,0,-1,4,2,4,2,0.8212890625,0.1650390625,1.0634765625,0.0625,2.3447265625,0.25,3.75390625,0.390625,1
226,Jalen Slawson,Sacramento Kings,F,2,8,1,2,50.0,0,0,0.0,0,1,0.0,1,1,2,0,2,1,0,0,3,4,4,2,2,2.1360946745562135,2.609467455621302,0.0,0.0,9.467455621301774,9.467455621301774,2.1360946745562135,2.609467455621302,1
227,Jalen Smith,Indiana Pacers,PF,82,154,32,64,475.8,13,16,327.4,5,17,283.3,28,32,60,8,18,5,8,7,5,150,142,90,68,187.90401051939514,60.373438527284684,7.600591715976332,5.369493754109139,346.2751479289941,347.97633136094674,198.27777777777777,55.89907955292571,10
228,Jalen Suggs,Orlando Magic,SG,134,293,46,95,481.2,28,39,654.8,14,45,277.6,9,23,32,35,29,12,9,7,-18,201,166,169,67,338.7009194159005,20.48593834505138,36.548674959437534,14.113574905354245,406.8464034613304,364.6330448891292,372.1646836127636,65.78420767982693,10
229,Jalen Williams,Oklahoma City Thunder,F,185,311,77,146,536.1,19,24,516.7,12,38,291.6,6,36,42,51,17,14,20,7,97,278,227,236,93,533.5410760554793,47.7290047248895,57.93827160493827,9.718030787989635,874.5868007925621,566.6759640298735,839.119951226947,107.9992379210486,10
230,Jalen Wilson,Brooklyn Nets,F,53,188,19,46,530.2,9,14,350.0,6,21,250.0,11,29,40,7,12,4,5,3,5,100,93,60,47,138.2227903579255,59.53542731921111,11.0,4.421110299488678,315.6435354273192,263.07596785975164,180.35792549306063,80.96785975164353,10
231,Jamal Cain,Miami Heat,F,12,37,3,9,125.0,4,4,200.0,2,4,150.0,2,3,5,6,5,1,3,1,11,23,17,18,11,14.7025,4.5725,7.402499999999999,1.1225,50.97249999999999,29.240000000000006,37.25,11.16,4
232,Jamal Murray,Denver Nuggets,PG,226,309,86,186,472.7,27,29,750.0,27,62,446.2,8,35,43,61,16,10,20,10,71,330,269,287,104,277.7136094674556,19.094674556213015,61.39999999999999,22.531360946745565,251.14556213017752,303.93017751479294,216.3751479289941,89.04852071005917,10
233,Jamaree Bouyea,San Antonio Spurs,G,7,34,3,5,150.0,0,0,0.0,1,1,100.0,1,8,9,3,5,1,1,0,8,19,16,10,12,4.5041322314049586,32.1404958677686,1.1983471074380163,0.6033057851239669,73.0,57.289256198347104,8.595041322314051,44.958677685950406,2
234,James Bouknight,Charlotte Hornets,SG,10,13,4,10,83.3,0,0,0.0,2,7,58.3,0,0,0,0,0,1,1,0,13,10,10,10,0,18.0,0.0,0.0,0.72,18.0,18.0,18.0,0.0,2
235,James Harden,LA Clippers,SG,148,331,42,116,348.2,42,49,821.3,22,75,269.4,4,49,53,85,11,10,21,4,3,286,201,233,138,598.5683709869203,70.18668252080856,123.11626370722685,27.80975029726516,873.6778966838419,662.9405469678953,733.2581582771833,269.3505086537191,10
236,James Johnson,Indiana Pacers,PF,4,19,1,5,33.3,2,2,100.0,0,1,0.0,0,0,0,3,5,0,2,1,4,7,4,7,3,3.171597633136095,0.0,0.28402366863905326,0.0,4.213017751479289,3.171597633136095,4.213017751479289,0.28402366863905326,3
237,James Wiseman,Detroit Pistons,C,75,239,28,60,399.6,19,25,358.9,0,0,0.0,18,50,68,9,23,3,12,6,-72,152,143,84,77,381.66431661592696,177.6369171607114,9.255728248678096,0.0,1049.9202050953372,992.8932863323184,418.8620413395289,206.7218394488063,10
238,Jamie Jr. Jaquez,Miami Heat,G,123,252,46,94,503.40000000000003,18,20,525.0,13,28,450.0,8,27,35,31,21,8,11,3,79,189,158,154,66,428.1111111111111,24.302777777777777,72.0111111111111,12.944444444444445,943.3027777777778,571.225,759.3000000000001,137.20277777777775,10
239,Jarace Walker,Indiana Pacers,F,46,152,17,41,442.2,2,2,100.0,10,21,366.7,4,28,32,19,10,6,7,5,34,97,78,65,51,152.76233589859666,60.77953825260298,61.797645993662286,10.607514712539611,574.0602082390222,371.81349026708915,288.9411498415573,188.64508827523767,10
240,Jared Butler,Washington Wizards,SG,96,215,37,69,511.8,12,14,450.0,10,25,386.7,3,23,26,43,23,12,17,3,-17,165,122,139,69,351.46420745069395,18.952885317750184,72.18444119795471,10.730460189919649,541.9273192111029,318.04236669101533,599.381300219138,67.10518626734843,10
241,Jared Rhoden,Detroit Pistons,G,68,201,27,54,450.8,3,6,150.0,11,27,383.3,1,26,27,10,24,3,4,11,-57,105,95,78,37,197.7668054729328,20.914336704342656,10.095181439619274,13.290303390838787,323.24866151100537,316.2742415229031,212.18441403926238,23.566329565734684,10
242,Jaren Jackson Jr.,Memphis Grizzlies,PF,223,328,81,183,426.2,46,59,770.4,15,49,319.6,15,33,48,34,37,17,27,17,-129,305,271,257,82,1094.8353151010701,51.54815695600475,26.404280618311535,10.5,1277.910225921522,1216.8281807372177,1154.5,79.36979785969085,10
243,Jarred Vanderbilt,Los Angeles Lakers,PF,68,142,26,42,412.7,13,17,375.0,3,5,166.7,12,22,34,12,8,16,11,2,23,114,102,80,46,111.33333333333334,59.333333333333336,18.0,3.5,362.0,274.0,157.33333333333334,119.33333333333334,6
244,Jarrett Allen,Cleveland Cavaliers,C,180,335,77,119,659.4,26,39,587.5,0,1,0.0,36,75,111,29,16,9,12,8,23,320,291,209,140,202.04875346260386,239.3213296398892,19.678116343490302,0.0,474.77673130193904,417.2282548476454,244.25207756232686,274.3445983379502,10
245,Jason Preston,Utah Jazz,G,12,66,6,19,133.29999999999998,0,0,0.0,0,3,0.0,5,11,16,16,3,1,1,1,16,44,28,28,32,20.733727810650883,23.81804733727811,20.741124260355026,0.0,145.88757396449702,68.05473372781066,76.12573964497041,67.0,5
246,Javon Freeman-Liberty,Toronto Raptors,G,88,218,32,71,407.0,16,17,650.0,8,25,225.0,11,31,42,20,15,6,17,2,-132,150,130,108,62,415.291015625,52.556640625,32.15625,8.697265625,786.5,688.40625,518.744140625,79.353515625,10
247,Javonte Green,Chicago Bulls,G,125,238,51,82,621.4,13,17,525.0,10,28,329.6,22,47,69,11,17,13,6,7,14,205,194,136,80,463.797783933518,120.95429362880887,17.2202216066482,8.006925207756233,788.5124653739612,807.9293628808864,466.44459833795014,116.11080332409972,10
248,Jaxson Hayes,Los Angeles Lakers,C,50,144,22,27,682.2,6,10,260.0,0,0,0.0,12,23,35,7,18,7,8,5,-24,92,85,57,42,322.5415879017013,99.85845935727788,8.417769376181473,0.0,741.0049621928167,739.4387996219282,328.5567107750473,103.82726843100188,10
249,Jay Huff,Denver Nuggets,C,3,5,1,2,50.0,0,0,0.0,1,2,50.0,0,0,0,0,2,0,0,0,-3,3,3,3,0,4.7707756232686975,0.11703601108033242,0.011080332409972297,0.8483379501385041,3.0166204986149587,3.3933518005540164,4.32202216066482,0.20013850415512466,1
250,Jaylen Brown,Boston Celtics,SG,220,343,89,180,491.4,20,32,540.5,22,61,358.8,15,40,55,25,23,16,29,10,-14,300,275,245,80,450.212890625,77.90625,32.697265625,17.60009765625,450.625,514.916015625,357.40625,139.119140625,10
251,Jaylen Nowell,Detroit Pistons,SG,30,57,12,23,193.1,4,6,150.0,2,6,66.7,3,7,10,3,2,1,2,2,-31,43,40,33,13,83.4792899408284,5.005917159763314,2.78698224852071,3.0059171597633134,135.67455621301775,126.59171597633136,93.53254437869822,6.822485207100591,4
252,Jaylin Williams,Oklahoma City Thunder,F,56,152,20,42,500.0,7,9,183.3,9,26,340.0,5,28,33,30,13,5,6,2,-1,119,89,86,63,79.80836483931947,64.98700378071834,108.64579395085066,8.917060491493384,411.83010396975425,183.80151228733462,246.69281663516065,234.77693761814746,10
253,Jayson Tatum,Boston Celtics,SF,248,367,84,184,451.9,58,68,694.2,22,71,308.4,11,69,80,53,20,9,25,5,10,381,328,301,133,350.4197530864198,65.51234567901234,40.68402777777778,16.73611111111111,566.7673611111112,558.2777777777777,354.7889660493827,110.3167438271605,10
254,Jeenathan Williams,Houston Rockets,G,31,57,15,24,350.1,0,5,0.0,1,1,100.0,4,7,11,1,5,2,2,1,24,43,42,32,12,148.76275992438562,10.175803402646505,0.8345935727788281,0.895085066162571,209.79017013232516,218.37712665406426,143.7126654064272,7.473534971644613,6
255,Jeff Dowtin,Philadelphia 76ers,G,52,135,20,36,424.2,3,4,200.0,9,19,283.4,3,17,20,26,1,7,4,1,29,98,72,78,46,209.4948096885813,24.008650519031143,46.75432525951557,9.083044982698961,473.1297577854671,275.2474048442907,401.4878892733565,76.6522491349481,10
256,Jeff Green,Houston Rockets,PF,74,170,24,59,392.1,15,17,575.0,11,36,282.5,9,18,27,12,7,4,2,1,-25,113,101,86,39,83.78189981096408,38.168241965973536,15.957703213610586,9.158790170132326,208.80340264650283,182.96431947069942,106.73345935727788,57.01346880907372,10
257,Jerami Grant,Portland Trail Blazers,SF,169,342,56,142,386.6,38,46,711.3,19,49,402.0,6,19,25,35,18,14,28,2,-77,229,194,204,60,473.98961937716257,45.9204152249135,32.71626297577855,5.083044982698962,888.6262975778548,739.6678200692041,583.0934256055364,118.49134948096886,10
258,Jeremiah Robinson-Earl,New Orleans Pelicans,F,25,109,11,30,286.2,0,4,0.0,3,14,150.0,8,16,24,12,7,3,5,1,31,61,49,37,36,59.93638525564804,45.788941736028534,31.864447086801423,2.4215219976218787,254.1510107015458,139.0856123662307,135.37990487514864,117.27526753864448,10
259,Jeremy Sochan,San Antonio Spurs,F,126,301,51,121,422.6,14,19,516.7,10,44,192.79999999999998,21,59,80,33,16,14,20,10,-20,239,206,159,113,549.0972944849116,204.3746097814776,41.58480749219564,10.166493236212277,1143.8839750260145,1165.4823100936524,519.2138397502601,254.24453694068677,10
260,Jericho Sims,New York Knicks,C,13,151,5,10,266.7,3,4,150.0,0,0,0.0,15,24,39,5,13,4,5,4,13,57,52,18,44,24.85332729741965,81.70076957899502,4.754640108646447,0.0,178.32820280669986,163.60072430964237,33.483929379809865,92.55228610230874,10
261,Jerome Robinson,Golden State Warriors,SG,15,22,6,12,140.0,2,3,150.0,1,6,16.7,0,0,0,1,1,1,0,1,5,16,15,16,1,83.41322314049587,0.18365472910927458,0.7869605142332414,0.8861340679522498,90.72910927456384,76.37924701561067,98.22222222222224,0.5114784205693297,2
262,Jett Howard,Orlando Magic,G,3,16,1,6,25.0,0,0,0.0,1,6,25.0,0,1,1,2,2,2,0,0,0,6,4,5,3,6.244897959183674,0.6666666666666667,0.727891156462585,0.693877551020408,8.061224489795919,4.91156462585034,8.727891156462585,2.061224489795918,3
263,Jevon Carter,Chicago Bulls,PG,56,158,22,56,313.0,0,0,0.0,12,38,281.7,4,9,13,21,8,5,6,3,40,90,69,77,34,370.8710059171598,10.744378698224851,122.24023668639052,14.745562130177515,948.340828402367,435.2792899408284,850.8224852071006,166.09467455621302,10
264,Jimmy Butler,Miami Heat,SF,188,355,58,126,493.5,60,69,767.2,12,30,358.2,14,36,50,54,10,12,17,0,18,292,238,242,104,208.40277777777777,28.007716049382715,38.43402777777778,5.8086419753086425,492.9648919753086,316.5679012345679,348.76736111111114,102.4741512345679,10
265,Jock Landale,Houston Rockets,C,90,224,36,65,573.6,15,19,600.0,3,12,183.3,16,19,35,19,18,8,10,6,17,144,125,109,54,234.84505137912384,41.15332612222823,18.974040021633318,2.1043807463493778,341.46349378042186,256.59004867495946,322.31936181719846,57.52650081124933,10
266,Joe Harris,Detroit Pistons,SF,2,12,1,3,33.3,0,0,0.0,0,1,0.0,0,0,0,0,1,0,0,0,-5,2,2,2,0,0.0,0.0,0.0,0.0,0.0,0.0,0.0,0.0,1
267,Joe Ingles,Orlando Magic,SG,31,160,10,23,391.6,4,7,216.7,7,17,283.3,1,22,23,28,8,7,11,1,-12,82,54,59,51,80.19656609014014,15.21360939275344,21.60181795227875,8.49551824264613,146.11513697765434,102.97815932331777,132.04355510667844,28.10541598283045,10
268,Joel Embiid,Philadelphia 76ers,C,283,328,90,203,450.0,80,95,854.2,23,58,432.0,19,74,93,48,28,12,41,7,7,424,376,331,141,400.405325443787,108.59763313609467,52.16863905325444,12.215976331360947,801.1005917159763,589.5059171597633,579.8639053254437,192.9023668639053,10
269,John Collins,Utah Jazz,PF,193,271,68,119,570.0,39,48,752.5,18,34,508.9,22,58,80,7,25,7,12,7,-49,280,273,200,87,362.38775510204084,95.36033163265307,7.3501275510204085,12.044005102040817,700.0510204081634,672.8960459183673,372.3654336734694,119.88775510204083,10
270,John Konchar,Memphis Grizzlies,SG,57,299,19,46,385.8,8,9,266.7,11,29,391.6,19,45,64,29,20,13,17,9,-3,150,121,86,93,131.325,70.55625,15.0,7.125,291.05625,223.40625,166.425,118.10624999999999,10
271,Johnny Davis,Washington Wizards,G,51,175,19,33,454.2,5,9,160.0,8,13,330.0,2,15,17,13,19,3,5,3,-65,81,68,64,30,227.83906249999998,20.1765625,12.725,17.00625,348.65625,298.60625000000005,285.6515625,25.1390625,10
272,Johnny Juzang,Utah Jazz,G,94,242,32,67,449.9,10,14,466.7,20,45,433.5,5,16,21,19,19,4,9,2,-8,134,115,113,40,482.00229568411385,34.9485766758494,11.224058769513315,32.0,504.17860422405886,493.19421487603313,477.87006427915514,61.2892561983471,10
273,Jonas Valanciunas,New Orleans Pelicans,C,128,223,51,96,508.9,26,31,751.7,0,7,0.0,27,61,88,26,25,5,17,2,-32,242,216,154,114,531.730612244898,210.3111111111111,42.060770975056684,0.2040816326530612,1192.6938775510203,905.3750566893424,796.6049886621315,274.8163265306123,10
274,Jonathan Isaac,Orlando Magic,PF,55,195,20,53,326.8,7,9,400.0,8,29,226.2,13,38,51,7,12,10,4,15,-49,113,106,62,58,181.304,61.384,4.100444444444444,6.113777777777778,418.26044444444443,364.8,216.1351111111111,84.11377777777778,10
275,Jonathan Kuminga,Golden State Warriors,PF,149,279,61,120,474.3,22,29,633.4,5,19,200.0,11,42,53,29,26,10,14,6,-9,231,202,178,82,565.0667438271606,88.21141975308642,28.91975308641975,4.934027777777778,749.4340277777778,839.5389660493828,498.4556327160493,93.63734567901234,10
276,Jontay Porter,Toronto Raptors,C,49,159,18,41,352.3,4,6,150.0,9,26,230.4,10,23,33,32,11,10,13,9,-28,114,82,81,65,215.4023668639053,32.251479289940825,58.16863905325444,15.943786982248522,472.0,275.0917159763314,386.0976331360947,116.63313609467455,10
277,Jordan Clarkson,Utah Jazz,PG,161,328,58,144,353.7,31,35,737.9,14,53,206.6,7,29,36,63,18,10,23,0,-70,260,197,224,99,1014.8698224852071,104.98224852071006,74.72485207100591,21.005917159763314,1435.3639053254435,1403.248520710059,1032.630177514793,194.0621301775148,10
278,Jordan Goodwin,Memphis Grizzlies,G,117,294,45,122,367.9,14,18,383.3,13,38,284.4,35,63,98,42,22,14,15,1,-23,257,215,159,140,367.1384083044983,298.083044982699,27.66782006920415,24.78008458285275,894.1418685121108,866.9031141868512,351.0,369.1280276816609,10
279,Jordan Hawkins,New Orleans Pelicans,G,18,92,6,30,225.0,3,5,116.7,3,18,100.0,1,9,10,5,6,2,1,1,19,33,28,23,15,39.33265306122449,8.018367346938774,4.518367346938776,5.0,54.608163265306125,68.70204081632653,29.20204081632653,8.573469387755102,10
280,Jordan McLaughlin,Minnesota Timberwolves,PG,41,147,15,28,465.5,5,6,250.0,6,16,241.7,3,10,13,26,6,5,4,0,79,80,54,67,39,109.35762788592122,16.54368492530557,60.43458578542328,12.174739701222272,302.6518786781349,159.3897691263015,240.11996378451786,89.47804436396561,10
281,Jordan Miller,LA Clippers,G,4,5,1,1,100.0,2,2,100.0,0,0,0.0,0,1,1,0,0,0,0,0,3,5,5,4,1,11.111111111111112,0.5625,0.0,0.0,16.673611111111107,16.673611111111107,11.111111111111112,0.5625,1
282,Jordan Nwora,Toronto Raptors,SF,86,201,33,73,507.4,9,13,333.3,11,31,326.9,9,33,42,20,6,6,19,6,-104,148,128,106,62,242.1617777777778,97.8151111111111,20.56711111111111,6.936,649.6160000000001,475.77777777777777,350.51377777777776,183.86844444444444,10
283,Jordan Poole,Washington Wizards,SG,226,360,83,191,425.3,26,27,850.0,34,100,326.6,6,33,39,84,26,11,31,1,-62,349,265,310,123,723.1442743764172,21.766723356009066,130.1734693877551,24.096655328798185,1152.6224489795916,875.204081632653,941.266723356009,211.23611111111114,10
284,Jordan Walsh,Boston Celtics,G,11,70,4,11,175.0,1,2,50.0,2,7,66.7,4,9,13,2,10,5,3,1,37,26,24,13,15,45.25,14.400000000000002,1.65,3.4000000000000004,55.99999999999999,62.85,43.2,11.25,5
285,Jose Alvarado,New Orleans Pelicans,PG,78,221,29,70,384.9,2,3,150.0,18,48,387.5,5,19,24,25,17,8,5,1,25,127,102,103,49,223.81733696522994,36.46563050793142,46.644608235859636,23.970197083800677,514.7022912994712,375.1200128184586,327.594456016664,118.91539817336965,10
286,Josh Giddey,Oklahoma City Thunder,SG,124,275,48,104,444.7,21,26,633.3,7,25,308.3,10,67,77,66,17,5,30,6,96,267,201,190,143,385.7574662557126,133.29291104261878,185.07067701137208,6.358699117865873,1516.1161653735785,852.7561908810712,788.6296099479222,578.8514188542885,10
287,Josh Green,Dallas Mavericks,SG,47,210,17,45,332.0,10,11,280.0,3,20,133.3,9,22,31,14,16,9,6,4,-31,92,78,61,45,130.38279773156899,31.03780718336484,12.835538752362949,5.344045368620038,140.67013232514176,142.96124763705106,134.4017013232514,37.56332703213611,10
288,Josh Hart,New York Knicks,SG,140,376,52,100,463.8,23,27,630.0,13,27,348.8,18,77,95,46,29,13,16,2,44,281,235,186,141,925.6326530612246,210.29695960016662,88.87151187005414,23.261557684298207,1763.8669304456478,1603.3698458975427,1015.9094127446898,369.3887963348605,10
289,Josh Minott,Minnesota Timberwolves,F,4,17,2,4,100.0,0,0,0.0,0,0,0.0,0,5,5,2,3,1,0,0,18,11,9,6,7,2.921875,12.32421875,0.9596354166666665,0.25520833333333337,4.463541666666668,3.98046875,6.001302083333333,10.6875,3
290,Josh Okogie,Phoenix Suns,SF,40,130,11,30,290.5,12,13,450.0,6,14,350.0,13,7,20,10,7,6,10,2,-8,70,60,50,30,142.6640625,14.71267361111111,10.296006944444443,4.816840277777779,251.4140625,220.35069444444443,160.7361111111111,38.0,10
291,Josh Richardson,Miami Heat,SG,98,211,38,76,433.2,6,6,200.0,16,45,301.7,4,26,30,19,16,5,3,2,3,147,128,117,49,296.8888888888889,20.0,10.88888888888889,27.555555555555557,468.0,427.55555555555554,344.0,24.22222222222222,9
292,Joshua Primo,LA Clippers,G,0,5,0,1,0.0,0,0,0.0,0,0,0.0,1,0,1,0,0,0,1,0,1,1,1,0,1,0.0,0.0,0.0,0.0,0.0,0.0,0.0,0.0,1
293,Jrue Holiday,Boston Celtics,PG,96,317,40,97,424.9,0,0,0.0,16,49,333.3,11,43,54,38,13,9,15,9,37,188,150,134,92,123.23138941144853,50.185971513034126,46.850309056705186,10.813222252082774,351.94302606826125,184.04299919376513,260.55468959957,127.61300725611395,10
294,Jules Bernard,Washington Wizards,G,59,113,23,47,603.7,4,7,250.0,9,19,468.3,8,14,22,12,8,2,6,1,24,93,81,71,34,216.376,16.099999999999998,16.176,7.096000000000001,366.004,282.276,300.50399999999996,31.875999999999998,10
295,Julian Champagnie,San Antonio Spurs,F,128,329,44,94,470.3,19,23,671.7,21,55,400.7,8,38,46,24,12,9,15,7,-33,198,174,152,70,326.0277744233788,37.385822968240554,37.408284023668635,13.117860161816207,629.1926095882139,517.7538944571911,417.8198285231253,94.4407680231856,10
296,Julian Phillips,Chicago Bulls,F,39,132,13,31,272.9,7,8,266.7,6,13,283.4,6,12,18,5,12,5,3,1,-11,62,57,44,23,170.91975308641975,27.290123456790123,6.777777777777779,6.401234567901234,314.4444444444444,289.44444444444446,184.5493827160494,45.43827160493827,10
297,Julian Strawther,Denver Nuggets,G,28,61,9,26,108.0,6,6,300.0,4,18,81.9,1,8,9,8,6,1,6,0,4,45,37,36,17,167.66930445647648,16.73927530195752,10.3981674302374,3.925864223240316,317.6039150354019,249.93960849645984,214.95127030404,47.519783423573514,4
298,Julius Randle,New York Knicks,PF,66,99,23,48,142.2,14,14,300.0,6,11,195.0,8,17,25,18,7,1,10,0,25,109,91,84,43,98.0,2.666666666666667,14.0,2.0,140.66666666666669,120.66666666666666,126.0,8.666666666666668,3
299,Justin Champagnie,Washington Wizards,SF,78,211,27,67,366.2,12,15,400.0,12,39,218.3,19,32,51,17,13,9,8,7,-55,146,129,95,68,314.09599999999995,79.0,12.424,15.924,774.0959999999999,667.416,390.21599999999995,121.98400000000001,10
300,Justin Holiday,Denver Nuggets,SF,40,155,15,38,379.09999999999997,0,0,0.0,10,27,386.6,3,10,13,13,8,8,4,3,20,66,53,53,26,96.25464010864646,6.119963784517882,34.517202354006336,6.0,154.4798551380715,82.23200543232232,182.11996378451786,27.019692168401992,10
301,Justin Minaya,Portland Trail Blazers,F,36,201,13,40,320.9,2,3,150.0,8,28,213.29999999999998,20,14,34,12,23,3,3,5,-54,82,70,48,46,82.13611111111112,34.86944444444445,11.336111111111112,8.311111111111112,234.06944444444449,168.39999999999998,124.10000000000001,69.91111111111111,10
302,Jusuf Nurkic,Phoenix Suns,C,81,288,30,64,516.8,20,32,519.3,1,5,50.0,31,78,109,51,35,17,26,12,34,241,190,132,160,221.73657024793388,307.04958677685954,67.99276859504133,0.9186466942148762,804.8842975206612,737.4349173553719,177.60330578512398,486.625,10
303,Karl-Anthony Towns,Minnesota Timberwolves,C,166,308,56,134,420.7,37,42,771.7,17,56,288.2,18,61,79,38,34,8,30,6,35,283,245,204,117,306.1777777777778,88.41111111111111,62.44444444444444,14.144444444444444,596.1444444444444,506.67777777777775,398.8,147.7,10
304,Kawhi Leonard,LA Clippers,SF,227,348,88,173,509.3,37,43,815.0,14,45,310.8,14,47,61,27,13,16,20,11,9,315,288,254,88,183.08527620247847,61.1974375131275,9.48729258559126,10.835538752362949,264.0707834488553,194.99810964083176,222.84268010922074,100.0,10
305,Keegan Murray,Sacramento Kings,SF,178,371,64,158,398.2,14,15,650.0,36,96,359.0,25,42,67,17,18,11,10,9,31,262,245,195,84,411.47959183673464,72.86422324031653,22.380049979175343,40.70241566014161,434.4189920866307,499.57705122865474,318.87421907538527,122.69158683881716,10
306,Keita Bates-Diop,Brooklyn Nets,SF,35,85,12,20,615.0,6,6,300.0,5,11,350.0,3,10,13,5,1,2,5,4,-13,53,48,40,18,52.10000000000001,16.81111111111111,4.677777777777777,5.4,94.5,87.3777777777778,51.511111111111106,29.2,10
307,Keldon Johnson,San Antonio Spurs,SF,145,293,49,104,463.8,27,32,684.2,20,55,368.5,15,44,59,18,17,4,11,2,-15,222,204,163,77,291.739919975377,55.21606648199445,22.15266235764851,24.603262542320714,379.4958448753462,409.48045552477686,289.8919667590028,49.232071406586634,10
308,Kelly Olynyk,Toronto Raptors,PF,143,297,51,88,584.8,34,38,823.3,7,24,281.6,17,52,69,61,35,12,29,5,-41,273,212,204,130,218.125,48.48337950138503,104.7950138504155,4.1582409972299175,358.2635041551246,247.55574792243758,359.1568559556787,122.95429362880883,10
309,Kelly Oubre Jr.,Philadelphia 76ers,SG,157,338,56,125,426.8,30,38,574.2,15,43,287.3,12,45,57,19,28,13,15,13,61,233,214,176,76,492.0569470699433,56.25354442344045,33.59191871455577,12.51063327032136,871.2932419659736,741.8005671077505,614.8015122873346,96.59357277882798,10
310,Kendall Brown,Indiana Pacers,SG,7,29,3,6,150.0,1,2,50.0,0,1,0.0,1,1,2,1,5,0,1,0,-8,10,9,8,3,13.889700511322133,1.1234477720964207,0.7720964207450693,0.0,28.613586559532504,22.763330898466037,18.844411979547118,2.79108838568298,4
311,Kenneth Lofton Jr.,Philadelphia 76ers,F,2,5,1,4,25.0,0,0,0.0,0,2,0.0,0,1,1,0,0,0,0,0,-4,3,3,2,1,108.75510204081633,11.755102040816329,16.576530612244895,0.8622448979591837,321.4336734693877,192.02040816326533,210.25,56.25,1
312,Kenneth Lofton Jr.,Utah Jazz,F,55,90,21,35,236.8,9,11,150.0,4,12,166.7,10,10,20,19,9,3,6,2,-2,94,75,74,39,273.734693877551,65.3061224489796,36.59183673469388,2.020408163265306,797.4489795918367,561.0816326530612,451.0,161.0,4
313,Kenrich Williams,Oklahoma City Thunder,SF,66,166,27,53,520.6,2,2,100.0,10,21,499.9,6,23,29,17,16,3,12,2,-24,112,95,83,46,231.94499773653234,60.318243549117255,45.89271163422364,4.327071072883658,634.2564508827523,434.69737437754645,367.29311905839745,170.42191036668177,10
314,Kentavious Caldwell-Pope,Denver Nuggets,SG,115,315,43,87,489.7,5,8,250.0,24,57,345.5,2,20,22,23,26,9,9,6,110,160,137,138,45,477.26481994459834,16.66481994459834,14.122437673130195,52.0,600.4,569.6592797783934,498.8963988919667,39.896398891966754,10
315,Kenyon Martin Jr.,Philadelphia 76ers,F,56,177,25,47,495.8,4,8,200.0,2,6,150.0,15,25,40,16,20,2,8,5,24,112,96,72,56,114.11632653061224,129.3795918367347,11.3,1.6000000000000003,439.38775510204084,396.5734693877551,148.70204081632653,148.90816326530611,10
316,Keon Ellis,Sacramento Kings,G,99,272,33,72,375.3,10,11,475.0,23,50,453.2,11,22,33,22,34,13,15,10,-18,154,132,121,55,606.2177755333922,40.785380633758365,30.575684888271677,50.510920338341116,1011.4147203635905,762.9491225855321,825.5188738795607,100.52556495391995,10
317,Keon Johnson,Brooklyn Nets,G,15,36,4,10,123.3,5,6,150.0,2,5,133.3,2,3,5,2,3,2,3,0,-11,22,20,17,7,30.12244897959184,0.6938775510204083,3.1020408163265314,1.1020408163265307,43.55102040816326,23.632653061224485,52.48979591836735,1.346938775510204,3
318,Kessler Edwards,Sacramento Kings,SF,39,93,14,34,376.7,1,4,50.0,10,23,386.7,4,10,14,3,9,5,2,0,-23,56,53,42,17,126.47470739932552,13.637770283673872,2.105732989486213,10.160285657607616,187.0482047212855,179.8101567149375,128.38524102360643,21.071017655227134,10
319,Kevin Durant,Phoenix Suns,PF,234,387,89,187,480.6,36,42,898.5,20,58,371.1,5,51,56,34,20,11,27,5,10,324,290,268,90,273.0074482195694,45.56330986634017,44.59667380879502,10.229568411386593,517.7898173655749,380.9788797061525,396.7144168962351,103.26395265789208,10
320,Kevin Huerter,Sacramento Kings,SG,72,231,29,79,330.1,2,4,100.0,12,45,205.0,6,24,30,25,23,8,11,2,5,127,102,97,55,288.7933884297521,30.44995408631772,4.61248852157943,16.24793388429752,456.10743801652893,441.77777777777777,290.6730945821855,47.51239669421488,10
321,Kevin Knox II,Detroit Pistons,SF,22,89,9,26,148.9,3,3,200.0,1,11,33.3,3,11,14,4,9,2,6,0,21,40,36,26,18,115.33333333333334,19.333333333333336,3.3333333333333335,0.8333333333333335,167.33333333333331,188.0,101.33333333333334,16.0,6
322,Kevin Love,Miami Heat,PF,85,131,29,61,433.5,14,14,300.0,13,33,321.7,12,48,60,11,16,3,11,0,45,156,145,96,71,321.10133136094674,208.8794378698225,15.710059171597633,14.178254437869821,950.2751479289941,860.2633136094674,350.47707100591714,285.2255917159763,10
323,Kevon Looney,Golden State Warriors,F,41,114,16,29,508.4,9,12,450.0,0,0,0.0,16,31,47,9,16,4,5,6,66,97,88,50,56,75.37267780071306,78.68286732970539,4.920435353724901,0.0,199.32126102458247,227.7098892850441,66.04353537249015,64.5438168511916,10
324,Keyontae Johnson,Oklahoma City Thunder,F,5,39,2,8,66.7,0,0,0.0,1,2,100.0,2,4,6,2,4,0,2,0,-15,13,11,7,8,20.0,7.0,1.2653061224489797,0.8163265306122451,29.69387755102041,35.0,17.26530612244898,5.6938775510204085,5
325,Keyonte George,Utah Jazz,G,143,306,48,125,378.1,26,29,646.7,21,68,287.1,1,20,21,41,16,3,39,0,-72,205,164,184,62,392.94444444444446,18.90625,42.259765625,23.556640625,346.6260850694444,417.5173611111111,322.53754340277777,60.681640625,10
326,Khris Middleton,Milwaukee Bucks,SF,161,303,64,120,546.9,17,20,508.3,16,41,493.4,8,55,63,56,27,10,27,1,-19,280,224,217,119,387.32622268470345,44.181581685744014,30.0,8.408428720083247,622.6638917793964,544.5348595213319,457.77783558792925,81.85900104058273,10
327,Killian Hayes,Detroit Pistons,PG,18,79,7,14,209.6,1,3,33.3,3,6,100.0,0,15,15,20,4,0,5,2,-12,53,33,38,35,27.0,18.75,54.0,2.75,252.75,74.75,153.0,124.75,4
328,Kira Lewis Jr.,Utah Jazz,PG,37,106,15,35,219.4,5,7,225.0,2,11,83.3,3,7,10,14,4,3,6,0,-54,61,47,51,24,181.12618147448012,22.531190926275993,14.956049149338375,1.4612476370510399,420.38563327032136,321.57230623818526,256.17202268431,61.2547258979206,7
329,Klay Thompson,Golden State Warriors,SG,190,302,69,153,435.0,16,16,600.0,36,93,355.6,3,26,29,25,14,9,18,4,41,244,219,215,54,817.3444444444444,32.96049382716049,10.530864197530862,46.99753086419753,1002.9,852.8753086419754,974.2827160493828,36.577777777777776,10
330,Kobe Brown,LA Clippers,G,30,124,14,32,417.5,0,0,0.0,2,11,66.6,14,11,25,10,12,6,4,3,-52,65,55,40,35,94.62516976007244,36.534631054775915,17.279311905839748,1.6038931643277499,328.5613399728384,209.77546401086465,172.22498868266183,95.0,9
331,Kobe Bufkin,Atlanta Hawks,G,63,142,27,71,372.6,3,6,116.7,6,29,151.6,4,20,24,18,17,4,8,4,-43,105,87,81,42,128.86776859504133,8.752984389348027,15.601469237832873,4.429752066115703,159.4132231404959,146.7392102846648,131.89623507805328,34.0,10
332,Kobi Simmons,Toronto Raptors,G,20,67,9,21,183.4,0,0,0.0,2,8,100.0,1,6,7,12,5,6,1,2,-31,39,27,32,19,25.11111111111111,4.111111111111111,22.0,1.1111111111111112,45.0,41.0,30.44444444444445,24.77777777777778,4
333,Kris Dunn,Utah Jazz,G,57,220,23,57,422.1,5,7,130.0,6,21,200.0,9,24,33,34,26,9,8,5,-31,124,90,91,67,86.14792899408283,42.469822485207104,44.409467455621304,6.409467455621302,200.63668639053253,168.15147928994082,96.91479289940828,108.59763313609467,10
334,Kris Murray,Portland Trail Blazers,F,94,348,34,94,348.9,12,15,483.3,14,51,242.1,30,32,62,17,25,8,16,5,-103,173,156,111,79,164.99753086419753,180.51975308641974,20.200000000000003,14.677777777777777,333.95679012345676,386.5345679012346,159.10864197530864,154.0308641975309,10
335,Kristaps Porzingis,Boston Celtics,C,173,307,61,123,491.0,34,39,816.7,17,45,426.9,19,63,82,26,26,13,17,28,6,281,255,199,108,313.9136316337149,68.17117585848075,18.618106139438087,13.203954214360042,465.63423517169616,416.00468262226843,335.22268470343397,115.1097814776275,10
336,Kyle Anderson,Minnesota Timberwolves,SF,46,183,20,52,329.3,4,7,250.0,2,8,100.0,3,15,18,31,20,11,8,8,-9,95,64,77,49,174.74066366053881,52.782518210197715,74.30697190426638,1.607815932477743,755.9626546421551,391.4760087871431,426.6508266851659,239.66597294484913,10
337,Kyle Kuzma,Washington Wizards,SF,218,366,85,181,489.6,37,47,775.0,11,43,218.6,3,70,73,51,24,7,36,7,-27,342,291,269,124,513.3879277201077,57.532103037293346,59.63667820069204,16.7439446366782,740.9957708573625,549.878123798539,709.8965782391388,111.77777777777777,10
338,Kyle Lowry,Philadelphia 76ers,PG,94,302,30,60,528.5,14,17,400.0,20,42,533.8,6,28,34,42,33,8,14,5,66,170,128,136,76,407.2959279414524,36.468380559204356,83.85250516044286,16.827547382248074,509.474197785701,446.0589228748358,490.86582848564456,100.16626008632014,10
339,Kyrie Irving,Dallas Mavericks,PG,278,388,98,185,530.5,49,55,815.4,33,74,450.9,10,41,51,41,22,16,25,6,81,370,329,319,92,583.3877551020408,54.941326530612244,80.40617913832199,8.736961451247165,582.0907029478458,678.125,439.1544784580499,183.546485260771,10
340,LaMelo Ball,Charlotte Hornets,PG,32,55,12,37,66.1,5,6,150.0,3,17,34.7,1,5,6,15,10,3,7,0,-49,53,38,47,21,2.0,2.0,0.5,0.5,4.5,8.0,0.5,0.5,2
341,Lamar Stevens,Memphis Grizzlies,PF,114,252,42,108,413.9,24,27,583.3,6,27,235.0,13,38,51,12,13,12,6,8,16,177,165,126,63,156.41322314049586,41.26446280991736,9.798553719008265,4.5,248.1745867768595,209.0165289256198,198.50929752066116,48.125,10
342,Landry Shamet,Washington Wizards,SG,55,184,20,55,273.1,7,7,300.0,8,35,104.1,4,10,14,8,12,4,9,2,-68,77,69,63,22,330.90000000000003,22.5,5.700000000000001,15.624999999999998,463.7,413.80000000000007,373.0,35.99999999999999,10
343,Larry Nance Jr.,New Orleans Pelicans,PF,74,217,30,53,557.8,10,13,500.0,4,10,200.0,24,35,59,30,29,9,15,1,5,163,133,104,89,171.57084653689452,90.52557718424626,56.21118153010411,4.407650520597556,552.110683567225,377.0941602535084,308.7725215029425,184.55160706201903,10
344,Lauri Markkanen,Utah Jazz,PF,223,347,68,170,401.2,57,60,956.7,30,80,363.3,20,49,69,26,14,11,18,4,-42,318,292,249,95,334.8261504747991,129.06135865595326,45.68298027757487,34.00730460189919,657.4915997078159,517.5704894083273,451.0029218407597,198.48867786705623,10
345,LeBron James,Los Angeles Lakers,SF,286,373,105,182,588.9,54,69,765.2,22,45,416.2,10,63,73,97,8,19,41,7,68,456,359,383,170,358.45804988662127,40.125,115.04336734693878,63.95379818594105,411.5464852607711,438.8687641723356,294.1000566893426,192.20408163265307,10
346,Leaky Black,Charlotte Hornets,F,42,192,16,32,465.4,4,5,250.0,6,12,250.0,4,27,31,19,8,5,4,6,-11,92,73,61,50,135.65289256198346,30.28925619834711,17.595041322314046,10.400826446280993,250.77685950413223,161.0,203.26446280991735,70.04958677685951,10
347,Leonard Miller,Minnesota Timberwolves,F,7,15,3,6,133.3,0,0,0.0,1,2,100.0,2,2,4,4,0,1,0,0,20,15,11,11,8,15.855597620335315,5.475932936722552,4.469442942130881,0.8399134667387779,34.22498647917794,27.877771768523523,26.453758788534348,5.694429421308816,3
348,Lester Quinones,Golden State Warriors,G,64,149,23,57,369.2,9,13,325.0,9,34,228.6,8,15,23,13,18,1,5,0,-13,100,87,77,36,273.41157024793387,28.943801652892564,17.77355371900827,11.000000000000002,434.29421487603304,406.76198347107436,313.97520661157023,33.68595041322314,10
349,Lindy Waters III,Oklahoma City Thunder,F,67,103,25,48,519.0,2,2,200.0,15,33,366.7,5,9,14,8,5,3,2,2,-24,89,81,75,22,203.5388429752066,17.04793388429752,11.930578512396695,19.185123966942147,290.7917355371901,216.97355371900824,268.83140495867764,37.50413223140496,10
350,Lonnie Walker IV,Brooklyn Nets,G,67,174,27,81,325.7,3,4,150.0,10,45,240.8,4,23,27,12,7,3,5,6,-67,106,94,79,39,266.38271604938274,54.00192901234567,25.808641975308646,12.0,731.6006944444445,518.7519290123457,420.7716049382716,138.2704475308642,10
351,Luguentz Dort,Oklahoma City Thunder,G,123,291,38,88,407.3,25,34,555.0,22,55,393.2,7,22,29,17,23,9,11,4,53,169,152,140,46,345.25434027777777,45.916015625,8.108506944444445,14.462890625,426.59483506944446,416.16254340277777,354.1006944444444,55.61046006944445,10
352,Luka Doncic,Dallas Mavericks,PG,326,388,109,230,473.3,55,69,796.1,53,126,424.6,8,97,105,90,26,10,44,5,126,521,431,416,195,411.1111111111111,44.42081999695169,52.049382716049394,40.93141289437585,486.95305593659504,509.86937966773354,431.01234567901236,53.65264441396128,10
353,Luka Garza,Minnesota Timberwolves,C,70,75,26,48,410.8,11,14,366.7,7,21,233.3,13,6,19,2,9,3,3,1,9,91,89,72,21,221.7951843043995,28.34453032104637,1.707193816884661,5.40665873959572,375.50743162901307,347.2520808561237,247.41973840665872,32.682520808561236,7
354,Luka Samanic,Utah Jazz,F,95,208,32,81,337.7,26,34,609.2,5,32,197.6,14,38,52,13,13,3,16,2,-48,160,147,108,65,584.65625,104.15114795918367,11.530612244897958,2.8858418367346936,1255.3188775510203,1040.9413265306123,741.5082908163265,173.20727040816325,10
355,Luke Kennard,Memphis Grizzlies,SG,118,282,40,88,429.0,9,9,500.0,29,64,450.4,2,28,30,53,7,6,24,1,-63,201,148,171,83,483.43673469387755,10.073469387755102,60.68979591836735,26.90204081632653,676.3306122448979,492.7755102040816,657.4081632653061,80.34693877551021,10
356,Luke Kornet,Boston Celtics,C,62,179,27,33,875.0,7,7,300.0,1,1,100.0,19,32,51,16,7,3,2,8,89,129,113,78,67,161.1033601168736,142.17275383491602,28.72790357925493,0.935354273192111,725.662892622352,501.0993425858291,281.57487216946674,274.9926953981008,10
357,M. Pereira,Memphis Grizzlies,F,44,120,16,33,255.6,7,10,225.0,5,13,150.0,10,26,36,2,10,6,5,4,7,82,80,46,38,240.508875739645,107.38856015779093,1.4319526627218937,5.3550295857988175,656.7297830374753,624.319526627219,255.88165680473372,125.85798816568047,6
358,M. Williams,Toronto Raptors,C,17,102,8,31,117.5,0,2,0.0,1,4,100.0,13,23,36,2,15,3,3,3,-50,55,53,19,38,53.7616,116.99839999999999,1.3504,0.8464,310.81759999999997,291.85760000000005,58.03039999999999,133.04000000000002,6
359,Malachi Flynn,Detroit Pistons,PG,120,191,45,98,409.8,17,25,310.0,13,43,282.3,3,19,22,32,13,11,18,1,-50,174,142,152,54,1870.4000000000003,35.94489795918367,53.88775510204082,22.39387755102041,2424.0,2258.2306122448977,2049.202040816326,76.8,10
360,Malaki Branham,San Antonio Spurs,G,123,262,48,106,436.0,5,9,250.0,22,53,417.1,3,15,18,17,14,3,15,1,-22,158,141,140,35,519.5254753955581,19.830454347510525,12.101175787487298,25.616199738713895,628.356800696763,614.0849179851938,526.9644360574829,38.764552184642184,10
361,Malcolm Brogdon,Portland Trail Blazers,PG,102,218,37,83,266.20000000000005,17,19,433.3,11,30,202.89999999999998,7,22,29,40,13,4,17,2,4,171,131,142,69,100.0,28.833333333333336,7.333333333333334,6.833333333333334,113.5,66.83333333333334,151.33333333333331,31.5,6
362,Malik Beasley,Milwaukee Bucks,SG,74,252,28,79,367.8,1,1,100.0,17,58,270.8,1,26,27,11,14,4,6,0,-43,112,101,85,38,258.88218291131926,15.84957798589432,10.908428720083247,22.831194357729217,330.4416695571742,295.6497861024396,302.83119435772926,17.60087871430223,10
363,Malik Monk,Sacramento Kings,SG,157,272,57,138,394.0,31,33,730.0,12,58,166.1,6,27,33,44,31,6,17,2,13,234,190,201,77,653.7845804988663,24.25724363819602,14.982111363063742,11.617031997984379,877.3560090702948,822.5527840765936,694.3827160493827,53.44444444444444,10
364,Mamadi Diakite,New York Knicks,F,0,5,0,0,0.0,0,0,0.0,0,0,0.0,0,1,1,0,1,1,0,0,0,1,1,0,1,0.0,0.4049586776859504,0.0,0.0,0.4049586776859504,0.4049586776859504,0.0,0.4049586776859504,1
365,MarJon Beauchamp,Milwaukee Bucks,F,44,57,16,25,485.0,7,8,175.0,5,10,350.0,2,12,14,2,5,2,3,1,-18,60,58,46,16,71.55555555555554,13.625,1.5555555555555556,2.375,132.125,117.5138888888889,82.0,19.347222222222218,8
366,Marcus Morris Sr.,Cleveland Cavaliers,SF,55,156,21,52,479.5,5,8,250.0,8,24,328.3,5,16,21,10,10,2,11,2,-51,86,76,65,31,81.84023668639053,49.33136094674556,10.299556213017754,4.080621301775148,202.25813609467457,183.20710059171597,97.61020710059171,62.91198224852071,10
367,Marcus Sasser,Detroit Pistons,G,136,309,48,127,343.6,21,23,540.0,19,60,303.9,3,17,20,46,18,9,22,4,-93,202,156,182,66,723.9754017060108,14.285657607617537,22.946637571910337,14.129934536798256,843.8091648482443,686.2824836341996,882.2924023011307,36.44197579845269,10
368,Markelle Fultz,Orlando Magic,PG,68,175,30,64,442.3,7,8,350.0,1,4,100.0,11,17,28,17,15,6,10,3,-36,113,96,85,45,458.07402659830166,37.600064092292904,23.91972440314052,0.9416760134593815,792.5257170325269,696.8851145649735,522.9362281685627,92.29818939272552,10
369,Markieff Morris,Dallas Mavericks,PF,15,49,5,16,195.3,2,2,100.0,3,10,100.0,0,9,9,3,0,0,2,2,-18,27,24,18,12,33.8704,16.830399999999997,6.7696,2.8944,145.5824,95.4016,66.9856,40.6656,4
370,Marques Bolden,Charlotte Hornets,C,35,112,16,24,376.7,3,4,150.0,0,1,0.0,10,20,30,4,9,3,3,7,-26,69,65,39,34,142.02853745541023,63.56242568370986,5.888228299643282,0.0,440.7253269916765,373.7526753864447,189.5909631391201,88.86087990487513,7
371,Marvin Bagley III,Washington Wizards,PF,134,238,58,89,623.5,12,13,600.0,6,8,450.0,23,49,72,8,11,5,10,9,3,214,206,142,80,341.85484830458057,93.62879238548483,15.875074360499699,4.5258774538964905,424.1273051754908,392.8102320047591,350.1939321832243,132.48185603807258,10
372,Mason Jones,Sacramento Kings,G,7,24,2,7,66.7,1,2,50.0,2,6,66.7,1,4,5,5,2,1,2,0,-5,17,12,12,10,21.787037037037038,12.75,12.75,2.7037037037037037,74.67592592592592,35.48148148148148,35.48148148148148,51.0,3
373,Mason Plumlee,LA Clippers,C,37,149,13,39,317.5,11,14,375.0,0,5,0.0,12,40,52,15,18,4,8,4,-6,104,89,52,67,147.50826685165916,164.3840906463175,24.687825182101978,0.0,788.7929240374609,564.9105098855359,265.6855127760435,294.77708405596024,10
374,Matisse Thybulle,Portland Trail Blazers,SG,67,209,25,53,398.9,5,7,200.0,12,31,335.0,7,24,31,20,14,17,12,7,-23,118,98,87,51,338.8434903047091,39.325484764542935,20.249307479224377,12.531855955678669,707.3573407202216,558.770083102493,458.20637119113564,88.79916897506926,10
375,Matt Ryan,New Orleans Pelicans,F,28,83,10,28,233.3,0,0,0.0,8,22,194.4,1,8,9,2,7,0,3,0,-12,39,37,30,11,220.2777777777778,18.386621315192745,1.6383219954648527,20.005668934240365,369.6383219954648,355.55328798185946,232.6938775510204,21.693877551020414,10
376,Matthew Hurt,Memphis Grizzlies,F,32,110,12,33,215.9,3,3,200.0,5,19,233.4,9,7,16,4,8,3,2,3,-7,52,48,36,20,163.8343195266272,34.95857988165681,4.934911242603551,5.335798816568047,360.0,296.6272189349112,213.72781065088756,53.37278106508876,7
377,Max Christie,Los Angeles Lakers,G,39,115,15,31,519.4,3,4,150.0,6,14,250.0,3,17,20,7,4,2,4,1,17,66,59,46,27,156.3390625,37.90625,8.2,6.5265625,411.78906250000006,319.4640625,219.41406250000003,75.35625,10
378,Max Strus,Cleveland Cavaliers,SG,101,326,33,83,412.7,16,19,433.4,19,52,370.7,13,54,67,55,17,10,21,1,18,223,168,156,122,218.05098855359003,104.88969823100939,127.8652445369407,15.859001040582726,562.5,225.88137356919876,488.1316337148803,299.292924037461,10
379,Maxi Kleber,Dallas Mavericks,PF,53,208,16,33,573.3,11,14,325.0,10,21,400.0,13,26,39,17,15,3,8,11,80,109,92,70,56,99.29826933477554,31.42401297998918,8.123850730124392,8.596268253109788,207.88345051379122,196.5356949702542,116.3442401297999,33.84964845862628,10
380,Maxwell Lewis,Los Angeles Lakers,F,2,11,1,5,25.0,0,0,0.0,0,2,0.0,1,0,1,2,0,0,0,0,-15,5,3,4,3,2.7573964497041423,0.8579881656804735,3.0680473372781067,0.0,6.7603550295857975,6.65680473372781,3.624260355029586,3.162721893491124,2
381,Micah Potter,Utah Jazz,C,32,138,12,31,307.1,3,5,200.0,5,16,216.7,8,24,32,5,12,4,5,6,-22,69,64,37,37,107.80811609782316,45.73716742811072,8.53292125772642,6.516796560064499,308.30932545014775,255.41144853533996,140.17549045955388,74.80059123891428,10
382,Michael Porter Jr.,Denver Nuggets,SF,165,322,64,143,453.6,9,10,366.7,28,72,394.0,9,63,72,13,16,6,10,7,75,250,237,178,85,121.70033319450226,132.08579758433984,18.585797584339858,17.64264889629321,297.20033319450226,265.55789254477304,125.51436901291132,178.5,10
383,Mikal Bridges,Brooklyn Nets,SF,138,315,49,118,411.6,10,11,466.7,30,72,425.9,7,24,31,33,10,11,8,4,-33,202,169,171,64,405.80622837370237,54.65813148788928,18.352249134948096,23.00899653979239,654.0013840830451,566.7162629757785,501.28096885813153,64.82076124567473,10
384,Mike Conley,Minnesota Timberwolves,PG,131,285,45,98,453.6,12,12,600.0,29,59,458.4,9,21,30,50,18,16,25,2,-13,211,161,181,80,300.17107750472593,28.738421550094518,62.19966918714556,31.813090737240074,381.4111531190926,362.9718809073724,295.3783081285444,114.17013232514178,10
385,Mike Muscala,Oklahoma City Thunder,C,16,96,7,26,306.7,1,3,50.0,1,14,33.3,8,13,21,6,8,3,2,1,38,43,37,22,27,34.25562130177514,29.177514792899412,7.2544378698224845,0.914792899408284,99.06390532544378,83.05917159763314,36.828402366863905,49.86390532544379,10
386,Miles Bridges,Charlotte Hornets,SF,193,366,73,155,472.9,27,31,721.4,20,63,275.2,9,55,64,34,14,6,16,3,-75,291,257,227,98,578.3074717490301,68.311013661663,27.08821049080789,34.13661663012312,1059.5687299713272,850.9669421487603,730.0753921403273,152.23309158374093,10
387,Miles McBride,New York Knicks,PG,123,290,44,102,423.0,12,13,550.0,23,60,315.2,6,19,25,23,21,9,6,1,-2,171,148,146,48,575.775390625,40.77777777777777,14.2890625,34.2890625,894.2302517361111,813.5323350694445,647.931640625,63.60850694444444,10
388,Mitchell Robinson,New York Knicks,C,37,170,12,22,260.0,13,26,429.1,0,0,0.0,32,17,49,5,16,6,2,10,-2,91,86,42,54,208.36776859504135,113.35640495867769,4.629132231404959,0.0,553.595041322314,529.823347107438,211.625,138.5,10
389,Mo Bamba,Philadelphia 76ers,C,75,191,28,53,507.8,11,15,425.0,8,23,273.3,18,46,64,10,25,7,5,17,-4,149,139,85,74,166.18400000000003,43.681777777777775,12.044444444444443,5.855999999999999,319.80000000000007,300.2444444444444,196.60177777777778,44.864,10
390,Monte Morris,Minnesota Timberwolves,PG,42,131,16,39,339.1,1,2,50.0,9,22,326.7,1,20,21,18,8,3,1,5,39,81,63,60,39,159.2523629489603,24.534971644612476,29.64839319470699,10.909262759924387,365.6266540642722,250.5,260.5415879017013,68.02079395085066,10
391,Moritz Wagner,Orlando Magic,C,108,157,43,71,632.6,18,22,700.0,4,15,216.7,12,27,39,5,26,7,9,1,6,152,147,113,44,143.58742583007196,28.96010604721626,7.59335942431511,4.424441358414342,261.6000504986744,221.16841307915666,180.1566721373564,40.41585658376468,10
392,Moses Brown,Portland Trail Blazers,C,51,109,21,39,510.4,9,27,240.8,0,0,0.0,19,20,39,4,14,3,7,4,-16,94,90,55,43,103.24852071005918,72.11111111111111,6.401051939513478,0.0,281.23734385272843,267.051939513478,112.75016436554898,83.19592373438527,10
393,Moses Moody,Golden State Warriors,SG,105,216,35,72,523.8,16,21,596.7,19,36,555.0,7,24,31,14,19,5,5,1,49,150,136,119,45,148.45746579417013,19.938429506246283,7.389946460440214,16.890541344437832,240.5484830458061,205.3768590124925,176.96044021415827,33.99702558001189,10
394,Mouhamadou Gueye,Toronto Raptors,F,26,112,11,37,340.5,4,9,225.0,0,3,0.0,11,10,21,5,13,3,11,15,-78,52,47,31,26,13.906509695290858,27.529778393351805,4.25,0.0,63.374653739612185,48.5983379501385,29.603878116343495,30.858725761772856,9
395,Mouhamed Gueye,Atlanta Hawks,F,21,56,7,17,108.9,4,4,100.0,3,6,166.7,8,11,19,4,12,3,0,4,-13,44,40,25,23,128.75,11.421875,5.6875,2.29296875,159.796875,175.546875,105.6875,24.421875,3
396,Moussa Diabate,LA Clippers,F,2,7,1,1,100.0,0,2,0.0,0,0,0.0,1,3,4,0,0,1,0,1,1,6,6,2,4,0.0,0.0,0.0,0.0,0.0,0.0,0.0,0.0,1
397,Myles Turner,Indiana Pacers,C,172,260,62,120,518.2,27,35,808.4,21,54,411.2,8,60,68,19,17,5,11,20,79,259,240,191,87,389.71984856679285,101.72985397512169,44.6914548404543,9.114656571119525,868.802055164954,781.7125473228772,468.2447268793943,154.98593834505138,10
398,Naji Marshall,New Orleans Pelicans,SF,66,213,25,58,400.8,7,8,300.0,9,26,332.1,7,32,39,17,19,8,5,3,26,122,105,83,56,164.5,37.075716603569504,16.204705246078962,12.9394267171444,365.76960519199565,297.0408328826393,212.10005408328828,74.4091400757166,10
399,Nassir Little,Phoenix Suns,SF,22,69,9,21,325.0,0,0,0.0,4,12,250.0,0,11,11,5,7,0,1,2,-14,38,33,27,16,40.86563614744352,16.745541022592157,5.160523186682521,2.401902497027349,70.36147443519619,59.25445897740785,47.77883472057076,26.099881093935785,8
400,Nate Hinton,Houston Rockets,G,14,36,5,10,143.3,2,3,66.7,2,5,66.7,2,9,11,7,5,1,1,2,8,32,25,21,18,78.91836734693878,11.0,11.632653061224492,3.4897959183673466,174.0,114.01360544217688,117.0,44.5374149659864,3
401,Nathan Mensah,Charlotte Hornets,C,4,59,2,5,66.7,0,0,0.0,0,0,0.0,4,6,10,1,13,2,1,4,-17,15,14,5,11,13.75,9.9375,0.859375,0.0,41.359375,44.4375,13.484375,7.984375,7
402,Naz Reid,Minnesota Timberwolves,C,149,249,54,118,421.8,18,28,515.8,23,53,378.3,5,49,54,13,23,12,18,9,-1,216,203,162,67,768.4830239927569,114.4972838388411,8.685830692621096,42.13807152557719,1274.867587143504,1189.9938886373925,829.8153010411951,146.72453598913535,10
403,Neemias Queta,Boston Celtics,C,70,116,33,45,590.1,4,6,175.0,0,0,0.0,19,25,44,10,12,5,7,12,81,124,114,80,54,210.49586776859505,68.82851239669421,19.010330578512395,0.0,562.3471074380166,454.72933884297515,309.2747933884297,96.67768595041323,9
404,Nic Claxton,Brooklyn Nets,C,102,311,46,74,638.1,10,30,330.0,0,0,0.0,31,81,112,22,23,6,21,21,9,236,214,124,134,139.23426306965402,86.15058680079254,15.7290047248895,0.0,325.92196311537873,289.16476146928824,166.45816186556925,111.41289437585733,10
405,Nick Jr. Smith,Charlotte Hornets,G,77,177,26,75,328.9,9,10,187.5,16,40,271.2,2,18,20,17,11,2,7,0,-15,114,97,94,37,623.0548696844992,37.90123456790124,16.679012345679013,39.16598079561042,1065.5363511659807,887.639231824417,768.5322359396434,87.0,10
406,Nick Richards,Charlotte Hornets,C,94,247,39,53,745.5,16,18,575.0,0,0,0.0,18,51,69,8,24,5,10,4,-44,171,163,102,77,62.56850077968366,194.35219425261755,7.615059033192247,0.0,339.3105368678993,373.687458231232,39.42214301626198,190.73668968589885,10
407,Nickeil Alexander-Walker,Minnesota Timberwolves,SG,120,240,44,88,528.5,9,10,450.0,23,52,532.1,3,19,22,26,17,12,9,3,91,168,142,146,48,377.1635547393123,23.639220487705337,24.67442097745128,17.125293337414547,669.3447607387002,532.0826446280992,499.03315988164474,63.70615243342516,10
408,Nicolas Batum,Philadelphia 76ers,PF,61,295,22,56,334.5,0,0,0.0,17,45,296.2,7,33,40,20,15,8,9,5,14,121,101,81,60,316.5,24.7437641723356,46.17148526077098,33.27551020408163,287.329081632653,378.9580498866213,216.24291383219955,79.54336734693878,10
409,Nikola Jokic,Denver Nuggets,C,288,366,117,190,616.2,39,51,768.2,15,32,504.2,30,113,143,91,25,20,33,4,135,522,431,379,234,734.3951901953982,145.2807260955024,106.45265348595213,7.439125910509885,969.1363163371487,933.0291363163373,715.5679269279686,306.66782286969595,10
410,Nikola Jovic,Miami Heat,F,111,238,41,82,524.5,8,8,300.0,21,52,434.1,4,51,55,17,19,6,13,4,-3,183,166,128,72,509.13595488492604,52.98902606310013,34.61042524005487,21.644413961286386,680.3403444596861,640.6032616979119,515.3119951226947,121.16049382716051,10
411,Nikola Vucevic,Chicago Bulls,C,179,332,75,149,475.7,13,18,385.7,16,41,480.0,22,79,101,34,18,7,13,5,-42,314,280,213,135,536.3049148653544,101.378215191402,32.65040454051443,5.254437869822485,578.5467938654751,552.4352131385099,509.90858591957493,186.53652940466128,10
412,Noah Clowney,Brooklyn Nets,F,89,241,33,60,503.9,14,20,396.4,9,20,283.4,18,37,55,9,19,5,9,14,-52,153,144,98,64,487.61706406205116,102.65642056880208,7.320597529445562,11.471128985923585,918.6529732835392,869.9448434357943,527.7983338121229,118.50387819592069,10
413,Norman Powell,LA Clippers,G,111,274,37,98,384.7,17,19,335.7,20,47,388.0,4,18,22,10,19,5,7,1,71,143,133,121,32,298.4373639134852,21.9442589635651,6.175642328349543,18.28451154013645,345.1811583684134,329.62534475250396,315.50137901001597,26.611699811293363,10
414,O.G. Anunoby,New York Knicks,SF,109,326,46,106,419.8,3,5,150.0,14,40,335.0,7,33,40,12,23,14,16,9,62,161,149,121,52,337.0701963117192,50.214158239143366,10.29387269482451,16.40095181439619,304.5669244497323,322.6478286734087,294.21832242712674,85.279000594884,10
415,Obi Toppin,Indiana Pacers,PF,116,181,47,83,578.1,8,10,450.0,14,39,379.5,11,37,48,18,17,9,8,8,57,182,164,134,66,325.92556710775045,65.65689981096409,33.09735349716446,12.863185255198488,570.507797731569,526.5909735349716,408.6193289224953,59.9773156899811,10
416,Ochai Agbaji,Toronto Raptors,G,73,276,29,70,378.4,12,21,441.7,3,23,120.0,19,24,43,20,18,9,13,9,-49,136,116,93,63,168.44489795918366,81.27551020408164,24.35918367346939,2.559183673469388,478.68775510204085,359.1938775510204,238.60816326530613,154.96530612244896,10
417,Olivier Sarr,Oklahoma City Thunder,C,11,22,4,7,125.0,3,5,116.7,0,1,0.0,4,4,8,0,3,0,1,1,-14,19,19,11,8,43.6875,8.75,0.0,0.0,79.1875,79.1875,43.6875,8.75,3
418,OlivierMaxence Prosper,Dallas Mavericks,F,41,102,14,32,235.7,9,14,217.1,4,12,83.3,7,15,22,2,4,3,4,2,-57,65,63,43,24,319.0720221606648,67.5443213296399,1.362880886426593,5.777008310249307,720.7576177285318,666.740997229917,358.0637119113573,83.93213296398892,6
419,Omer Yurtseven,Utah Jazz,C,104,220,47,86,529.8,9,11,500.0,1,7,50.0,27,51,78,13,13,3,12,4,-57,195,182,117,91,289.8351525952328,233.4560035642682,12.69035419915349,0.9010915571396747,868.6587213187793,764.7676542659838,327.2401425707284,312.63243484072177,10
420,Onuralp Bitim,Chicago Bulls,SF,54,166,24,54,474.4,1,1,100.0,5,23,133.4,5,14,19,8,16,1,6,1,-56,81,73,62,27,280.4094674556213,51.17514792899408,5.836686390532545,4.813017751479291,548.9360946745562,513.9822485207101,299.7514792899408,72.62366863905325,10
421,Onyeka Okongwu,Atlanta Hawks,PF,147,296,61,89,703.8000000000001,16,22,492.9,9,19,466.6,32,44,76,11,28,7,5,15,4,234,223,158,87,308.4240362811791,185.95918367346937,9.244897959183675,5.6893424036281175,807.5192743764171,822.7913832199548,307.3560090702948,181.0,10
422,Orlando Robinson,Miami Heat,C,13,59,4,11,108.3,4,5,175.0,1,2,100.0,8,9,17,5,4,1,3,0,4,35,30,18,22,56.670068027210895,32.06122448979591,3.108843537414966,0.8639455782312926,127.7448979591837,104.86054421768706,77.05102040816328,37.673469387755105,6
423,Oscar Tshiebwe,Indiana Pacers,C,3,5,1,3,33.3,1,2,50.0,0,0,0.0,2,0,2,0,1,0,0,1,8,5,5,3,2,0.25,0.0,0.0,0.0,0.25,0.25,0.25,0.0,1
424,Oshae Brissett,Boston Celtics,SF,39,128,15,34,385.1,6,16,190.0,3,8,250.0,15,17,32,9,9,2,5,4,23,80,71,48,41,68.31519274376417,83.51927437641723,4.904257999496095,2.1383219954648522,212.29881582262536,233.53061224489798,58.864197530864196,76.6427311665407,10
425,Ousmane Dieng,Oklahoma City Thunder,F,41,113,16,37,374.4,4,4,200.0,5,17,253.3,1,8,9,18,5,6,8,5,18,68,50,59,27,215.17233560090705,7.090702947845805,28.75736961451247,4.777777777777779,409.50566893424036,268.9750566893424,346.55102040816325,45.0,10
426,P.J. Tucker,LA Clippers,PF,19,164,7,17,213.3,0,0,0.0,5,9,400.0,7,22,29,6,13,7,1,0,3,54,48,25,35,91.27091906721536,49.36145404663923,2.46639231824417,4.554869684499314,178.50754458161862,165.6049382716049,102.62345679012347,53.37791495198902,10
427,P.J. Washington,Dallas Mavericks,PF,148,333,53,114,440.5,16,25,531.4,26,64,413.8,11,55,66,16,21,17,13,11,57,230,214,164,82,660.7492195629552,62.48953636258527,14.511041738929356,26.534628280726096,730.9427679500519,688.0830153775004,688.6095502370216,92.0,10
428,Paolo Banchero,Orlando Magic,PF,237,378,81,198,415.3,61,78,774.2,14,56,264.6,10,63,73,55,17,5,36,5,-32,365,310,292,128,281.39239001189065,110.44166996961289,23.110714757563745,4.488836041749241,616.730215352094,480.7543929184833,346.7599418681464,204.16065530453164,10
429,Pascal Siakam,Indiana Pacers,PF,238,313,99,174,576.3,30,43,632.4,10,22,400.0,23,61,84,27,29,5,12,5,43,349,322,265,111,551.7327504725898,66.60491493383742,36.296786389413995,8.118147448015122,1038.9435255198487,850.8556238185255,679.3367202268431,163.38563327032136,10
430,Pat Connaughton,Milwaukee Bucks,SG,58,244,20,60,336.4,10,11,550.0,8,38,152.2,9,26,35,27,17,9,7,3,-10,120,93,85,62,132.05101498565205,65.89276224891061,46.18418535444788,9.61228610904453,495.86055903921783,302.4177914762461,257.4249123179934,180.14581783398873,10
431,Pat Spencer,Golden State Warriors,G,2,15,1,3,33.3,0,0,0.0,0,2,0.0,2,2,4,3,0,0,1,0,7,9,6,5,7,1.3407202216066483,11.346260387811633,4.886426592797783,0.0,45.38504155124653,20.48753462603878,11.346260387811633,31.124653739612192,1
432,Patrick Baldwin Jr.,Washington Wizards,F,69,217,26,63,339.8,6,9,325.0,11,43,163.3,6,44,50,11,25,9,8,8,-19,130,119,80,61,489.18052167385997,151.4479264402327,24.90542315631451,18.974479264402326,1376.0390317132671,1119.9652842934884,665.656220679302,255.95139801088385,10
433,Patrick Beverley,Milwaukee Bucks,PG,72,254,25,57,346.5,12,13,450.0,10,27,240.0,10,43,53,41,15,8,5,6,15,166,125,113,94,476.40625,72.76406250000001,57.456250000000004,20.0390625,998.6890625,791.6890625,632.6,181.0265625,10
434,Patrick Williams,Chicago Bulls,PF,6,24,2,9,22.2,2,2,100.0,0,5,0.0,0,6,6,2,5,0,2,2,-11,14,12,8,8,0.0,0.0,0.0,0.0,0.0,0.0,0.0,0.0,1
435,Patty Mills,Miami Heat,PG,54,171,18,60,255.1,11,11,400.0,7,42,145.8,4,4,8,17,12,10,6,0,21,79,62,71,25,276.6712802768167,5.799307958477509,14.461745482506728,6.100346020761245,325.35678585159553,277.60553633217995,314.1595540176855,30.52402921953095,10
436,Paul George,LA Clippers,F,229,328,73,155,478.6,54,56,975.0,29,67,433.3,4,44,48,31,28,12,23,4,46,308,277,260,79,1004.5423822714681,81.71080332409971,35.56509695290859,35.9994459833795,1921.5047091412741,1534.7063711911358,1310.397783933518,198.21883656509695,10
437,Paul Reed,Philadelphia 76ers,SF,70,169,34,53,764.8,1,3,50.0,1,3,50.0,17,37,54,14,17,9,6,9,43,138,124,84,68,99.52290712203248,89.1411911703457,36.44814660558101,1.109954185755935,499.3563098708871,355.1089129529363,187.1747188671387,182.18492294877137,10
438,Payton Pritchard,Boston Celtics,PG,152,271,63,116,453.0,5,6,250.0,21,53,344.2,7,25,32,62,17,7,7,0,123,246,184,214,94,1087.5864197530864,27.808641975308642,89.94567901234569,22.911111111111108,1913.1901234567902,1278.4,1662.3864197530863,177.74444444444444,10
439,Pete Nance,Cleveland Cavaliers,F,3,11,1,3,33.3,0,0,0.0,1,1,100.0,0,1,1,0,1,0,0,0,-18,4,4,3,1,5.76,0.30250000000000005,0.0,0.6400000000000001,8.7025,8.7025,5.76,0.30250000000000005,1
440,Peyton Watson,Denver Nuggets,F,66,204,28,55,467.5,6,10,300.0,4,14,183.3,9,32,41,17,20,4,9,18,13,124,107,83,58,131.45679012345678,69.63830221405979,22.480257116620756,4.431996735027038,278.0297928782777,227.7595143352719,146.4757677787981,127.36986021834507,10
441,Precious Achiuwa,New York Knicks,PF,42,163,18,38,363.2,5,7,150.0,1,6,100.0,18,32,50,6,20,3,9,6,-57,98,92,48,56,368.1474435196195,143.08574448407978,15.283921257761925,0.9910159862597439,1084.0713436385254,914.1305324349319,478.4555423437706,218.0023781212842,10
442,Quentin Grimes,Detroit Pistons,SG,82,213,26,80,296.2,19,24,525.0,11,50,200.0,2,27,29,19,13,7,9,4,-12,130,111,101,48,312.44628099173553,35.19834710743802,14.900826446280991,10.900826446280991,442.06611570247935,483.0495867768595,277.6942148760331,43.86776859504132,10
443,Quenton Jackson,Indiana Pacers,G,0,7,0,1,0.0,0,0,0.0,0,0,0.0,0,1,1,2,1,1,0,0,6,3,1,2,3,0.36,0.09000000000000002,1.9599999999999997,0.0,0.25,0.8099999999999998,0.6400000000000001,1.2100000000000002,1
444,R. Rupert,Portland Trail Blazers,G,63,324,22,77,278.6,6,8,300.0,13,42,240.2,10,32,42,31,29,7,15,2,-95,136,105,94,73,101.88495252008767,42.37107377647918,34.70891161431702,13.451059167275384,246.1957633308985,137.58838568298023,177.07231555880205,110.5,10
445,RJ Barrett,Toronto Raptors,SG,244,335,96,172,560.7,39,56,647.3,13,36,325.0,11,50,61,45,26,6,34,5,-65,350,305,289,106,234.80991735537188,71.76400367309458,50.50229568411387,12.17722681359045,532.4499540863177,428.8879706152433,327.46097337006427,133.17722681359047,10
446,RaiQuan Gray,San Antonio Spurs,F,23,36,10,17,118.1,0,0,0.0,3,7,60.0,2,3,5,6,0,1,0,1,18,34,28,29,11,37.23140495867769,12.834710743801653,4.793388429752065,4.834710743801653,71.53719008264464,41.685950413223146,55.1487603305785,29.56198347107438,2
447,Reggie Bullock,Houston Rockets,SF,17,91,6,14,183.3,0,0,0.0,5,12,200.0,0,13,13,3,10,3,2,2,-34,33,30,20,16,112.69974089315653,22.155616521871664,2.1281816796220085,8.820454199055023,208.44185337600976,189.80795610425238,132.0865721688767,23.530864197530867,10
448,Reggie Jackson,Denver Nuggets,PG,91,200,33,91,333.59999999999997,10,11,450.0,15,38,366.6,5,13,18,27,21,3,12,2,4,136,109,118,45,314.9379655137231,27.976124885215796,23.64075094378125,21.38791960004081,541.530864197531,463.0750943781247,378.38240995816756,66.62820120395878,10
449,Richaun Holmes,Washington Wizards,F,88,241,35,62,516.4,18,21,591.7,0,2,0.0,31,52,83,9,31,7,8,8,-2,180,171,97,92,289.8569488456315,267.74694431869625,7.027161611588955,0.004526935264825713,982.0,910.5165233137166,326.7682209144409,309.3463105477592,10
450,Ricky IV Council,Philadelphia 76ers,G,51,103,16,35,424.9,12,17,358.3,7,14,433.3,2,6,8,9,9,6,2,1,33,68,59,60,17,128.9556786703601,8.880886426592799,9.022160664819943,4.125884887657741,229.41828254847647,164.7950138504155,190.77008310249306,20.71191135734072,10
451,Robin Lopez,Milwaukee Bucks,C,6,23,3,9,37.5,0,0,0.0,0,2,0.0,1,0,1,1,3,1,0,2,-16,8,7,7,2,21.92,0.52,0.6800000000000002,0.0,24.48,29.0,18.28,0.32000000000000006,2
452,Royce O'Neale,Phoenix Suns,PF,71,236,25,62,300.0,3,4,150.0,18,49,274.9,7,39,46,19,21,8,7,4,38,136,117,90,65,381.7755102040816,68.55497709287798,25.15993336109954,27.765306122448976,792.0510204081634,631.7269887546855,490.4981257809246,145.31632653061226,10
453,Rudy Gobert,Minnesota Timberwolves,C,155,350,56,80,677.1,43,61,543.4,0,0,0.0,41,92,133,18,31,13,16,19,29,306,288,173,151,321.785246876859,172.1100535395598,13.60053539559786,0.0,694.1478286734086,675.2587745389649,321.46966091612137,204.9152290303391,10
454,Rui Hachimura,Los Angeles Lakers,PF,138,312,54,101,553.9,14,19,500.0,16,36,470.3,10,44,54,15,13,6,6,4,-15,207,192,153,69,574.8479800083298,64.48063306955436,18.76655560183257,10.488129945855892,850.8890045814245,792.0,620.0301957517701,96.9539775093711,10
455,Russell Westbrook,LA Clippers,PG,113,228,44,93,476.3,17,23,575.0,8,20,300.0,13,43,56,48,22,12,29,3,66,217,169,161,104,256.1289940828402,166.09467455621302,142.1325443786982,7.7917159763313615,1032.2094674556213,513.684023668639,509.71005917159766,573.1715976331361,10
456,Ryan Arcidiacono,New York Knicks,G,0,5,0,1,0.0,0,0,0.0,0,1,0.0,0,0,0,0,1,1,0,0,3,0,0,0,0,0.0,0.0625,0.0,0.0,0.0625,0.0625,0.0,0.0625,1
457,Ryan Rollins,Milwaukee Bucks,G,0,7,0,1,0.0,0,0,0.0,0,0,0.0,0,2,2,2,1,0,1,0,0,4,2,2,4,0.81,1.9599999999999997,1.2100000000000002,0.09,2.5600000000000005,0.25,0.03999999999999998,6.25,1
458,Saben Lee,Phoenix Suns,G,35,103,9,28,194.29999999999998,15,20,416.7,2,9,83.3,3,15,18,17,6,4,2,0,6,70,53,52,35,220.85034013605443,38.795918367346935,18.46938775510204,1.7006802721088436,500.3197278911565,421.49659863945584,271.3333333333333,85.60544217687075,9
459,Saddiq Bey,Atlanta Hawks,SF,146,337,48,125,372.4,31,35,800.0,19,59,298.4,29,32,61,14,7,4,10,4,-23,221,207,160,75,398.90000000000003,67.125,9.625,14.9,439.4000000000001,478.32500000000005,362.225,74.5,10
460,Sam Hauser,Boston Celtics,SF,121,249,44,108,465.1,2,2,100.0,31,78,438.5,7,30,37,17,10,8,2,3,112,175,158,138,54,351.448245092207,32.260856632956575,13.963712076145152,27.543426531826295,380.7834622248661,396.90303390838784,320.0336109458656,61.519631171921475,10
461,Sam Merrill,Cleveland Cavaliers,SG,76,196,23,65,254.6,7,8,466.7,23,62,263.4,3,17,20,22,13,2,3,0,-18,118,96,98,42,463.53372856913956,22.057683063611602,33.86252203172569,50.12962666239385,776.2281685627304,640.1028681301074,573.9051434065053,81.67409069059445,10
462,Samardo Samuels,Houston Rockets,F,0,11,0,1,0.0,0,0,0.0,0,0,0.0,1,2,3,1,1,0,0,1,-6,4,3,1,4,1.53125,2.03125,0.6953125,0.0,0.1953125,0.5,1.1328125,2.8203125,2
463,Sandro Mamukelashvili,San Antonio Spurs,PF,108,227,42,82,533.5,13,17,500.0,11,29,276.6,24,63,87,20,13,1,11,4,19,215,195,128,107,396.77800916284883,175.13660974593915,14.203248646397332,13.82465639316951,755.4539775093712,690.3469387755102,401.81840899625155,249.4064972927947,10
464,Santi Aldama,Memphis Grizzlies,PF,116,316,42,90,459.2,13,20,450.0,19,52,309.5,11,56,67,23,14,10,7,16,-91,206,183,139,90,464.97257653061223,94.125,18.288903061224488,31.887755102040817,898.1326530612246,764.936862244898,555.9005102040816,154.68176020408163,10
465,Sasha Vezenkov,Sacramento Kings,F,40,103,13,37,238.9,5,5,200.0,9,26,251.2,2,11,13,5,11,6,1,0,25,58,53,45,18,89.22265625,4.265625,4.2900390625,10.4306640625,145.9228515625,105.03515625,128.4462890625,10.2197265625,9
466,Scoot Henderson,Portland Trail Blazers,G,186,351,70,168,416.2,22,28,706.7,24,63,380.7,8,27,35,84,34,12,55,2,-154,305,221,270,119,249.89269928364575,44.56439567139156,124.44444444444443,26.271604938271608,487.6063100137175,297.43347050754454,456.8474317939339,152.2269471117208,10
467,Scottie Barnes,Toronto Raptors,SF,179,333,70,155,460.1,33,39,674.9,6,36,159.89999999999998,28,63,91,75,18,13,31,14,21,345,270,254,166,391.6640625,102.8515625,85.6640625,4.8515625,827.2890625,587.40625,576.65625,243.40625,10
468,Scotty Pippen Jr.,Memphis Grizzlies,G,143,269,57,118,445.1,17,20,585.7,12,39,267.9,11,20,31,46,32,22,30,5,-52,220,174,189,77,595.8697978596908,32.923305588585016,34.46848989298454,12.133769322235434,1017.0439952437574,778.5992865636148,805.4346016646849,96.2717003567182,10
469,Seth Curry,Charlotte Hornets,SG,81,181,29,67,372.5,14,15,566.7,9,31,256.6,4,15,19,17,7,5,7,3,-33,117,100,98,36,233.0,12.900826446280993,16.140495867768593,4.900826446280991,334.3388429752066,276.08264462809916,269.8677685950413,50.429752066115704,10
470,Shai Gilgeous-Alexander,Oklahoma City Thunder,PG,243,319,87,182,476.5,60,69,882.4,9,40,238.3,7,40,47,48,20,13,23,5,87,338,290,291,95,676.1111495844875,50.74549861495845,41.79085872576177,9.70775623268698,1076.5872576177285,946.2063711911358,784.8673822714684,114.16101108033241,10
471,Shake Milton,New York Knicks,SG,49,126,21,46,431.1,2,3,66.7,5,12,250.0,9,19,28,15,12,4,5,2,-6,92,77,64,43,168.13609467455623,82.63017751479289,18.28994082840237,8.869822485207102,562.7485207100592,440.9378698224852,242.85207100591717,148.0147928994083,10
472,Sidy Cissoko,San Antonio Spurs,G,39,109,15,27,241.3,8,11,221.4,1,8,33.3,8,8,16,10,16,4,2,3,10,65,55,49,26,156.3194706994329,17.546313799621927,21.4593572778828,0.833648393194707,385.79773156899813,270.70132325141776,242.42155009451795,68.0,6
473,Simone Fontecchio,Detroit Pistons,F,158,307,55,116,455.5,19,21,616.7,29,65,413.2,8,41,49,16,20,10,13,5,5,223,207,174,65,506.0,36.90963139120095,14.430439952437576,30.11296076099881,589.4708680142687,547.3923900118907,538.8442330558859,60.574316290130795,10
474,Skylar Mays,Los Angeles Lakers,SG,8,34,4,10,170.0,0,0,0.0,0,3,0.0,0,1,1,3,2,3,2,1,-3,12,9,11,4,17.18273645546373,0.8163452708907254,3.257116620752984,0.0,18.0,19.56014692378329,16.755739210284663,2.9403122130394856,4
475,Spencer Dinwiddie,Los Angeles Lakers,PG,59,189,16,38,279.2,15,15,500.0,12,28,270.0,1,19,20,16,13,6,6,3,-1,95,79,75,36,332.9646267361111,20.017361111111114,40.40625,17.704210069444443,697.728515625,469.744140625,529.5948350694445,91.77777777777777,10
476,Stanley Umude,Detroit Pistons,G,49,150,16,39,260.4,8,9,366.7,9,25,243.3,5,16,21,3,15,4,4,2,-32,73,70,52,24,177.08,44.0,1.9200000000000002,10.88,278.68,272.78,180.88,48.02,8
477,Stephen Curry,Golden State Warriors,PG,243,334,85,184,483.1,28,30,858.3,45,101,477.59999999999997,2,45,47,63,13,8,31,7,54,353,290,306,110,387.3309897241752,48.229853975121685,56.877501352082206,28.804218496484587,340.1019469983775,337.0091941590049,370.5,125.03109789075177,10
478,Svi Mykhailiuk,Boston Celtics,SG,71,149,25,47,692.1,3,3,200.0,18,35,593.2,3,14,17,14,7,1,3,0,98,102,88,85,31,371.36944444444447,14.144444444444446,16.40277777777778,26.225,627.3777777777777,489.82500000000005,498.5444444444444,40.925,10
479,T. Vukcevic,Washington Wizards,PF,85,143,29,65,303.7,17,22,427.8,10,35,215.3,6,26,32,13,27,4,9,6,29,130,117,98,45,371.53739612188366,62.60941828254847,13.550554016620497,7.517313019390581,640.7804709141274,532.8060941828254,431.75,123.92174515235456,7
480,T.J. McConnell,Indiana Pacers,PG,138,195,64,113,559.7,5,5,300.0,5,11,275.0,4,23,27,58,15,5,14,1,50,223,165,196,85,231.30109834616843,18.16727685898245,68.17927029415478,8.502840550435552,414.18873879560664,221.50700669107437,384.34970332028786,125.97967428355007,10
481,T.J. Warren,Minnesota Timberwolves,SF,37,119,16,39,361.2,3,4,150.0,2,13,83.3,5,16,21,7,11,3,4,1,45,65,58,44,28,77.13791238507301,20.88209843158464,7.56571119524067,1.6170903190914006,127.53812871822608,137.0400216333153,63.96051919956733,32.123309897241754,9
482,Taj Gibson,Detroit Pistons,F,18,40,8,14,216.7,0,0,0.0,2,4,100.0,2,7,9,2,3,1,0,1,-5,29,27,20,11,28.78116343490305,12.905817174515235,3.0027700831024937,1.0692520775623269,90.5567867036011,62.88919667590027,45.49030470914127,26.867036011080327,4
483,Taj Gibson,New York Knicks,F,2,68,0,9,0.0,2,2,100.0,0,2,0.0,4,6,10,4,8,1,3,0,2,16,12,6,14,39.79224376731302,10.013850415512465,1.1745152354570638,0.6786703601108033,45.65650969529086,47.229916897506925,34.362880886426595,15.044321329639889,5
484,Talen Horton-Tucker,Utah Jazz,SG,109,209,39,102,368.0,16,19,538.1,15,44,351.6,1,17,18,22,19,9,10,4,-48,149,127,131,40,409.8,21.616,36.084,11.076,629.716,557.976,470.564,68.676,10
485,Taurean Prince,Los Angeles Lakers,PF,80,213,29,63,461.9,6,6,300.0,16,34,496.6,5,31,36,10,11,7,10,4,24,126,116,90,46,168.2601456815817,32.397502601456814,22.018499248468032,14.511041738929356,268.2314718464562,218.61810613943808,198.41738929355995,73.87212394496473,10
486,Taylor Hendricks,Utah Jazz,F,98,267,36,72,505.0,5,7,216.7,21,41,540.0,11,39,50,15,16,11,7,7,-47,163,148,113,65,284.2560553633218,59.88788927335639,12.883737024221453,14.273356401384081,333.0927335640138,319.63460207612457,293.80276816609,76.68304498269896,10
487,Taze Moore,Portland Trail Blazers,G,14,35,6,15,135.7,1,2,50.0,1,5,20.0,4,4,8,5,2,1,3,0,-20,27,22,19,13,58.0,34.0,6.03125,0.53125,250.53125,180.0,101.03125,67.53125,2
488,Terance Mann,LA Clippers,SG,113,236,46,70,645.5,12,14,525.0,9,18,466.6,15,28,43,12,23,6,10,0,17,168,156,125,55,468.7641407705127,91.9048132536026,7.632977159102048,9.257621801784138,920.947162042937,825.6086658170767,544.0110773453583,119.62935006371924,10
489,Terquavion Smith,Philadelphia 76ers,G,46,71,16,40,307.8,3,5,150.0,11,30,266.6,0,4,4,11,6,8,6,0,1,61,50,57,15,246.0,2.040816326530612,20.882086167800455,21.88888888888889,260.24263038548753,237.18367346938774,271.3582766439909,20.62358276643991,8
490,Terry Rozier,Miami Heat,SG,188,305,68,150,442.8,15,16,466.7,37,74,449.4,2,29,31,31,14,12,12,3,40,250,219,219,62,683.6591836734694,25.0,25.765306122448976,77.26122448979592,794.9469387755103,827.7163265306122,646.1755102040817,55.479591836734706,10
491,Terry Taylor,Chicago Bulls,F,15,56,5,10,325.0,3,4,150.0,2,3,150.0,4,10,14,3,1,2,0,0,-15,32,29,18,17,20.88823959094229,35.125639152666174,3.509130752373996,1.7983929875821767,117.36084733382029,97.06866325785245,26.967129291453613,52.848064280496715,5
492,Thaddeus Young,Phoenix Suns,F,21,83,10,19,325.0,1,3,100.0,0,1,0.0,16,10,26,6,11,5,4,0,0,53,47,27,32,34.169382716049384,71.5679012345679,7.164444444444444,0.0,149.1664197530864,133.7767901234568,44.877530864197524,83.41382716049381,7
493,Thaddeus Young,Phoenix Suns,PF,13,49,6,8,241.7,1,2,50.0,0,1,0.0,5,10,15,6,3,2,1,1,-11,34,28,19,21,11.317037037037036,32.81481481481482,10.613333333333335,0.0,125.37925925925923,69.98370370370371,42.26814814814815,67.87259259259258,3
494,Thanasis Antetokounmpo,Milwaukee Bucks,SF,16,62,8,15,416.7,0,2,0.0,0,1,0.0,2,1,3,6,8,3,4,1,-16,25,19,22,9,24.492194674012854,1.8760330578512396,1.834710743801653,0.0,31.299357208448118,26.55555555555556,29.69880624426079,3.2479338842975203,8
495,Theo Maledon,Phoenix Suns,PG,5,10,1,2,50.0,3,3,100.0,0,0,0.0,0,1,1,0,3,0,3,0,-11,6,6,5,1,14.0625,0.5625,0.0,0.0,20.25,20.25,14.0625,0.5625,1
496,Thomas Bryant,Miami Heat,C,94,144,35,60,528.3,20,21,775.0,4,14,233.3,12,42,54,7,17,4,6,8,58,155,148,101,61,495.69012911286967,98.86797167846731,8.122032486463974,4.401499375260308,942.3744273219493,874.9121199500208,558.5493544356518,111.59308621407747,10
497,Tim Hardaway Jr.,Dallas Mavericks,SF,70,194,26,73,333.5,6,8,200.0,12,47,252.5,1,21,22,17,10,5,6,0,-49,109,92,87,39,221.60004340277777,11.777777777777777,14.2265625,8.978515625,362.58962673611114,321.30837673611114,260.6312934027777,28.25434027777778,10
498,Tobias Harris,Philadelphia 76ers,PF,150,339,56,119,468.7,19,22,700.0,19,45,371.9,18,65,83,29,20,5,11,12,43,262,233,179,112,254.5881117412308,35.7523629489603,6.978155849611426,25.588111741230833,226.73051879857172,221.90317160260452,247.74690191136312,54.399075824406644,10
499,Tony Allen,Memphis Grizzlies,F,13,124,6,23,125.0,1,2,50.0,0,7,0.0,4,13,17,5,18,4,2,0,-65,35,30,18,22,15.335640138408305,15.211072664359861,2.0,0.0,54.06920415224913,40.06920415224913,25.335640138408305,21.21107266435986,5
500,Torrey Craig,Chicago Bulls,SF,31,145,11,28,297.0,2,3,150.0,7,16,315.0,10,26,36,7,14,6,5,3,6,74,67,38,43,148.34176085663296,168.15377751338488,9.680547293277812,12.202558001189768,625.7549077929802,498.9559785841761,219.57198096371206,233.40303390838787,10
501,Tosan Evbuomwan,Detroit Pistons,F,84,276,29,53,552.3,17,25,508.4,9,23,390.0,10,34,44,10,17,5,8,4,-96,138,128,94,54,125.78092461474385,43.12952936276552,10.066638900458145,7.008329862557268,264.558100791337,237.48604748021654,150.0,56.04914618908788,10
502,Toumani Camara,Portland Trail Blazers,F,88,292,35,67,507.2,8,9,350.0,10,26,336.6,19,23,42,22,26,8,13,8,-36,152,130,110,64,287.70000000000005,51.93611111111112,28.402777777777775,8.002777777777778,547.7,471.46944444444443,351.46944444444443,92.8,10
503,Trae Young,Atlanta Hawks,PG,184,337,54,139,430.3,52,64,834.7,24,76,367.6,3,24,27,101,17,6,46,1,-75,312,211,285,128,552.625,10.90277777777778,48.5,11.625,598.2777777777777,457.4444444444445,703.125,49.73611111111111,10
504,Trayce JacksonDavis,Golden State Warriors,F,92,226,39,57,710.6,14,23,360.0,0,0,0.0,23,41,64,16,12,6,13,14,-21,172,156,108,80,260.68431001890355,112.5,22.401701323251416,0.0,520.0,409.01039697542535,350.5,156.07561436672967,10
505,Tre Jones,San Antonio Spurs,PG,115,337,48,103,441.5,7,11,258.3,12,37,291.7,11,49,60,70,13,11,21,2,44,245,175,185,130,135.34802560077287,81.97029344282092,62.53254437869822,9.600048303345007,366.3877551020408,228.67854123898078,187.22461055428087,230.33546673107114,10
506,Tre Mann,Charlotte Hornets,PG,113,312,41,93,454.59999999999997,18,22,588.3,13,38,366.7,4,32,36,53,12,20,27,3,-56,202,149,166,89,225.3860345169609,12.136480856972826,26.143820670501885,14.127157310057529,385.24261059313625,250.93056933148182,354.48879190636774,43.48958539972227,10
507,Trendon Watford,Brooklyn Nets,PF,120,253,45,87,520.9,22,33,493.8,8,20,290.0,8,47,55,21,24,6,23,6,-71,196,175,141,76,327.8986676674798,149.12122349408895,29.498780258960405,5.732407581159692,829.4133983861888,692.4756990054418,376.3507224620004,267.10564833927566,10
508,Trent Forrest,Atlanta Hawks,G,24,126,11,28,366.6,2,3,100.0,0,3,0.0,5,12,17,35,2,4,8,1,-25,76,41,59,52,30.69559864573715,12.694675284702985,66.63004001231148,0.0,151.2071406586642,30.62880886426593,137.7177593105571,92.8808864265928,10
509,Trevelin Queen,Orlando Magic,SG,0,13,0,3,0.0,0,0,0.0,0,2,0.0,0,1,1,1,1,0,0,0,-17,2,1,1,2,0.0,0.5918367346938775,0.7551020408163267,0.0,0.04081632653061227,0.5918367346938775,0.7551020408163267,0.04081632653061227,2
510,Trey Jemison,Memphis Grizzlies,C,71,282,31,64,450.5,9,10,450.0,0,0,0.0,34,38,72,16,26,6,15,13,-71,159,143,87,88,224.11296076099882,100.15933412604042,11.239001189060643,0.0,506.2889417360286,490.71462544589775,208.13436385255648,142.95124851367422,10
511,Trey Lyles,Sacramento Kings,PF,66,204,24,58,366.4,5,7,250.0,13,37,347.5,14,31,45,16,10,5,7,4,57,127,111,82,61,227.1353059465671,78.87991956334386,22.557311117494972,6.297902901465095,539.4527434645217,397.3326630278656,350.76644642344155,119.92617064062051,10
512,Trey Murphy III,New Orleans Pelicans,SG,179,387,61,125,486.1,22,23,587.5,35,86,392.0,9,48,57,29,18,11,10,6,30,265,236,208,86,547.1961908284023,39.5207100591716,17.29234467455621,31.9792899408284,800.4918639053255,708.15625,611.625,84.71985946745562,10
513,Tristan Thompson,Cleveland Cavaliers,C,24,89,11,22,301.3,2,8,100.0,0,0,0.0,14,17,31,9,8,3,4,3,-42,64,55,33,40,60.53550295857988,31.3491124260355,3.414201183431952,0.0,124.60355029585799,130.4319526627219,53.70414201183432,35.76627218934911,8
514,Troy Brown Jr.,Detroit Pistons,SF,45,244,16,57,221.7,5,6,250.0,8,27,170.8,7,31,38,13,8,15,6,1,-54,96,83,58,51,177.14437869822487,22.852071005917157,14.313609467455622,21.685207100591715,234.0828402366864,187.79289940828403,197.2,63.400000000000006,10
515,TyTy Washington Jr.,Milwaukee Bucks,G,11,38,5,13,145.0,0,0,0.0,1,4,100.0,1,2,3,5,1,1,0,0,-2,19,14,16,8,25.0,2.8125,4.7569444444444455,0.7777777777777779,42.111111111111114,28.5625,41.340277777777786,4.777777777777778,4
516,Tyler Herro,Miami Heat,PG,209,344,69,156,447.0,39,42,825.0,32,82,399.5,2,49,51,65,17,3,31,0,85,325,260,274,116,361.93347755543545,42.90914007571661,123.81449432125474,18.098431584640345,704.1714440237967,448.03677663601945,598.4845862628447,186.30719307733915,10
517,Tyrese Haliburton,Indiana Pacers,PG,174,332,61,126,478.5,25,30,686.7,27,74,345.9,3,42,45,98,15,14,21,9,104,317,219,272,143,560.0547520661157,38.081869834710744,70.75129132231406,20.64798553719008,580.5495867768595,658.9455061983471,517.1934400826447,73.29855371900825,10
518,Tyrese Maxey,Philadelphia 76ers,PG,279,408,104,222,457.6,41,45,833.3,30,91,323.3,3,40,43,68,18,7,20,6,72,390,322,347,111,1425.396090370133,85.30155423810285,96.18554718795065,22.129786893126102,2245.5007210382955,1899.498798269508,1649.7123858356035,303.1727287293703,10
519,Tyus Jones,Washington Wizards,PG,91,313,36,84,402.0,4,4,300.0,15,43,360.8,3,22,25,97,4,9,13,2,-70,213,116,188,122,345.04336734693874,43.53316326530612,160.5,20.959183673469386,776.265306122449,542.0510204081633,542.9719387755102,240.3188775510204,10
520,Udoka Azubuike,Phoenix Suns,C,2,11,1,3,33.3,0,2,0.0,0,0,0.0,2,4,6,0,1,0,0,0,-3,8,8,2,6,3.305785123966942,28.76859504132231,0.0,0.0,51.578512396694215,51.578512396694215,3.305785123966942,28.76859504132231,1
521,Usman Garuba,Golden State Warriors,PF,1,5,0,1,0.0,1,2,50.0,0,0,0.0,0,4,4,0,0,0,0,2,7,5,5,1,4,0.01777777777777777,5.444444444444443,0.017777777777777778,0.0,5.4444444444444455,6.084444444444445,0.0,4.840000000000001,1
522,Vasilije Micic,Charlotte Hornets,G,91,279,33,88,344.9,13,17,425.0,12,42,264.0,3,19,22,77,19,9,23,1,-74,190,113,168,99,231.96490946963627,22.29322224002564,138.8881589488864,11.724082679057842,671.192757570902,284.3190193879186,567.0200288415318,213.0,10
523,Victor Wembanyama,San Antonio Spurs,C,260,332,92,197,488.0,49,65,697.5,27,81,334.3,26,96,122,61,17,11,48,41,0,443,382,321,183,805.7886259040105,225.92373438527287,27.801775147928993,29.36949375410914,1775.4378698224855,1668.0621301775147,851.5548980933596,315.3349769888232,10
524,Vince Williams Jr.,Memphis Grizzlies,G,127,336,42,92,459.70000000000005,30,38,723.3,13,34,328.8,8,54,62,61,30,12,34,9,-54,250,189,188,123,231.93628808864267,72.8808864265928,35.61495844875347,18.00831024930748,492.2326869806094,474.07479224376726,226.76454293628805,131.82548476454295,10
525,Vit Krejci,Atlanta Hawks,G,63,237,24,45,483.7,1,1,100.0,14,30,320.8,4,21,25,19,23,6,8,0,-32,107,88,82,44,429.33664852692823,28.579283167573653,8.857759429536499,32.42709701632577,577.2045411897167,530.4308500656784,474.32238693938825,39.224995308688314,10
526,Walker Kessler,Utah Jazz,C,72,234,31,42,737.5,10,12,500.0,0,0,0.0,22,52,74,12,20,3,11,12,-77,158,146,84,86,107.6064272961714,126.54671692124577,7.620313429875025,0.0,303.70283673874235,272.61456060305494,118.40388811743702,154.45784566554255,10
527,Wendell Carter Jr.,Orlando Magic,C,102,241,36,77,490.7,14,19,382.1,16,44,427.5,20,50,70,19,28,9,11,4,23,191,172,121,89,185.94344008264463,160.25309917355372,24.91012396694215,10.549586776859503,860.6376549586777,655.7368285123966,292.9455061983471,283.06198347107437,10
528,Wendell Moore Jr.,Minnesota Timberwolves,G,8,18,4,5,250.0,0,0,0.0,0,0,0.0,0,7,7,2,2,0,1,0,20,17,15,10,9,15.289940828402367,10.75,3.012943786982249,0.0,58.20229289940828,47.270710059171606,19.817677514792898,20.1667899408284,3
529,Wenyen Gabriel,Memphis Grizzlies,F,17,81,8,22,168.3,0,5,0.0,1,6,50.0,7,18,25,3,10,2,8,2,-16,45,42,20,28,59.72702331961591,43.6159122085048,4.060356652949245,0.879286694101509,182.2098765432099,171.6858710562414,60.574759945130324,57.352537722908096,5
530,Wesley Matthews,Atlanta Hawks,SG,40,134,14,36,376.1,2,2,100.0,10,24,370.0,5,12,17,9,12,6,2,3,-19,66,57,49,26,66.4099173553719,32.14049586776859,13.08595041322314,6.211570247933885,127.24628099173555,127.92561983471074,64.15702479338843,46.8,10
531,Xavier Moon,LA Clippers,G,24,90,11,37,145.6,0,0,0.0,2,14,22.2,6,8,14,14,5,3,2,2,-24,52,38,38,28,155.73828125,31.467013888888893,39.252170138888886,3.578125,545.828125,308.3980034722223,328.5555555555555,135.33203125,5
532,Xavier Tillman,Boston Celtics,F,44,114,19,37,492.7,1,3,50.0,5,14,223.3,4,16,20,12,6,4,2,4,4,76,64,56,32,112.837890625,28.7265625,3.83447265625,4.69775390625,182.41650390625,178.775390625,116.58447265625,32.45556640625,10
533,Yuta Watanabe,Memphis Grizzlies,SF,22,97,10,24,250.0,0,2,0.0,2,12,64.3,0,11,11,5,6,5,4,0,-36,38,33,27,16,115.08000000000001,11.27,3.75,1.4800000000000004,136.28,131.43,116.23000000000002,18.72,7
534,Zach Collins,San Antonio Spurs,PF,114,187,43,88,456.5,19,23,716.7,9,23,290.0,17,42,59,27,22,3,14,9,-6,200,173,141,86,321.0830498866213,75.76530612244899,15.444444444444443,7.339002267573696,551.890306122449,622.3109410430839,287.1862244897959,54.685941043083886,10
535,Zavier Simpson,Memphis Grizzlies,G,42,162,17,54,192.7,3,4,75.0,5,17,108.3,4,16,20,25,11,7,10,3,-29,87,62,67,45,176.17919999999998,38.88,5.7472,9.48,301.92,250.93120000000002,214.08,57.7152,7
536,Zeke Nnaji,Denver Nuggets,PF,32,114,14,20,576.7,3,7,150.0,1,1,100.0,6,16,22,6,14,3,0,7,-1,60,54,38,28,48.019274376417236,28.23696145124717,6.408163265306122,0.9002267573696145,137.83673469387756,130.48979591836735,45.91043083900227,44.100907029478456,10
537,Ziaire Williams,Memphis Grizzlies,F,103,270,39,94,389.0,13,16,421.4,12,46,213.7,6,38,44,20,15,12,15,0,-39,167,147,123,64,552.1,32.4,24.0,17.599999999999998,788.1,632.1,714.1,50.4,10
538,Zion Williamson,New Orleans Pelicans,PF,258,350,98,194,496.0,61,89,687.5,1,5,50.0,17,44,61,48,21,18,31,11,0,367,319,306,109,593.2396694214876,100.94963842975207,31.80501033057851,0.9297520661157026,824.0010330578513,819.2058367768595,565.4331095041323,165.35640495867767,10
