,First Last Name,team,position,points,minutes,fgm,fga,fgp,ftm,fta,ftp,tpm,tpa,tpp,offReb,defReb,totReb,assists,pFouls,steals,turnovers,blocks,plusMinus,Points_Rebounds_Assist,Points_Rebounds,Points_Assist,Rebounds_Assist,points_deviation,totReb_deviation,assists_deviation,tpm_deviation,Points_Rebounds_Assist_deviation,Points_Rebounds_deviation,Points_Assist_deviation,Rebounds_Assist_deviation,count
0,A. Flagler,Oklahoma City Thunder,F,0,6,0,3,0.0,0,0,0.0,0,3,0.0,0,0,0,1,0,0,0,0,0,1,0,1,1,0.0,0.0,0.0,0.0,0.0,0.0,0.0,0.0,1
1,A.J. Green,Milwaukee Bucks,G,51,144,16,40,410.1,7,8,266.7,12,32,367.9,1,14,15,7,9,3,4,0,-7,73,66,58,22,170.27777777777777,17.044444444444444,9.0,10.5,282.1,279.3,173.47777777777776,25.644444444444446,10
2,A.J. Lawson,Dallas Mavericks,G,20,42,8,21,223.3,2,6,100.0,2,8,100.0,2,6,8,3,5,1,0,1,-5,31,28,23,11,34.239999999999995,6.56,1.826666666666667,1.5733333333333335,50.36,44.373333333333335,38.17333333333333,10.44,6
3,Aaron Gordon,Denver Nuggets,PF,131,315,53,92,646.3,21,29,621.7,4,17,133.3,21,43,64,37,23,7,16,2,16,232,195,168,101,201.15224913494808,108.67128027681662,42.11245674740484,2.403114186851211,342.43079584775086,461.5467128027682,129.75259515570934,103.0674740484429,10
4,Aaron Holiday,Houston Rockets,G,29,104,11,36,213.2,4,4,200.0,3,17,86.7,0,6,6,17,15,5,2,1,3,52,35,46,23,174.03806228373702,3.773356401384083,30.370242214532873,6.541522491349481,294.4584775086505,206.5,262.8650519031142,33.27508650519031,10
5,Aaron Nesmith,Indiana Pacers,SF,110,288,35,84,417.8,24,26,825.0,16,43,381.3,5,26,31,16,33,5,6,9,43,157,141,126,47,230.10405827263264,35.06867845993756,10.0,12.520291363163372,409.47242455775233,391.53694068678465,237.7169614984391,55.391259105098854,10
6,Aaron Wiggins,Oklahoma City Thunder,SG,53,150,22,41,553.0,4,6,200.0,5,14,200.0,8,12,20,10,6,7,9,6,-11,83,73,63,30,104.5,8.069444444444445,8.007716049382715,8.012345679012345,109.86419753086419,114.56944444444446,107.84104938271605,8.030864197530864,10
7,Admiral Schofield,Orlando Magic,SF,5,6,2,3,66.7,0,0,0.0,1,1,100.0,0,1,1,0,1,1,0,0,-7,6,6,5,1,13.071005917159763,0.02366863905325444,0.00591715976331361,0.4792899408284023,13.633136094674558,14.207100591715976,12.520710059171597,0.0059171597633136015,1
8,Al Horford,Boston Celtics,C,102,265,39,69,588.5,6,6,300.0,18,40,439.3,12,41,53,24,17,9,7,8,96,179,155,126,77,307.60493827160496,66.10013717421124,22.419753086419753,27.602194787379972,418.9396433470508,330.5034293552812,390.44444444444446,94.11659807956104,10
9,Alec Burks,New York Knicks,SG,57,125,20,68,259.9,9,12,375.0,8,34,220.79999999999998,4,11,15,9,2,2,3,1,-11,81,72,66,24,217.82871972318338,10.686851211072662,3.5103806228373697,8.096885813148791,349.7456747404845,296.5121107266435,260.86505190311414,24.394463667820066,10
10,Aleksej Pokusevski,Charlotte Hornets,F,30,111,12,32,275.8,3,3,200.0,3,11,183.3,5,16,21,11,6,6,7,5,-8,62,51,41,32,34.907407407407405,15.518518518518517,6.907407407407407,1.5,81.18518518518518,62.68518518518518,44.33333333333333,31.500000000000004,6
11,Aleksej Pokusevski,Oklahoma City Thunder,F,6,18,2,5,100.0,1,2,50.0,1,3,100.0,0,2,2,0,0,1,0,0,-12,8,8,6,2,28.453703703703695,23.814814814814817,8.898148148148149,0.75,164.37037037037038,99.78703703703704,64.33333333333333,61.41666666666667,3
12,Alex Caruso,Chicago Bulls,SG,103,311,37,86,407.1,7,13,275.0,22,54,392.0,5,35,40,46,26,23,13,8,-14,189,143,149,86,409.8099173553719,24.44995408631772,33.111111111111114,27.88797061524334,621.9752066115702,510.8438934802571,530.0725436179982,48.429752066115704,10
13,Alex Len,Sacramento Kings,C,33,93,13,21,566.7,7,10,275.0,0,0,0.0,5,16,21,10,16,2,4,8,33,64,54,43,31,52.36266349583829,15.466111771700357,14.760998810939359,0.0,112.96789536266348,68.0,88.01783590963139,39.539833531510105,10
14,Alondes Williams,Miami Heat,G,0,6,0,1,0.0,0,0,0.0,0,1,0.0,0,1,1,0,0,0,1,0,-2,1,1,0,1,0.0,0.25,0.0,0.0,0.25,0.25,0.0,0.25,1
15,Alperen Sengun,Houston Rockets,C,209,324,81,157,512.7,43,68,622.9,4,12,200.0,39,68,107,45,36,16,26,7,2,361,316,254,152,847.1723356009071,197.81632653061226,123.77551020408163,4.408163265306122,1935.0226757369614,1622.4580498866212,993.7777777777778,487.5510204081633,10
16,Amari Bailey,Charlotte Hornets,G,2,6,1,3,33.3,0,0,0.0,0,2,0.0,0,0,0,1,0,1,0,0,7,3,2,3,1,1.3061224489795917,0.0,0.18367346938775514,0.0,2.4693877551020407,1.3061224489795917,2.4693877551020407,0.18367346938775514,1
17,Amen Thompson,Houston Rockets,F,115,223,48,73,577.7,18,23,588.1,1,4,100.0,21,43,64,17,25,15,10,8,83,196,179,132,81,627.7020408163265,85.20816326530613,22.608163265306125,0.9020408163265305,1249.9510204081632,1090.9183673469388,739.9183673469388,154.63265306122446,10
18,Amir Coffey,LA Clippers,SG,62,224,24,60,322.0,3,3,200.0,11,33,216.7,2,28,30,13,13,6,7,2,-35,105,92,75,43,250.3655489809336,75.47928994082841,16.111111111111114,19.231426692965158,608.3754109138724,450.76002629848784,372.2373438527285,127.33399079552926,10
19,Andre Drummond,Chicago Bulls,C,71,153,25,55,379.3,21,35,604.2,0,0,0.0,28,49,77,3,21,2,8,2,2,151,148,74,80,315.6040816326531,72.03673469387756,2.3469387755102042,0.0,601.8163265306122,556.465306122449,349.9020408163266,85.43673469387758,10
20,Andre Jr. Jackson,Milwaukee Bucks,G,10,69,4,9,333.3,0,0,0.0,2,5,200.0,3,9,12,10,6,3,3,0,-10,32,22,20,22,11.420118343195266,8.272189349112427,8.0,1.5266272189349113,40.35502958579881,32.04733727810651,16.804733727810646,19.19526627218935,6
21,Andrew Nembhard,Indiana Pacers,PG,79,279,32,68,486.59999999999997,4,5,100.0,11,34,373.3,5,18,23,32,23,10,12,1,-10,134,102,111,55,142.77959183673465,34.68979591836735,22.0,4.918367346938775,280.64489795918365,179.6734693877551,250.8367346938775,49.60408163265306,10
22,Andrew Wiggins,Golden State Warriors,SF,128,255,48,101,468.6,16,20,500.0,16,37,408.3,17,31,48,19,13,6,7,4,14,195,176,147,67,298.961937716263,75.34256055363322,13.399653979238753,10.422145328719724,557.6003460207612,531.6262975778548,344.07093425605535,69.60726643598616,10
23,Anfernee Simons,Portland Trail Blazers,SG,261,384,89,194,463.5,42,46,842.8,41,99,424.8,5,39,44,65,20,6,34,1,-15,370,305,326,109,475.4498269896194,21.56401384083045,124.5,9.835640138408305,1130.8321799307957,599.3321799307957,974.9498269896194,178.06401384083046,10
24,Anthony Black,Orlando Magic,G,52,211,18,53,347.4,7,12,250.0,9,23,308.3,8,22,30,10,15,7,9,2,30,92,82,62,40,128.26063100137173,63.94787379972565,6.877914951989026,10.355281207133057,325.70096021947876,272.73799725651577,172.44444444444446,79.60493827160494,10
25,Anthony Davis,Los Angeles Lakers,PF,216,344,80,151,528.3,54,65,824.9,2,8,100.0,29,99,128,36,20,15,14,22,33,380,344,252,164,645.1735537190083,272.23140495867773,18.611570247933884,1.8677685950413223,1651.6528925619834,1431.6528925619834,772.595041322314,383.42148760330576,10
26,Anthony Edwards,Minnesota Timberwolves,SG,269,360,103,224,442.2,41,51,792.3,22,70,320.6,9,53,62,48,16,16,26,11,12,379,331,317,110,1021.6705624543463,48.27319211102995,53.265157048940836,23.57487216946676,1560.4872169466767,1373.344777209642,1156.8714390065743,153.4799123447772,10
27,Anthony Gill,Washington Wizards,PF,30,73,12,27,234.4,2,2,100.0,4,10,191.7,7,10,17,9,7,4,7,0,-2,56,47,39,26,180.16666666666666,44.06,15.426666666666664,3.7600000000000007,484.6400000000001,377.56000000000006,261.26,85.47333333333333,6
28,Ashton Hagans,Portland Trail Blazers,G,47,181,17,39,452.7,8,11,350.0,5,11,166.7,8,21,29,32,25,7,19,7,8,108,76,79,61,130.2265625,18.90625,51.625,6.8515625,392.9140625,216.4765625,286.0390625,91.15625,10
29,Ausar Thompson,Detroit Pistons,F,103,314,42,87,508.0,11,25,325.0,8,29,195.3,15,44,59,21,26,17,14,11,-6,183,162,124,80,121.7,31.399999999999995,24.125,8.5,347.72499999999997,237.7,200.02499999999998,87.225,10
30,Austin Reaves,Los Angeles Lakers,SG,166,349,63,121,528.4,14,17,600.0,26,59,382.6,5,47,52,56,15,6,21,2,15,274,218,222,108,232.40816326530614,38.77551020408163,95.21632653061226,40.69387755102041,371.20816326530615,263.3877551020408,384.5877551020408,89.63265306122449,10
31,Ayo Dosunmu,Chicago Bulls,SG,163,374,64,136,447.5,16,18,558.3,19,56,328.3,8,26,34,62,24,7,18,6,-53,259,197,225,96,659.873469387755,37.061224489795926,52.261224489795914,11.693877551020407,730.8367346938776,585.2938775510205,831.6938775510204,63.04489795918368,10
32,Bam Adebayo,Miami Heat,C,177,341,73,139,522.3000000000001,26,42,633.3,5,7,400.0,28,81,109,32,20,12,14,8,-34,318,286,209,141,258.7560553633218,123.24048442906575,21.10726643598616,4.5,371.5086505190312,360.38754325259515,252.3615916955017,161.86332179930795,10
33,Ben Sheppard,Indiana Pacers,G,64,200,24,56,412.5,4,4,200.0,12,40,279.6,2,19,21,8,19,5,2,1,36,93,85,72,29,148.0,42.353515625,9.884765625,17.884765625,289.8515625,258.603515625,188.134765625,43.3515625,10
34,Ben Simmons,Brooklyn Nets,PG,53,168,24,38,521.1,5,11,150.0,0,0,0.0,15,39,54,46,20,9,12,4,-5,153,107,99,100,134.88888888888889,64.0,78.88888888888889,0.0,382.0,162.8888888888889,300.0,196.88888888888889,9
35,Bennedict Mathurin,Indiana Pacers,SG,139,275,44,115,340.3,35,45,614.5,16,44,245.0,10,33,43,23,24,7,17,4,-18,205,182,162,66,753.4765625,123.6015625,38.125,30.4140625,1418.90625,1097.65625,970.9140625,265.5390625,10
36,Bilal Coulibaly,Washington Wizards,SG,90,289,30,76,451.5,19,27,633.3,11,39,238.3,9,30,39,18,22,12,8,7,-98,147,129,108,57,130.15816857440166,39.59729448491155,16.0,13.170655567117585,346.42767950052036,299.1373569198751,169.77107180020812,63.274713839750255,10
37,Bismack Biyombo,Oklahoma City Thunder,C,4,31,1,4,33.3,2,2,100.0,0,0,0.0,3,2,5,2,6,0,2,1,4,11,9,6,7,4.16,2.7600000000000002,1.04,0.0,21.240000000000002,13.0,9.36,6.84,4
38,Blake Wesley,San Antonio Spurs,G,46,140,17,34,390.4,11,14,400.0,1,7,100.0,2,17,19,27,15,4,7,4,-26,92,65,73,46,152.56327160493828,23.444444444444443,68.17901234567901,0.9151234567901236,295.625,171.804012345679,250.56944444444446,117.43827160493825,10
39,Boban Marjanovic,Houston Rockets,C,3,7,1,1,100.0,1,2,50.0,0,0,0.0,0,3,3,0,0,0,1,0,-3,6,6,3,3,0.3600000000000001,5.289999999999999,0.0,0.0,8.41,8.41,0.3600000000000001,5.289999999999999,1
40,Bobby Portis,Milwaukee Bucks,F,172,266,72,135,530.2,15,20,505.0,13,30,353.4,17,75,92,13,19,9,14,2,-14,277,264,185,105,581.8086419753087,151.34104938271602,12.179012345679013,24.655864197530867,1171.1743827160494,1127.736111111111,616.5308641975308,172.23611111111111,10
41,Bogdan Bogdanovic,Atlanta Hawks,SG,148,325,51,135,362.7,17,18,650.0,29,81,355.4,10,27,37,39,19,12,25,6,32,224,185,187,76,370.44628099173553,43.0,57.95133149678604,25.069788797061527,401.11111111111114,323.9917355371901,456.11111111111114,92.40587695133149,10
42,Bojan Bogdanovic,New York Knicks,SF,97,215,33,93,299.2,18,19,550.0,13,48,196.39999999999998,6,16,22,14,16,1,21,0,-33,133,119,111,36,532.369140625,20.322265625,22.40625,23.15625,806.5,662.40625,654.197265625,64.994140625,10
43,Bol Bol,Phoenix Suns,C,58,109,25,44,548.8,1,1,100.0,7,18,320.0,8,27,35,1,8,1,4,5,-40,94,93,59,36,199.86989795918367,38.55102040816326,0.961734693877551,6.369897959183675,338.6938775510204,344.1862244897959,193.48979591836735,40.40051020408163,10
44,Bones Hyland,LA Clippers,PG,65,161,24,62,368.1,4,6,200.0,13,36,313.8,1,16,17,31,15,10,14,1,0,113,82,96,48,268.2869822485207,16.21597633136095,90.87869822485207,18.313609467455624,774.2514792899408,398.1775147928994,576.4023668639054,175.05325443786984,10
45,Bradley Beal,Phoenix Suns,SG,191,343,75,142,513.8,24,28,638.3,17,41,455.2,11,28,39,58,22,12,28,6,-14,288,230,249,97,721.3,32.77777777777777,31.77777777777778,6.277777777777778,771.4777777777778,676.0111111111111,794.0111111111112,87.31111111111112,10
46,Brandin Podziemski,Golden State Warriors,G,68,290,25,69,332.8,7,12,275.0,11,29,390.0,16,33,49,41,12,12,12,5,53,158,117,109,90,200.65595325054784,31.734842951059168,19.531775018261506,8.953250547845142,442.0336011687363,347.0569758948137,278.75602629656686,68.14317019722425,10
47,Brandon Boston Jr.,LA Clippers,SG,49,114,20,52,357.1,6,12,300.0,3,13,183.3,6,9,15,2,12,2,1,7,-23,66,64,51,17,146.8416,25.5696,1.7376,2.4095999999999997,253.90559999999994,223.16000000000003,166.23999999999998,38.6544,9
48,Brandon Ingram,New Orleans Pelicans,SF,190,319,70,144,487.9,39,46,824.5,11,33,302.9,6,52,58,56,25,5,22,9,72,304,248,246,114,678.5876951331497,22.593204775022958,38.49403122130395,9.102846648301194,672.4058769513315,821.6528925619834,533.5518824609734,56.87603305785124,10
49,Brandon Miller,Charlotte Hornets,F,179,328,69,168,406.0,16,22,471.7,25,75,309.9,10,46,56,25,24,9,16,6,-86,260,235,204,81,344.4336419753086,62.40277777777777,42.53086419753086,14.530864197530864,697.6111111111111,664.104938271605,384.625,98.24845679012347,10
50,Brandon Williams,Dallas Mavericks,G,7,24,2,9,83.3,3,4,100.0,0,2,0.0,1,1,2,4,1,0,1,0,-12,13,9,11,6,18.22448979591837,3.183673469387756,4.081632653061224,0.0,30.46938775510204,15.448979591836734,29.0,11.510204081632653,4
51,Braxton Key,Denver Nuggets,F,2,6,1,1,100.0,0,1,0.0,0,0,0.0,1,1,2,0,1,0,0,0,2,4,4,2,2,2.25,1.0,0.0,0.0,6.25,6.25,2.25,1.0,1
52,Brice Sensabaugh,Utah Jazz,F,77,223,30,74,360.5,11,12,366.7,6,34,170.0,7,32,39,19,14,4,20,0,-43,135,116,96,58,271.5127551020408,119.24489795918366,13.03061224489796,6.584183673469387,545.2270408163265,542.8903061224489,281.625,124.5,10
53,Brook Lopez,Milwaukee Bucks,C,100,278,33,74,438.3,11,14,450.0,23,49,482.9,13,32,45,22,21,3,9,14,26,167,145,122,67,151.7943067033976,39.042240587695126,29.867768595041323,18.254361799816348,356.6730945821855,246.524334251607,244.91827364554635,85.93480257116622,10
54,Bruce Brown,Toronto Raptors,SF,92,267,33,76,393.0,22,23,650.0,4,18,150.0,6,32,38,35,16,4,13,2,-69,165,130,127,73,210.40051020408163,92.12244897959185,24.70408163265306,4.5,493.53316326530614,366.15561224489795,323.125,131.4795918367347,10
55,Bruno Fernando,Atlanta Hawks,PF,49,196,20,39,499.9,9,12,375.0,0,0,0.0,17,50,67,11,29,13,17,11,-37,127,116,60,78,71.34444444444445,59.0,6.944444444444445,0.0,170.11111111111111,146.41111111111113,87.37777777777778,73.6111111111111,10
56,Bryce McGowens,Charlotte Hornets,G,54,155,18,37,330.8,13,18,441.7,5,15,180.0,3,21,24,8,15,7,4,3,-10,86,78,62,32,234.40625,28.0,5.65625,6.8515625,395.625,383.40625,249.625,30.65625,10
57,Buddy Hield,Philadelphia 76ers,SG,114,242,41,103,405.59999999999997,9,9,300.0,23,62,407.2,7,23,30,25,14,8,9,6,-22,169,144,139,55,86.5595567867036,35.55817174515236,19.27008310249307,8.189750692520775,257.56509695290856,191.12049861495845,135.15927977839334,72.67313019390582,10
58,CJ McCollum,New Orleans Pelicans,SG,145,283,57,133,403.3,4,5,166.7,27,73,324.3,3,33,36,31,13,5,14,5,25,212,181,176,67,645.0863177226813,24.752984389348025,52.50229568411387,47.191000918273645,1009.502295684114,690.7777777777778,976.198347107438,64.86776859504133,10
59,Cade Cunningham,Detroit Pistons,PG,210,316,77,190,399.1,37,40,722.2,19,62,269.6,8,40,48,88,17,6,30,2,-32,346,258,298,136,548.0,37.65755053507729,23.09155766944114,19.68014268727705,939.7764565992865,753.1747919143876,704.8156956004756,90.53507728894175,10
60,Caleb Houstan,Orlando Magic,G,38,148,12,32,256.1,2,2,100.0,12,30,289.4,3,11,14,3,13,2,2,2,-4,55,52,41,17,152.7232,33.9872,2.2447999999999997,17.92,295.71680000000003,277.12,158.27679999999998,49.2752,8
61,Caleb Martin,Miami Heat,SF,118,300,42,97,420.5,15,17,666.7,19,50,387.9,11,40,51,21,24,9,12,8,-8,190,169,139,72,194.94444444444443,36.952160493827165,31.345679012345673,16.975308641975307,445.625,279.6929012345679,328.7716049382716,100.40277777777777,10
62,Cam Reddish,Los Angeles Lakers,SF,23,83,8,17,193.3,2,6,75.0,5,11,183.3,3,4,7,1,5,3,2,4,7,31,30,24,8,48.138888888888886,7.472222222222222,0.8055555555555556,2.1388888888888884,42.138888888888886,35.0,58.0,5.555555555555556,5
63,Cam Thomas,Brooklyn Nets,SG,215,324,78,178,416.5,36,42,844.1,23,64,338.3,8,34,42,33,22,8,16,0,-29,290,257,248,75,664.1,69.61111111111111,18.11111111111111,26.27777777777778,881.1111111111112,807.4444444444443,728.9444444444445,96.54444444444445,10
64,Cam Whitmore,Houston Rockets,F,126,203,48,111,415.2,17,26,385.0,13,50,239.8,14,31,45,5,11,5,15,5,3,176,171,131,50,215.05817174515238,60.56232686980609,2.673130193905817,12.290858725761774,347.16343490304706,345.24376731301936,225.77008310249312,54.44321329639889,10
65,Cameron Johnson,Brooklyn Nets,SF,146,265,49,102,481.0,22,27,591.7,26,62,405.2,5,26,31,20,16,11,14,1,-5,197,177,166,51,461.5433673469388,37.043367346938766,12.0,31.887755102040813,589.0,495.0,559.5433673469388,45.043367346938766,10
66,Cameron Payne,Philadelphia 76ers,PG,101,203,38,92,429.9,10,11,375.0,15,44,341.2,4,11,15,34,20,5,13,2,-52,150,116,135,49,197.0679012345679,20.50771604938272,33.01234567901234,10.530864197530864,267.1188271604939,281.40277777777777,196.5,39.80401234567902,10
67,Caris LeVert,Cleveland Cavaliers,SG,137,338,48,120,386.4,25,35,450.2,16,55,274.5,6,44,50,92,18,19,22,7,34,279,187,229,142,373.0,24.816326530612244,115.03673469387756,11.044897959183675,794.1020408163265,475.81632653061223,612.8367346938776,218.30204081632655,10
68,Cason Wallace,Oklahoma City Thunder,G,65,200,26,53,457.2,2,3,150.0,11,27,350.0,7,17,24,19,15,14,9,6,-18,108,89,84,43,329.27160493827165,12.444444444444445,20.902777777777775,16.901234567901234,420.6743827160494,354.0864197530864,397.08179012345676,32.125,10
69,Cedi Osman,San Antonio Spurs,SF,46,134,19,38,457.1,0,0,0.0,8,22,266.6,3,17,20,14,12,4,8,2,-40,80,66,60,34,128.81632653061223,18.11479591836735,21.257653061224488,7.316326530612244,124.5,156.54336734693877,105.40051020408164,30.744897959183675,10
70,Charlie Brown Jr.,New York Knicks,G,3,27,1,5,20.0,0,0,0.0,1,3,33.3,1,1,2,0,4,0,0,1,-6,5,5,3,2,6.12,2.7200000000000006,0.0,0.6800000000000002,17.0,17.0,6.12,2.7200000000000006,2
71,Chet Holmgren,Oklahoma City Thunder,PF,171,307,62,117,532.0,34,39,643.3,13,41,295.0,17,75,92,25,12,5,9,14,35,288,263,196,117,636.2854938271605,125.52623456790124,21.271604938271604,10.944444444444443,1198.4444444444443,1158.679012345679,670.4891975308642,152.35956790123458,10
72,Chimezie Metu,Detroit Pistons,PF,8,22,3,8,37.5,2,2,100.0,0,3,0.0,1,2,3,1,2,2,1,0,-2,12,11,9,4,27.5625,0.5625,0.25,0.0,42.25,36.0,33.0625,1.5625,1
73,Chimezie Metu,Phoenix Suns,PF,6,29,3,5,150.0,0,0,0.0,0,0,0.0,2,9,11,2,2,2,3,0,-7,19,17,8,13,9.6875,24.6875,0.75,0.0,46.75,36.0,13.6875,32.1875,3
74,Chris Boucher,Toronto Raptors,PF,69,120,25,35,573.3,15,18,500.0,4,12,216.7,13,27,40,5,11,1,9,5,7,114,109,74,45,142.20987654320987,47.580246913580254,5.913580246913581,4.0246913580246915,410.0,329.0246913580247,192.69135802469134,83.98765432098766,8
75,Chris Duarte,Sacramento Kings,SG,70,154,25,46,475.0,4,5,250.0,16,30,483.4,8,22,30,8,10,6,1,3,18,108,100,78,38,316.0828402366864,35.59763313609467,6.097633136094675,14.062130177514792,530.5828402366865,467.4437869822485,362.41715976331363,58.5,10
76,Chris Livingston,Milwaukee Bucks,F,0,6,0,2,0.0,0,0,0.0,0,2,0.0,0,1,1,1,4,0,1,0,-10,2,1,1,2,0.0,0.0625,0.5625,0.0,1.0,0.0625,0.5625,1.0,1
77,Chris Paul,Golden State Warriors,PG,108,245,46,93,493.1,2,2,100.0,14,33,406.7,4,40,44,69,18,11,8,0,-33,221,152,177,113,214.93383742911155,32.83553875236295,103.5179584120983,8.593572778827976,444.9886578449905,353.8449905482041,319.57844990548205,122.85255198487712,10
78,Christian Braun,Denver Nuggets,G,69,197,27,41,659.7,6,11,225.0,9,16,433.3,5,29,34,14,25,6,7,7,51,117,103,83,48,150.92214532871972,22.58304498269896,10.5121107266436,8.922145328719722,216.93079584775086,172.4325259515571,192.33391003460207,36.181660899653984,10
79,Christian Wood,Los Angeles Lakers,F,59,133,22,51,477.0,11,14,450.0,4,19,225.0,6,28,34,6,12,5,5,2,-14,99,93,65,40,153.90277777777777,54.402777777777786,4.625,2.4444444444444446,305.125,285.0,156.7777777777778,76.27777777777777,10
80,Chuma Okeke,Orlando Magic,PF,0,28,0,4,0.0,0,0,0.0,0,4,0.0,0,3,3,2,2,2,2,0,-10,5,3,2,5,0.48999999999999994,3.1100000000000003,1.3600000000000003,0.010000000000000002,5.0,2.7600000000000002,1.01,6.190000000000001,4
81,Clint Capela,Atlanta Hawks,C,120,251,52,92,582.3000000000001,16,25,470.0,0,0,0.0,47,63,110,20,23,5,14,12,20,250,230,140,130,106.50988553590011,79.37148803329865,18.84287200832466,0.0,312.0416233090531,293.25910509885534,116.66389177939647,106.84287200832466,10
82,Coby White,Chicago Bulls,PG,190,393,66,163,402.3,33,37,821.7,25,76,313.4,9,40,49,51,24,9,21,3,-24,290,239,241,100,593.9002267573696,28.927437641723355,96.11111111111111,39.45804988662131,889.6734693877552,631.0226757369614,779.7573696145125,197.83219954648524,10
83,Cody Martin,Charlotte Hornets,SF,69,285,28,76,367.2,6,7,250.0,7,30,228.2,6,44,50,42,15,11,20,7,-28,161,119,111,92,111.0,28.18685121107267,64.68512110726644,2.6816608996539792,183.02076124567472,112.9515570934256,173.33217993079583,100.60899653979239,10
84,Cody Zeller,New Orleans Pelicans,C,7,31,3,6,200.0,1,2,50.0,0,0,0.0,5,10,15,3,5,2,3,0,14,25,22,10,18,3.3209876543209877,4.246913580246914,3.2098765432098766,0.0,16.061728395061728,11.222222222222221,6.061728395061729,9.555555555555555,5
85,Colby Jones,Sacramento Kings,G,4,20,2,7,83.3,0,0,0.0,0,2,0.0,1,4,5,3,3,0,1,0,4,12,9,7,8,4.000000000000001,4.481481481481482,0.5925925925925926,0.0,18.703703703703702,14.259259259259261,6.37037037037037,7.148148148148147,3
86,Cole Anthony,Orlando Magic,PG,101,221,38,86,419.8,17,24,537.5,8,34,168.4,9,32,41,23,19,6,10,5,15,165,142,124,64,311.26446280991735,51.38934802571166,24.188246097337007,11.719008264462808,399.5123966942149,391.29843893480256,340.49403122130394,54.561983471074385,10
87,Cole Swider,Miami Heat,F,2,18,0,6,0.0,2,2,100.0,0,5,0.0,0,2,2,1,1,0,3,0,-9,5,4,3,3,2.666666666666667,0.6666666666666667,0.6666666666666667,0.0,8.666666666666666,4.666666666666667,6.0,2.0,3
88,Collin Gillespie,Denver Nuggets,G,30,64,11,20,197.8,1,3,50.0,7,11,200.0,0,7,7,7,6,5,5,0,8,44,37,37,14,157.84,3.24,7.24,9.24,242.96,167.15999999999997,231.16,12.96,4
89,Collin Sexton,Utah Jazz,PG,219,326,84,162,514.9,28,35,773.3,23,50,366.7,11,20,31,57,15,9,21,1,-20,307,250,276,88,129.0,36.62880886426593,47.57479224376732,34.30193905817175,301.3753462603878,199.31301939058167,217.36426592797784,97.90166204986149,10
90,Corey Kispert,Washington Wizards,SF,126,275,44,93,444.4,13,22,425.0,25,59,394.7,3,23,26,16,22,6,11,4,-74,168,152,142,42,373.5419393218322,16.64366448542534,26.643664485425344,26.53718024985128,554.1939321832242,429.2242712671029,473.2242712671029,68.57465794170136,10
91,Cory Joseph,Golden State Warriors,PG,27,71,10,16,316.7,0,0,0.0,7,11,316.7,2,9,11,6,6,0,1,0,9,44,38,33,17,31.2,10.8,2.8000000000000003,3.2,28.8,47.2,21.2,5.2,5
92,Craig Jr. Porter,Cleveland Cavaliers,G,53,105,22,44,391.9,5,5,300.0,4,10,125.0,5,16,21,16,7,3,7,0,-17,90,74,69,37,320.01331360946745,36.94082840236686,13.976331360946748,8.98224852071006,604.9245562130177,518.1908284023668,399.5044378698225,58.159763313609474,9
93,D'Angelo Russell,Los Angeles Lakers,PG,206,353,74,152,463.9,21,26,735.0,37,82,423.8,6,30,36,64,19,9,19,4,39,306,242,270,100,1029.5640138408305,31.01038062283737,125.06747404844292,52.12802768166091,1742.112456747405,1329.688581314879,1440.5484429065743,157.5173010380623,10
94,D.J. Carton,Toronto Raptors,G,8,31,2,7,83.3,3,4,150.0,1,4,50.0,2,1,3,3,1,1,1,0,-30,14,11,11,6,8.666666666666668,2.0,2.0,0.6666666666666667,8.666666666666666,2.6666666666666665,18.666666666666668,0.0,3
95,Daishen Nix,Minnesota Timberwolves,SG,5,5,2,3,66.7,0,0,0.0,1,2,50.0,0,0,0,0,1,1,0,0,6,5,5,5,0,9.0,0.0,0.08163265306122448,0.32653061224489793,7.367346938775511,9.0,7.367346938775511,0.08163265306122448,1
96,Dalano Banton,Portland Trail Blazers,G,173,328,61,149,420.5,26,32,851.7,25,63,420.0,12,37,49,38,17,8,24,6,-95,260,222,211,87,680.273356401384,52.465397923875436,44.935986159169545,22.347750865051903,1290.0,1015.1712802768164,920.7006920415224,131.80276816608995,10
97,Dalen Terry,Chicago Bulls,F,28,118,11,28,343.6,3,6,150.0,3,12,175.0,5,14,19,16,12,9,5,1,18,63,47,44,35,48.775510204081634,28.98979591836735,12.408163265306122,2.5,172.1734693877551,121.03061224489795,78.9795918367347,62.336734693877546,10
98,Damian Jones,Cleveland Cavaliers,C,52,118,21,35,527.9,10,12,550.0,0,5,0.0,14,23,37,6,10,4,6,7,-25,95,89,58,43,149.80555555555554,47.583333333333336,4.027777777777778,0.0,262.25,264.0,149.66666666666666,50.0,9
99,Damian Lillard,Milwaukee Bucks,PG,247,364,79,180,423.1,50,53,949.0,39,91,416.8,4,39,43,79,15,8,24,4,42,369,290,326,122,918.576124567474,26.10553633217993,158.5,34.134948096885815,1400.5,1026.0,1266.1937716262976,211.48788927335642,10
100,Daniel Gafford,Dallas Mavericks,C,115,208,50,59,701.2,15,23,406.7,0,0,0.0,20,52,72,10,31,8,6,21,18,197,187,125,82,461.27160493827165,125.78549382716048,8.192901234567902,0.0,1036.6234567901236,938.125,530.2361111111111,163.51234567901233,10
101,Daniel Theis,LA Clippers,C,49,152,21,44,446.1,3,3,200.0,4,13,250.0,14,30,44,11,17,1,7,7,28,104,93,60,55,118.27335640138408,118.06920415224914,9.399653979238755,4.422145328719723,292.5,266.7231833910035,148.21626297577853,123.30276816608996,10
102,Danilo Gallinari,Milwaukee Bucks,PF,28,105,9,23,350.0,9,10,275.0,1,11,100.0,3,6,9,9,7,2,3,1,-43,46,37,37,18,84.83900226757369,5.489795918367347,12.927437641723355,1.2448979591836735,104.78458049886619,103.44444444444446,84.12471655328798,20.471655328798185,10
103,Dante Exum,Dallas Mavericks,G,66,186,21,45,459.1,16,18,616.7,8,14,350.0,2,18,20,26,13,2,10,0,38,112,86,92,46,239.6111111111111,18.434027777777775,36.40277777777778,16.18402777777778,373.76736111111114,264.90625,330.40277777777777,72.90625,10
104,Danuel House Jr.,Philadelphia 76ers,SF,42,143,14,30,276.3,13,15,466.7,1,11,33.3,6,11,17,7,16,7,3,3,-26,66,59,49,24,42.0,11.714285714285715,8.0,0.8571428571428572,41.714285714285715,51.714285714285715,40.0,11.714285714285715,7
105,Dario Saric,Golden State Warriors,PF,28,107,12,33,298.3,2,3,100.0,2,17,83.3,6,15,21,18,5,0,13,0,-31,67,49,46,39,54.736,26.936,15.744,2.384,149.94400000000002,101.4,77.024,68.936,10
106,Darius Garland,Cleveland Cavaliers,PG,200,359,72,165,436.6,20,27,677.4,36,90,396.8,8,23,31,72,25,11,29,1,-10,303,231,272,103,626.0,40.90138408304498,59.017301038062286,44.89446366782007,868.9013840830452,701.607266435986,795.6055363321799,97.60726643598616,10
107,David Roddy,Phoenix Suns,F,68,169,27,69,480.3,9,15,301.7,5,25,143.3,5,24,29,13,7,2,14,0,-88,110,97,81,42,418.0127551020409,121.04336734693878,25.125,8.818877551020407,1010.7474489795918,788.3367346938775,590.7448979591837,195.84693877551024,10
108,Davion Mitchell,Sacramento Kings,PG,68,161,29,50,512.5,2,2,100.0,8,25,210.0,4,11,15,15,13,2,9,0,23,98,83,83,30,288.0124653739612,9.337950138504155,10.506925207756233,15.979224376731304,384.53324099722994,331.5803324099723,327.81301939058176,32.99722991689751,10
109,Davis Bertans,Charlotte Hornets,SF,92,245,31,89,316.3,7,8,250.0,23,71,284.1,5,23,28,15,18,11,7,4,-33,135,120,107,43,348.4413265306123,55.387755102040806,20.18622448979592,26.418367346938776,593.2755102040817,497.625,424.9081632653061,94.75765306122447,10
110,Day'Ron Sharpe,Brooklyn Nets,C,63,160,26,44,652.2,9,18,241.6,2,3,100.0,24,35,59,19,18,4,12,7,-3,141,122,82,78,174.56944444444443,173.15625,17.125,3.65625,498.7673611111111,408.51736111111114,226.44444444444446,228.65625,10
111,De'Aaron Fox,Sacramento Kings,PG,255,360,102,212,480.0,29,35,751.7,22,65,347.0,9,46,55,64,26,20,34,4,55,374,310,319,119,602.8271604938271,51.27160493827161,73.43827160493827,11.660493827160494,531.6111111111112,612.1975308641976,566.0308641975308,80.91975308641975,10
112,De'Andre Hunter,Atlanta Hawks,SF,156,286,59,127,461.7,16,23,583.3,22,56,383.1,1,21,22,14,21,7,12,3,-11,192,178,170,36,317.947265625,24.322265625,8.5,19.712890625,350.9140625,372.5390625,289.384765625,39.759765625,10
113,De'Anthony Melton,Philadelphia 76ers,SG,23,43,7,20,75.0,4,4,200.0,5,14,75.0,0,5,5,5,3,2,1,1,-2,33,28,28,10,128.66666666666666,2.666666666666667,2.666666666666667,8.666666666666666,206.0,164.66666666666669,164.66666666666669,10.666666666666668,3
114,DeAndre Jordan,Denver Nuggets,C,23,71,11,19,550.0,1,3,100.0,0,0,0.0,14,17,31,2,10,0,1,3,-23,56,54,25,33,27.222222222222225,45.691358024691354,1.5061728395061729,0.0,92.46913580246914,79.72839506172839,33.32098765432099,53.839506172839506,8
115,DeJon Jarreau,Memphis Grizzlies,F,29,108,11,36,175.0,4,6,200.0,3,9,116.7,6,31,37,22,9,5,7,0,-16,88,66,51,59,50.68518518518518,54.24074074074074,32.01851851851852,3.5,213.79629629629628,98.66666666666666,111.07407407407408,141.0,6
116,DeMar DeRozan,Chicago Bulls,SF,252,367,81,155,516.4,79,90,894.1,11,32,263.4,5,46,51,55,16,7,18,6,5,358,303,307,106,1092.2938775510204,72.17551020408163,60.7469387755102,11.244897959183675,1377.1020408163265,1435.2938775510204,1003.9795918367347,163.0448979591837,10
117,Dean Wade,Cleveland Cavaliers,PF,46,178,15,35,260.2,5,7,216.7,11,31,233.4,4,27,31,7,8,3,1,9,-23,84,77,53,38,468.50000000000006,35.125,6.125,31.525000000000006,718.8,714.725,466.12499999999994,47.699999999999996,10
118,Deandre Ayton,Portland Trail Blazers,C,229,346,105,167,627.8,18,22,450.0,1,3,100.0,39,97,136,14,15,7,22,9,-35,379,365,243,150,601.2479338842975,209.2213039485767,6.471992653810836,0.9044995408631772,1326.7777777777776,1388.805325987144,564.2213039485766,190.69237832874197,10
119,Dejounte Murray,Atlanta Hawks,SG,258,371,95,209,449.5,32,43,697.4,36,95,366.7,6,42,48,80,16,17,28,2,-34,386,306,338,128,828.9221453287197,58.26989619377163,70.03460207612457,37.01903114186851,672.2301038062284,977.8356401384083,577.0121107266436,74.60899653979239,10
120,Delon Wright,Miami Heat,SG,40,148,14,34,436.09999999999997,8,10,233.3,4,8,250.0,6,12,18,22,4,10,1,3,20,80,58,62,40,117.91715976331363,3.8136094674556213,34.582840236686394,4.831360946745562,213.36094674556213,133.97928994082838,192.9023668639053,42.79289940828403,10
121,Deni Avdija,Washington Wizards,SF,181,349,67,139,480.8,32,42,685.0,15,40,303.3,22,72,94,29,24,8,22,4,-45,304,275,210,123,883.096,184.8,25.016,30.983999999999998,1626.0,1513.7359999999999,973.6,231.576,10
122,Dennis Schroder,Brooklyn Nets,PG,164,353,59,130,447.2,23,31,571.4,23,53,438.5,4,19,23,68,17,8,33,4,-52,255,187,232,91,356.7474048442906,20.259515570934255,45.579584775086516,13.185121107266436,474.2231833910035,305.03460207612454,529.7249134948098,62.05017301038061,10
123,Dennis Smith Jr.,Brooklyn Nets,PG,57,176,21,53,393.8,7,9,333.3,8,25,264.9,7,15,22,28,22,14,9,2,10,107,79,85,50,79.58775510204083,30.0,41.689795918367345,4.4163265306122454,166.83673469387753,127.24489795918367,96.55102040816327,94.31836734693877,10
124,Dereck II Lively,Dallas Mavericks,C,96,196,46,57,725.7,4,9,200.0,0,0,0.0,17,27,44,7,24,6,7,14,-7,147,140,103,51,401.49583828775263,70.12366230677763,8.2294887039239,0.0,819.0,725.9881093935791,486.57193816884666,86.28894173602853,10
125,Derrick Jones Jr.,Dallas Mavericks,SF,75,181,28,50,520.2,10,16,450.0,9,20,240.0,13,10,23,7,12,6,7,3,15,105,98,82,30,345.7750865051903,83.27508650519032,4.1280276816609,26.064013840830448,576.5346020761245,605.6003460207611,327.8062283737025,76.30622837370242,10
126,Derrick Rose,Memphis Grizzlies,PG,49,95,20,37,377.7,5,6,266.7,4,8,233.3,0,15,15,21,3,1,9,0,-9,85,64,70,36,70.0,14.857142857142858,12.0,3.7142857142857144,188.85714285714286,116.85714285714286,128.0,40.857142857142854,7
127,Derrick White,Boston Celtics,PG,140,335,53,118,461.7,6,6,400.0,28,68,333.3,9,52,61,69,22,10,14,18,105,270,201,209,130,468.67777777777775,40.411111111111104,47.84444444444445,59.477777777777774,584.0444444444444,542.7777777777778,487.3,110.89999999999998,10
128,Desmond Bane,Memphis Grizzlies,SG,52,93,16,49,93.4,12,14,166.7,8,25,95.2,1,8,9,15,7,3,6,2,-24,76,61,67,24,216.0,8.333333333333334,6.75,3.0,345.41666666666663,301.66666666666663,258.75,16.083333333333336,3
129,Devin Booker,Phoenix Suns,SG,252,377,92,204,449.8,53,56,912.5,15,60,226.3,14,40,54,69,30,9,22,5,-13,375,306,321,123,300.0,58.44444444444444,84.77777777777777,26.544444444444448,298.37777777777774,355.9111111111111,222.24444444444447,163.44444444444446,10
130,Devin Vassell,San Antonio Spurs,SG,202,385,81,167,471.1,18,24,775.0,22,59,357.5,4,43,47,52,14,14,23,5,-3,301,249,254,99,421.55102040816325,67.87346938775511,77.2,21.632653061224488,716.3877551020408,450.9020408163265,678.9224489795919,153.1877551020408,10
131,Devonte' Graham,San Antonio Spurs,PG,11,27,4,8,125.0,0,0,0.0,3,6,150.0,0,7,7,0,2,1,0,0,12,18,18,11,7,46.111111111111114,2.1111111111111107,0.0,3.0,58.0,58.0,46.111111111111114,2.1111111111111107,4
132,Dillon Brooks,Houston Rockets,SF,83,299,33,85,347.8,6,8,300.0,11,49,218.5,7,28,35,18,21,9,12,1,63,136,118,101,53,302.19999999999993,50.599999999999994,13.730612244897959,10.004081632653063,457.330612244898,362.0,375.75918367346935,86.10204081632654,10
133,Domantas Sabonis,Sacramento Kings,PF,209,369,80,140,585.3,46,60,770.0,3,9,250.0,49,118,167,76,31,12,32,10,62,452,376,285,243,250.31301939058173,99.83102493074793,84.7590027700831,2.2465373961218837,311.4016620498615,275.10249307479233,264.0581717451523,207.14404432132963,10
134,Dominick Barlow,San Antonio Spurs,F,62,141,24,39,553.3,14,18,366.6,0,1,0.0,19,20,39,16,18,4,2,4,-20,117,101,78,55,227.28027681660902,71.5432525951557,39.602076124567475,0.0,528.3494809688582,468.8304498269896,310.6539792387543,87.29065743944636,9
135,Donovan Mitchell,Cleveland Cavaliers,SG,241,347,75,167,435.8,52,59,812.8,39,86,449.3,3,47,50,49,22,13,34,6,4,340,291,290,99,886.6487603305785,22.330578512396695,23.0495867768595,16.96694214876033,1278.185950413223,1120.5,1030.0206611570247,59.69421487603306,10
136,Donte DiVincenzo,New York Knicks,SG,175,361,61,170,359.1,14,17,516.7,39,120,327.3,12,35,47,33,26,17,22,5,22,255,222,208,80,248.23265306122448,47.832653061224484,27.587755102040816,24.90204081632653,313.98775510204086,297.59999999999997,264.9795918367347,75.06122448979593,10
137,Dorian Finney-Smith,Brooklyn Nets,PF,100,328,37,81,461.6,9,10,375.0,17,52,333.3,18,28,46,22,20,14,9,5,-6,168,146,122,68,230.67777777777778,26.444444444444446,34.099999999999994,22.6,398.0,339.3,285.1111111111111,64.8111111111111,10
138,Doug McDermott,Indiana Pacers,SF,45,123,17,43,325.0,1,2,50.0,10,34,239.89999999999998,1,8,9,9,8,3,2,0,-4,63,54,54,18,176.4140625,11.0,11.40625,10.15625,263.9140625,229.2890625,210.7890625,22.65625,10
139,Draymond Green,Golden State Warriors,PF,72,272,30,69,480.1,8,11,300.0,4,21,103.3,21,65,86,64,31,9,27,9,29,222,158,136,150,83.06944444444444,94.94444444444444,115.85956790123458,4.845679012345679,511.97530864197535,195.4027777777778,270.9938271604938,339.45216049382714,10
140,Drew Eubanks,Phoenix Suns,PF,46,148,19,29,625.0,8,8,300.0,0,0,0.0,14,34,48,4,10,3,6,5,-17,98,94,50,52,64.4,83.55102040816327,2.5306122448979593,0.0,241.91836734693877,246.3510204081633,66.13061224489796,79.91836734693878,10
141,Duncan Robinson,Miami Heat,F,146,321,53,111,467.0,8,9,350.0,32,84,339.0,2,33,35,30,26,10,16,3,-13,211,181,176,65,464.534859521332,21.310093652445367,36.01040582726327,37.60665972944849,660.9438085327782,477.4557752341311,636.4703433922997,68.87304890738814,10
142,Duop Reath,Portland Trail Blazers,C,93,188,33,67,373.4,12,15,385.7,15,30,333.4,12,10,22,6,21,2,9,3,-61,121,115,99,28,715.7640613586559,37.69466764061359,8.474799123447772,32.25493060628196,1058.0737764791818,931.8356464572681,812.5704894083273,75.60116873630388,10
143,Dwight Powell,Dallas Mavericks,C,20,119,7,12,450.0,6,11,325.0,0,0,0.0,12,20,32,9,19,0,9,3,-9,61,52,29,41,33.397923875432525,81.41868512110726,9.121107266435986,0.0,206.4844290657439,168.0899653979239,47.162629757785474,115.16955017301038,9
144,Dylan Windler,Atlanta Hawks,G,0,5,0,0,0.0,0,0,0.0,0,0,0.0,0,1,1,0,1,0,0,0,-8,1,1,0,1,0.81,0.16000000000000003,0.25,0.09,1.0,0.25,1.9599999999999997,0.010000000000000018,1
145,Dylan Windler,Los Angeles Lakers,G,3,14,1,4,25.0,0,0,0.0,1,4,25.0,0,1,1,2,1,0,0,0,-7,6,4,5,3,5.220000000000001,0.52,0.5,0.58,4.0,2.5,6.920000000000001,0.8199999999999998,2
146,Dyson Daniels,New Orleans Pelicans,G,38,181,16,32,311.4,1,2,50.0,5,13,250.0,7,20,27,20,12,15,12,8,25,85,65,58,47,123.55555555555556,24.0,25.555555555555557,4.222222222222222,146.22222222222223,113.55555555555556,128.22222222222223,77.55555555555556,9
147,Emoni Bates,Cleveland Cavaliers,F,7,12,3,7,42.9,0,2,0.0,1,4,25.0,0,1,1,0,0,0,1,0,-3,8,8,7,1,0.0,0.0,0.0,0.0,0.0,0.0,0.0,0.0,1
148,Eric Gordon,Phoenix Suns,SG,82,260,29,75,337.9,7,10,216.7,17,46,322.9,3,11,14,19,11,9,10,5,-1,115,96,101,33,383.10204081632656,6.989795918367347,3.0,24.06122448979592,333.4795918367347,324.62244897959187,394.6734693877552,7.275510204081632,10
149,Eugene Omoruyi,Washington Wizards,F,39,106,17,38,391.3,5,10,200.0,0,6,0.0,7,13,20,7,18,7,5,1,-68,66,59,46,27,94.94444444444444,8.899999999999999,7.0,0.011111111111111112,87.24444444444444,71.44444444444444,106.94444444444444,19.7,10
150,Evan Fournier,Detroit Pistons,SG,69,172,24,72,311.8,8,9,366.7,13,46,221.8,2,16,18,23,18,9,6,0,-9,110,87,92,41,413.4334705075446,11.083676268861453,23.0,17.444444444444443,533.679012345679,474.0123456790124,484.21124828532237,22.972565157750342,10
151,Evan Mobley,Cleveland Cavaliers,PF,147,305,60,107,547.9,24,42,522.6,3,14,175.0,25,76,101,35,27,12,16,20,-29,283,248,182,136,371.84429065743944,105.37370242214533,75.2006920415225,2.6262975778546713,782.1418685121107,674.0,423.83391003460207,236.7266435986159,10
152,Frank Ntilikina,Charlotte Hornets,PG,5,39,1,8,50.0,2,2,100.0,1,7,50.0,1,4,5,3,4,0,0,0,0,13,10,8,8,19.0,7.0,6.84,0.7600000000000002,24.439999999999998,14.0,18.64,24.640000000000004,4
153,Franz Wagner,Orlando Magic,SF,155,309,59,126,482.1,33,40,795.0,4,35,67.9,7,40,47,30,26,12,23,7,67,232,202,185,77,412.7061524334251,59.73645546372819,44.264462809917354,12.0,773.3553719008265,640.0,537.0973370064279,112.96510560146926,10
154,Fred VanVleet,Houston Rockets,PG,189,373,61,137,449.5,34,38,602.4,33,76,425.3,5,37,42,96,20,17,19,5,95,327,231,285,138,383.44444444444446,26.71111111111111,83.34444444444443,23.699999999999996,448.81111111111113,461.0,388.10000000000014,93.21111111111111,10
155,Furkan Korkmaz,Philadelphia 76ers,SG,41,116,13,29,278.6,7,10,241.7,8,18,258.3,3,12,15,12,6,3,2,2,22,68,56,53,27,292.875,14.875,10.0,20.0,404.0,340.0,363.875,17.875,8
156,GG Jackson,Memphis Grizzlies,F,192,316,62,140,427.5,41,49,757.4,27,76,331.0,14,29,43,14,13,5,18,4,-63,249,235,206,57,823.7487216946677,38.1263696128561,18.41051862673484,48.13221329437546,1119.6062819576332,989.7479912344777,943.9737034331629,66.17019722425128,10
157,Garrett Temple,Toronto Raptors,SF,5,12,2,4,50.0,1,2,50.0,0,2,0.0,1,0,1,0,2,1,1,0,-4,6,6,5,1,16.0,0.16000000000000003,0.0,0.0,19.360000000000003,19.360000000000003,16.0,0.16000000000000003,1
158,Garrison Mathews,Atlanta Hawks,SG,37,165,11,30,350.0,5,5,200.0,10,24,375.1,5,10,15,6,20,3,0,2,-37,58,52,43,21,105.20408163265306,18.959183673469386,14.530612244897958,12.293877551020408,211.68979591836737,156.77551020408163,148.6081632653061,45.0,10
159,Gary Harris,Orlando Magic,SG,77,247,28,57,516.1,4,7,125.0,17,40,477.6,1,15,16,11,12,8,6,3,59,104,93,88,27,107.49408284023669,10.59171597633136,13.0,4.668639053254438,196.98520710059174,160.36982248520712,135.03254437869822,32.66863905325444,10
160,Gary Payton II,Golden State Warriors,SG,32,138,14,25,443.3,1,3,50.0,3,6,300.0,11,10,21,11,16,4,7,3,-19,64,53,43,32,104.98979591836734,23.084183673469383,3.030612244897959,2.655612244897959,117.2984693877551,138.53316326530611,86.26530612244898,23.60459183673469,10
161,Gary Trent Jr.,Toronto Raptors,SG,181,330,67,153,436.6,15,19,521.7,32,86,364.0,9,33,42,13,14,14,3,2,-52,236,223,194,55,572.2444444444445,14.5,14.644444444444444,31.644444444444442,556.8999999999999,606.8111111111111,518.8,32.67777777777778,10
162,Georges Niang,Cleveland Cavaliers,SF,127,280,46,92,500.0,10,10,400.0,25,58,459.4,2,32,34,18,26,6,14,3,-8,179,161,145,52,349.9072315558802,26.40029218407597,15.862673484295103,21.569758948137324,551.4835646457268,460.47114682249816,425.37107377647914,57.81154127100073,10
163,Giannis Antetokounmpo,Milwaukee Bucks,PF,310,352,106,171,626.9,89,123,724.9,9,19,483.3,24,87,111,65,22,6,32,5,49,486,421,375,176,415.96433470507543,85.93827160493827,91.73799725651578,5.844993141289438,1026.0,771.960219478738,643.2716049382716,204.4087791495199,10
164,Goga Bitadze,Orlando Magic,C,24,94,10,19,380.0,4,7,183.3,0,3,0.0,10,12,22,8,10,2,7,9,7,54,46,32,30,53.17355371900826,58.24793388429753,8.809917355371901,0.0,252.06611570247935,187.3388429752066,84.0,100.95867768595039,8
165,Gordon Hayward,Oklahoma City Thunder,SF,50,178,16,33,495.0,11,17,310.0,7,12,466.7,5,14,19,24,11,5,5,0,-10,93,69,74,43,94.85069444444444,12.902777777777777,40.100694444444436,4.15625,203.0,127.85069444444444,143.40277777777777,79.60069444444443,10
166,Gradey Dick,Toronto Raptors,G,94,298,36,100,351.5,5,5,300.0,17,55,312.0,6,19,25,18,18,7,12,1,-136,137,119,112,43,152.90625,21.125,42.697265625,14.119140625,351.369140625,206.90625,281.712890625,79.478515625,10
167,Grant Williams,Charlotte Hornets,PF,133,318,48,96,524.0,26,33,524.6,11,35,372.5,17,35,52,25,31,11,27,5,-47,210,185,158,77,344.60816326530613,88.86530612244896,24.2734693877551,11.400000000000002,656.4897959183673,593.9469387755103,358.130612244898,162.1591836734694,10
168,Grayson Allen,Phoenix Suns,SG,179,368,59,111,509.4,17,19,725.0,44,88,460.2,3,26,29,33,20,12,14,6,21,241,208,212,62,934.6124567474048,18.949826989619375,44.21107266435986,102.52076124567475,1193.9809688581315,1005.0121107266436,1122.076124567474,64.66608996539793,10
169,Gui Santos,Golden State Warriors,F,38,103,13,24,372.5,8,9,350.0,4,8,250.0,9,21,30,9,14,2,5,2,22,77,68,47,39,148.16326530612247,87.02040816326529,12.734693877551022,4.040816326530612,454.8775510204082,414.0,159.79591836734696,129.0,8
170,Harrison Barnes,Sacramento Kings,SF,139,281,52,101,518.3,14,19,375.0,21,49,332.6,6,20,26,11,15,4,7,1,-16,176,165,150,37,228.42797783933517,53.983379501385045,11.166204986149584,42.10664819944598,455.4972299168975,350.6329639889197,309.297783933518,89.14404432132964,10
171,Harry III Giles,Brooklyn Nets,F,8,8,3,6,50.0,1,2,50.0,1,1,100.0,2,2,4,2,3,0,0,0,-12,14,12,10,6,45.33777777777778,10.240000000000002,3.24,0.7511111111111112,137.67111111111114,98.67111111111112,72.81777777777778,25.0,1
172,Harry III Giles,Los Angeles Lakers,F,2,5,1,1,100.0,0,0,0.0,0,0,0.0,0,1,1,0,0,0,0,0,-3,3,3,2,1,0.5377777777777779,0.03999999999999998,0.04000000000000001,0.017777777777777778,0.5377777777777779,0.8711111111111107,0.28444444444444456,0.0,1
173,Haywood Highsmith,Miami Heat,F,26,117,10,26,368.8,1,4,50.0,5,18,200.0,4,12,16,7,7,0,1,2,-36,49,42,33,23,137.9948096885813,28.989619377162626,4.100346020761245,10.195501730103807,318.098615916955,278.4515570934256,165.94636678200692,44.78546712802768,10
174,Herbert Jones,New Orleans Pelicans,SF,99,316,34,62,492.3,13,16,500.0,18,34,394.1,6,21,27,28,32,11,11,13,72,154,126,127,55,240.09393579072534,26.57669441141498,25.693222354340072,25.657550535077288,298.6040428061831,247.3412604042806,270.7788347205707,72.84780023781214,10
175,Hunter Tyson,Denver Nuggets,F,0,7,0,3,0.0,0,0,0.0,0,3,0.0,0,1,1,0,1,0,2,0,-1,1,1,0,1,4.0,0.11111111111111106,0.0,0.4444444444444444,5.4444444444444455,5.4444444444444455,4.0,0.11111111111111106,1
176,Ibou Badji,Portland Trail Blazers,C,7,32,3,4,150.0,1,2,50.0,0,0,0.0,1,2,3,4,6,0,5,3,-17,14,10,11,7,15.720000000000002,3.0800000000000005,2.75,0.0,37.06999999999999,30.32,21.470000000000002,6.83,3
177,Immanuel Quickley,Toronto Raptors,SG,195,364,68,158,420.7,33,45,597.2,26,77,328.3,2,55,57,88,17,11,26,3,-71,340,252,283,145,487.18639053254446,38.13609467455621,200.2869822485207,21.494082840236686,950.284023668639,549.3520710059172,809.5562130177514,316.98520710059165,10
178,Isaac Okoro,Cleveland Cavaliers,SF,116,349,44,93,491.0,10,16,341.7,18,48,439.7,8,30,38,19,29,11,9,8,-38,173,154,135,57,156.80788897005112,39.846603360116866,8.93864134404675,10.140248356464573,266.2505478451424,211.69612856099343,196.63330898466035,63.51424397370343,10
179,Isaiah Hartenstein,New York Knicks,C,68,231,29,46,689.5,10,13,650.0,0,0,0.0,29,52,81,33,23,6,7,12,58,182,149,101,114,89.11111111111114,86.5,33.699999999999996,0.0,298.44444444444446,253.0777777777777,132.27777777777777,122.4,10
180,Isaiah Jackson,Indiana Pacers,SF,92,188,35,56,681.8,22,30,708.3,0,1,0.0,21,36,57,14,25,11,9,7,-3,163,149,106,71,240.6487603305785,211.1487603305785,30.0,0.0,912.5,760.5,300.10330578512395,333.694214876033,10
181,Isaiah Joe,Oklahoma City Thunder,SG,64,175,24,65,303.7,1,1,100.0,15,47,260.4,4,14,18,7,8,3,4,4,-14,89,82,71,25,229.625,9.65625,7.0,14.5390625,266.15625,257.40625,233.125,21.90625,10
182,Isaiah Mobley,Cleveland Cavaliers,F,5,33,2,7,58.3,0,0,0.0,1,4,25.0,0,4,4,2,2,0,0,0,-1,11,9,7,6,0.6799999999999997,10.880000000000003,0.72,0.6800000000000002,13.32,9.0,2.1199999999999997,14.479999999999999,2
183,Isaiah Stewart,Detroit Pistons,C,106,319,40,71,587.7,10,12,516.7,16,38,409.0,10,48,58,12,11,4,10,10,-48,176,164,118,70,130.60491493383742,49.60680529300567,9.60680529300567,12.67296786389414,244.60491493383742,192.36672967863893,178.05671077504726,64.0,10
184,Ish Smith,Charlotte Hornets,PG,18,181,8,34,236.0,0,0,0.0,2,2,200.0,1,19,20,41,16,5,6,1,-90,79,38,59,61,54.36000000000001,24.0,78.09,1.5600000000000003,170.49,69.16000000000001,134.09,123.69,9
185,Ish Wainright,Phoenix Suns,F,3,11,1,6,16.7,0,0,0.0,1,4,25.0,3,2,5,1,1,1,1,0,-3,9,8,4,6,5.76,16.0,0.6400000000000001,0.6400000000000001,51.84,40.96000000000001,10.240000000000002,23.04,1
186,Ivica Zubac,LA Clippers,C,90,248,37,55,646.2,16,18,600.0,0,0,0.0,26,49,75,17,22,6,13,8,-38,182,165,107,92,268.5444444444444,72.37777777777778,8.2,0.0,483.7,440.90000000000003,277.2111111111111,114.71111111111111,10
187,JT Thor,Charlotte Hornets,F,19,104,8,16,408.3,0,0,0.0,3,8,200.0,1,15,16,5,9,0,2,3,24,40,35,24,21,41.44444444444444,16.594104308390023,2.9591836734693877,4.219954648526077,73.99546485260771,66.26077097505669,46.403628117913826,22.328798185941043,10
188,JaVale McGee,Sacramento Kings,C,23,44,11,18,355.0,0,3,0.0,1,2,100.0,5,8,13,1,6,2,1,0,3,37,36,24,14,45.0,13.0,0.8400000000000002,0.8400000000000002,78.44,84.0,43.84,9.44,6
189,Jabari Smith Jr.,Houston Rockets,PF,140,323,49,107,440.3,22,26,791.7,20,54,360.1,18,63,81,13,29,11,9,10,21,234,221,153,94,255.525390625,191.3515625,12.212890625,12.0390625,468.7265625,465.400390625,277.0,185.416015625,10
190,Jabari Walker,Portland Trail Blazers,F,90,224,35,75,451.3,15,17,625.0,5,15,266.7,24,43,67,13,28,7,10,1,-21,170,157,103,80,321.43162901307966,96.33174791914387,16.362663495838287,6.740784780023781,601.0439952437574,531.6183115338882,350.5885850178359,152.96313912009512,10
191,Jacob Gilyard,Memphis Grizzlies,G,67,205,23,52,431.8,1,1,100.0,20,45,431.8,1,14,15,41,10,10,12,2,-62,123,82,108,56,274.1404958677686,10.685950413223141,31.595041322314046,24.0,454.1404958677686,332.0,382.0,56.561983471074385,10
192,Jacob Toppin,New York Knicks,F,13,29,5,9,107.1,2,2,100.0,1,4,33.3,3,3,6,1,3,0,1,0,-18,20,19,14,7,78.05555555555556,8.722222222222221,0.5555555555555556,0.7222222222222223,130.22222222222223,136.55555555555554,72.5,8.5,2
193,Jaden Hardy,Dallas Mavericks,G,77,107,32,62,559.4,4,5,250.0,9,19,350.0,1,9,10,14,6,3,7,1,16,101,87,91,24,141.55363321799308,10.034602076124568,20.5,7.539792387543254,201.16435986159172,167.31141868512108,171.5242214532872,34.416955017301035,10
194,Jaden Ivey,Detroit Pistons,PG,163,320,58,143,406.0,34,41,696.7,13,55,202.7,10,19,29,40,25,11,29,6,-69,232,192,203,69,446.56944444444446,22.901234567901234,60.007716049382715,31.248456790123452,616.253086419753,546.1188271604939,486.6975308641975,112.91512345679013,10
195,Jaden McDaniels,Minnesota Timberwolves,PF,118,318,46,105,434.4,14,22,348.8,12,41,283.1,11,40,51,14,35,7,6,5,-39,183,169,132,65,636.6837107377648,66.83053323593865,27.10153396639883,29.741417092768444,948.8714390065741,897.8940832724616,645.7750182615048,135.81811541271003,10
196,Jaden Springer,Boston Celtics,G,58,175,21,50,363.7,13,14,575.0,3,17,183.3,13,18,31,18,22,13,12,4,-17,107,89,76,49,177.32544378698228,34.594674556213015,23.775147928994087,2.4408284023668636,485.67159763313606,351.3402366863906,270.5325443786982,99.4940828402367,10
197,Jae Crowder,Milwaukee Bucks,PF,59,204,23,51,389.4,2,2,100.0,11,27,283.3,6,18,24,8,20,11,2,1,20,91,83,67,32,244.7530864197531,23.3641975308642,6.748456790123457,18.5,267.8410493827161,283.7345679012346,231.56944444444446,27.402777777777775,10
198,Jae'Sean Tate,Houston Rockets,SF,37,125,15,34,428.7,5,9,200.0,2,6,133.3,10,18,28,6,17,9,11,3,10,71,65,43,34,60.456790123456784,28.19753086419753,4.598079561042524,1.6351165980795608,148.97256515775035,116.53086419753086,75.18655692729767,50.50754458161866,10
199,Jahmi'us Ramsey,Toronto Raptors,SG,32,83,12,29,203.39999999999998,5,6,175.0,3,14,108.3,4,14,18,5,4,5,5,0,-26,55,50,37,23,62.53472222222222,25.534722222222225,2.5555555555555554,1.4722222222222223,86.13888888888889,94.13888888888889,68.8125,13.8125,5
200,Jaime Jr. Jaquez,Miami Heat,G,104,291,39,86,430.4,18,25,616.7,8,25,244.89999999999998,9,40,49,27,20,12,9,3,3,180,153,131,76,398.259765625,41.3515625,22.40625,7.806640625,372.197265625,368.244140625,389.556640625,76.4140625,10
201,Jake LaRavia,Memphis Grizzlies,F,125,276,35,103,319.4,41,50,730.0,14,48,276.9,24,31,55,19,22,14,12,5,-46,199,180,144,74,164.77514792899407,127.69822485207101,33.071005917159766,6.591715976331361,483.68639053254435,432.0,220.55621301775147,156.67455621301775,10
202,Jakob Poeltl,Toronto Raptors,C,122,251,55,101,543.9,12,20,491.7,0,0,0.0,39,53,92,31,28,10,11,19,35,245,214,153,123,161.8469387755102,127.67346938775509,30.387755102040813,0.0,516.704081632653,398.98979591836735,256.6224489795918,181.0,10
203,Jalen Brunson,New York Knicks,PG,303,351,106,230,461.0,61,69,783.3,30,84,350.3,6,25,31,70,15,12,37,3,81,404,334,373,101,836.9044995408631,19.102846648301195,144.9568411386593,22.44995408631772,586.0973370064279,809.7024793388429,649.615243342516,127.74380165289257,10
204,Jalen Duren,Detroit Pistons,C,132,273,49,79,611.5,34,41,755.0,0,0,0.0,31,86,117,21,31,6,27,4,-81,270,249,153,138,262.40277777777777,251.79012345679013,23.0,0.0,1020.0077160493827,865.0632716049382,345.56944444444446,346.5679012345679,10
205,Jalen Green,Houston Rockets,SG,273,360,97,202,475.1,40,48,756.3,39,97,382.7,7,53,60,33,16,11,19,3,111,366,333,306,93,832.0367346938774,110.31836734693879,12.559183673469388,53.8,1205.8612244897959,1233.1224489795918,789.9591836734694,137.6938775510204,10
206,Jalen HoodSchifino,Los Angeles Lakers,G,5,11,1,6,33.3,2,4,100.0,1,3,50.0,0,2,2,0,1,0,1,0,-13,7,7,5,2,9.0,0.9799999999999999,0.020000000000000004,0.8200000000000001,13.32,14.180000000000001,8.42,0.72,2
207,Jalen Johnson,Atlanta Hawks,SF,178,339,71,149,485.0,19,29,568.3,17,46,399.9,13,75,88,44,19,7,16,11,35,310,266,222,132,514.8515625,92.65625,50.5,14.6640625,1006.8515625,695.7265625,765.7265625,203.40625,10
208,Jalen McDaniels,Toronto Raptors,PF,41,124,18,42,312.0,2,4,66.7,3,15,116.7,5,19,24,11,13,7,12,1,-31,76,65,52,35,162.0,86.76543209876542,12.728395061728397,4.222222222222222,416.8888888888888,336.4320987654321,207.06172839506172,134.8888888888889,8
209,Jalen Pickett,Denver Nuggets,G,2,7,1,3,33.3,0,0,0.0,0,2,0.0,0,0,0,2,0,0,0,0,-1,4,2,4,2,2.25,0.0,1.3611111111111107,0.0,7.1111111111111125,2.25,7.1111111111111125,1.3611111111111107,1
210,Jalen Slawson,Sacramento Kings,F,2,8,1,2,50.0,0,0,0.0,0,1,0.0,1,1,2,0,2,1,0,0,3,4,4,2,2,1.0,0.25,0.0,0.0,2.25,2.25,1.0,0.25,1
211,Jalen Smith,Indiana Pacers,PF,97,167,36,66,553.3,16,26,515.0,9,28,361.9,23,34,57,12,17,0,6,5,13,166,154,109,69,99.82544378698225,43.5207100591716,18.0,5.21301775147929,107.90828402366864,86.67751479289943,129.3639053254438,53.21301775147929,10
212,Jalen Suggs,Orlando Magic,SG,128,260,47,83,570.1,10,13,500.0,24,49,480.4,4,27,31,33,28,16,19,6,150,192,159,161,64,178.94444444444443,27.800000000000004,22.5,22.677777777777777,319.1111111111111,234.94444444444446,250.51111111111112,62.9,10
213,Jalen Williams,Oklahoma City Thunder,F,200,301,79,150,510.4,27,30,736.7,15,36,384.9,5,36,41,38,21,15,19,10,42,279,241,238,79,612.6555671175859,27.39542143600416,23.72944849115505,12.81477627471384,908.0343392299687,796.6462018730489,701.1633714880334,74.00520291363163,10
214,Jalen Wilson,Brooklyn Nets,F,38,153,14,43,409.1,7,8,350.0,3,18,200.0,14,18,32,10,14,1,7,0,-2,80,70,48,42,46.90625,40.40625,6.017361111111111,2.902777777777778,130.85069444444446,98.625,58.44444444444444,67.1111111111111,10
215,Jamal Cain,Miami Heat,F,4,16,0,3,0.0,4,4,200.0,0,1,0.0,1,2,3,1,1,1,1,0,-4,8,7,5,4,2.88,2.1199999999999997,0.6800000000000002,0.0,11.52,9.32,5.0,2.88,2
216,Jamal Murray,Denver Nuggets,PG,210,340,80,176,438.9,29,35,761.4,21,51,426.7,8,40,48,81,18,14,19,3,49,339,258,291,129,669.90625,61.619140625,76.15625,19.041015625,1163.962890625,800.978515625,965.125,205.541015625,10
217,James Bouknight,Charlotte Hornets,SG,10,13,4,10,83.3,0,0,0.0,2,7,58.3,0,0,0,0,0,1,1,0,13,10,10,10,0,18.0,0.0,0.0,0.72,18.0,18.0,18.0,0.0,2
218,James Harden,LA Clippers,SG,172,351,54,125,417.5,36,40,950.0,28,75,344.5,5,44,49,93,17,7,29,9,-16,314,221,265,142,611.2986472424557,59.45577523413112,45.27471383975026,37.600416233090534,554.5952133194589,560.945889698231,597.996878251821,111.68158168574402,10
219,James Johnson,Indiana Pacers,PF,2,7,0,1,0.0,2,2,100.0,0,0,0.0,0,0,0,1,3,0,0,1,1,3,2,3,1,1.7777777777777781,0.0,0.44444444444444453,0.0,4.0,1.7777777777777781,4.0,0.44444444444444453,1
220,James Wiseman,Detroit Pistons,C,87,182,36,60,576.3,15,17,550.0,0,0,0.0,21,50,71,13,23,3,11,8,-13,171,158,100,84,159.23517169614985,96.47762747138397,14.155046826222685,0.0,481.0416233090531,363.1009365244537,237.80853277835587,150.0,10
221,Jamie Jr. Jaquez,Miami Heat,G,7,31,3,5,60.0,1,1,100.0,0,1,0.0,0,1,1,2,4,0,1,0,-7,10,8,9,3,0.0,0.0,0.0,0.0,0.0,0.0,0.0,0.0,1
222,Jarace Walker,Indiana Pacers,F,26,101,9,29,232.2,2,2,100.0,6,17,200.0,3,20,23,8,9,4,5,6,19,57,49,34,31,105.77854671280275,45.80968858131487,32.24221453287197,6.41522491349481,395.0,258.7716262975779,180.1038062283737,139.95501730103808,8
223,Jared Butler,Washington Wizards,SG,50,147,22,53,443.5,5,5,300.0,1,14,16.7,3,11,14,34,13,4,13,1,-29,98,64,84,48,160.46560000000002,18.5984,67.56,0.8896,482.2656,206.1136,386.31359999999995,136.4624,9
224,Jared Rhoden,Detroit Pistons,G,2,13,1,2,50.0,0,0,0.0,0,0,0.0,0,1,1,1,0,0,1,2,2,4,3,3,2,0.0,0.0,0.0,0.0,0.0,0.0,0.0,0.0,1
225,Jaren Jackson Jr.,Memphis Grizzlies,PF,234,334,81,185,444.0,53,71,722.2,19,53,363.9,14,43,57,30,38,16,31,17,-83,321,291,264,87,370.4005102040816,147.0,41.3469387755102,10.941326530612244,741.125,785.9005102040816,385.625,128.3469387755102,10
226,Jarred Vanderbilt,Los Angeles Lakers,PF,68,142,26,42,412.7,13,17,375.0,3,5,166.7,12,22,34,12,8,16,11,2,23,114,102,80,46,111.33333333333334,59.333333333333336,18.0,3.5,362.0,274.0,157.33333333333334,119.33333333333334,6
227,Jarrett Allen,Cleveland Cavaliers,C,195,352,74,122,616.9,47,61,780.5,0,0,0.0,26,95,121,24,12,5,14,13,-4,340,316,219,145,386.3981008035062,236.4127100073046,26.981738495252007,0.0,1151.2008765522278,1024.5200876552228,476.97516435354277,299.4981738495252,10
228,Jason Preston,Utah Jazz,G,4,25,2,6,66.6,0,0,0.0,0,0,0.0,2,4,6,7,1,0,1,0,10,17,10,11,13,0.4260355029585797,2.4260355029585803,5.165680473372782,0.0,17.0,3.7041420118343202,6.65680473372781,14.65680473372781,2
229,Javon Freeman-Liberty,Toronto Raptors,G,28,87,8,20,173.8,10,11,380.0,2,9,83.3,2,13,15,8,8,1,3,2,-10,51,43,36,23,138.44970414201183,17.83431952662722,5.319526627218935,1.5029585798816567,258.73964497041425,224.56804733727807,160.65680473372782,35.11834319526628,5
230,Jaxson Hayes,Los Angeles Lakers,C,50,147,20,27,643.4,10,16,400.0,0,1,0.0,13,31,44,2,18,2,9,4,1,96,94,52,46,85.19926538108356,97.60146923783287,3.867768595041322,0.0,240.44444444444449,229.03948576675847,87.84389348025712,110.2295684113866,10
231,Jay Huff,Denver Nuggets,C,3,5,1,2,50.0,0,0,0.0,1,2,50.0,0,0,0,0,2,0,0,0,-3,3,3,3,0,3.0625,0.5625,0.0,0.5625,1.0,1.0,3.0625,0.5625,1
232,Jaylen Brown,Boston Celtics,SG,290,333,111,210,535.0,41,60,698.8,27,65,422.5,19,43,62,33,27,12,15,0,134,385,352,323,95,543.7544378698226,98.09763313609467,14.866863905325443,20.301775147928993,816.8313609467457,823.1479289940829,527.4023668639054,123.0,10
233,Jaylin Williams,Oklahoma City Thunder,F,39,129,14,31,408.3,2,3,150.0,9,21,424.9,5,30,35,11,13,4,3,5,56,85,74,50,46,56.431640625,60.125,10.90625,3.3515625,230.072265625,198.712890625,75.166015625,83.65625,10
234,Jayson Tatum,Boston Celtics,SF,280,350,92,196,478.9,55,63,870.0,41,82,508.9,9,59,68,50,20,10,26,5,130,398,348,330,118,312.16649323621226,88.20811654526536,49.00728407908429,15.287200832466182,327.8106139438085,476.47242455775233,210.58896982310097,90.13111342351719,10
235,Jeenathan Williams,Houston Rockets,G,8,17,4,7,66.7,0,2,0.0,0,0,0.0,2,1,3,0,4,0,0,0,17,11,11,8,3,43.8828125,2.03125,0.0703125,0.0,60.03125,62.4453125,42.125,1.4453125,2
236,Jeff Dowtin,Philadelphia 76ers,G,28,69,10,16,203.8,2,2,100.0,6,11,183.4,1,5,6,13,0,4,3,1,23,47,34,41,19,128.8888888888889,6.888888888888889,30.0,4.888888888888889,344.0,178.0,269.55555555555554,62.22222222222222,5
237,Jeff Green,Houston Rockets,PF,47,143,17,44,336.4,6,10,225.0,7,20,375.0,2,11,13,9,5,3,4,3,-39,69,60,56,22,146.6528925619835,19.885215794306703,7.0,4.107438016528926,236.54086317722678,225.96510560146925,161.10743801652893,23.006427915518824,10
238,Jerami Grant,Portland Trail Blazers,SF,169,342,56,142,386.6,38,46,711.3,19,49,402.0,6,19,25,35,18,14,28,2,-77,229,194,204,60,473.98961937716257,45.9204152249135,32.71626297577855,5.083044982698962,888.6262975778548,739.6678200692041,583.0934256055364,118.49134948096886,10
239,Jeremiah Robinson-Earl,New Orleans Pelicans,F,22,75,8,19,209.6,4,7,80.0,2,8,100.0,9,8,17,9,5,3,2,1,25,48,39,31,26,56.49134948096886,29.422145328719726,28.377162629757784,1.3910034602076125,198.0,134.96539792387546,97.53979238754326,79.78546712802768,6
240,Jeremy Sochan,San Antonio Spurs,F,143,320,55,123,441.3,20,25,683.4,13,41,266.6,22,57,79,33,28,5,20,10,18,255,222,176,112,373.5817901234568,23.90277777777778,42.69753086419753,13.569444444444446,298.5,371.53086419753095,296.4027777777778,70.74845679012346,10
241,Jericho Sims,New York Knicks,C,29,195,12,14,516.7,5,8,113.3,0,0,0.0,21,30,51,11,11,4,6,6,-13,91,80,40,62,104.90926275992439,54.20226843100189,13.650283553875235,0.0,329.3251417769376,229.531190926276,176.92627599243858,95.62948960302458,10
242,Jerome Robinson,Golden State Warriors,SG,10,17,4,10,40.0,1,2,50.0,1,6,16.7,0,0,0,1,1,0,0,1,-2,11,10,11,1,61.5621301775148,0.21301775147928997,0.4792899408284023,0.7159763313609467,65.23668639053254,54.53254437869823,72.90532544378698,0.053254437869822466,1
243,Jett Howard,Orlando Magic,G,0,5,0,1,0.0,0,0,0.0,0,1,0.0,0,0,0,0,1,0,0,0,-5,0,0,0,0,0.18367346938775508,0.0,0.0,0.02040816326530612,0.18367346938775508,0.18367346938775508,0.18367346938775508,0.0,1
244,Jevon Carter,Chicago Bulls,PG,41,150,17,38,405.20000000000005,1,2,50.0,6,19,191.7,2,9,11,13,9,4,4,2,5,65,52,54,24,163.59504132231405,12.15702479338843,8.562901744719925,6.6483011937557395,243.44444444444446,205.4214876033058,186.69237832874197,35.6455463728191,10
245,Jimmy Butler,Miami Heat,SF,222,361,78,155,502.4,56,69,792.8,10,28,358.3,15,35,50,54,16,17,18,5,40,326,272,276,104,488.19281663516074,48.124763705103966,55.37996219281663,8.302457466918716,686.9111531190927,468.50661625708887,691.4971644612476,118.60491493383743,10
246,Jock Landale,Houston Rockets,C,68,158,25,44,509.6,15,18,430.0,3,7,250.0,20,20,40,14,20,3,3,13,54,122,108,82,54,154.3923182441701,39.65980795610425,32.86145404663923,2.3305898491083674,305.7668038408779,222.34567901234567,236.06310013717422,74.27160493827161,10
247,Joe Harris,Detroit Pistons,SF,2,12,1,3,33.3,0,0,0.0,0,1,0.0,0,0,0,0,1,0,0,0,-5,2,2,2,0,0.0,0.0,0.0,0.0,0.0,0.0,0.0,0.0,1
248,Joe Ingles,Orlando Magic,SG,38,160,12,23,405.0,5,6,250.0,9,18,375.0,1,11,12,29,10,5,10,0,9,79,50,67,41,102.0,11.011937557392102,47.595041322314046,9.069788797061523,159.87419651056015,117.31496786042241,132.1404958677686,71.02571166207531,10
249,Joel Embiid,Philadelphia 76ers,C,45,61,16,38,82.8,9,12,170.0,4,10,83.3,2,12,14,5,6,2,10,0,-41,64,59,50,19,144.5,0.0,0.5,0.0,162.0,144.5,162.0,0.5,2
250,John Collins,Utah Jazz,PF,158,293,61,112,534.6,24,32,754.2,12,29,388.9,24,64,88,10,32,3,17,13,-37,256,246,168,98,290.697265625,116.90625,10.478515625,7.884765625,558.5390625,544.994140625,293.7265625,137.900390625,10
251,John Konchar,Memphis Grizzlies,SG,58,287,19,45,395.8,10,11,366.7,10,26,401.6,21,42,63,30,19,14,16,10,-5,151,121,88,93,140.041015625,74.306640625,14.009765625,6.087890625,292.431640625,228.90625,173.4765625,118.40625,10
252,Johnny Davis,Washington Wizards,G,31,144,12,37,308.3,3,4,150.0,4,14,183.3,3,12,15,8,12,3,1,4,-51,54,46,39,23,79.1712802768166,12.508650519031143,9.72491349480969,4.5121107266435985,151.01038062283737,116.58304498269896,115.66435986159169,20.16782006920415,10
253,Johnny Juzang,Utah Jazz,G,50,113,19,38,276.9,0,0,0.0,12,27,219.2,2,13,15,3,6,0,4,0,10,68,65,53,18,201.598615916955,13.629757785467127,2.1280276816608996,18.747404844290656,230.0,254.71626297577856,178.45328719723182,14.186851211072664,6
254,Jonas Valanciunas,New Orleans Pelicans,C,63,181,24,56,394.6,11,12,475.0,4,11,250.0,16,57,73,17,17,1,13,7,33,153,136,80,90,226.11836734693875,64.89387755102041,21.587755102040816,4.53061224489796,510.8938775510204,442.35918367346943,302.7755102040816,78.3591836734694,10
255,Jonathan Isaac,Orlando Magic,PF,89,168,34,54,672.3,8,10,316.7,13,20,535.0,15,35,50,5,5,5,5,13,55,144,139,94,55,100.616,35.6,4.5360000000000005,13.864000000000003,172.39999999999998,196.53599999999997,84.00000000000001,32.616,10
256,Jonathan Kuminga,Golden State Warriors,PF,209,286,80,151,516.0,39,45,715.0,10,23,350.1,7,35,42,23,28,9,19,4,-5,274,251,232,65,355.14464168310326,60.28402366863905,13.66929651545036,10.105193951347799,503.33596318211704,487.0105193951348,373.54503616042075,71.8783694937541,10
257,Jontay Porter,Toronto Raptors,C,54,157,19,44,335.6,5,8,125.0,11,28,255.4,11,26,37,27,13,10,10,8,-15,118,91,81,64,285.1111111111111,44.21995464852608,33.816326530612244,22.219954648526077,575.8367346938776,405.20408163265313,424.4512471655329,109.32879818594104,10
258,Jordan Clarkson,Utah Jazz,PG,174,327,64,151,396.6,29,32,757.9,17,59,244.1,7,28,35,60,19,10,22,0,-76,269,209,234,95,814.0,107.44444444444446,81.07029478458051,20.83673469387755,1289.530612244898,1206.7777777777778,873.736961451247,211.53061224489798,10
259,Jordan Goodwin,Memphis Grizzlies,G,69,232,28,81,330.5,5,12,225.0,8,28,229.89999999999998,13,28,41,37,16,15,14,10,-59,147,110,106,78,85.28515625,128.0625,77.28515625,2.94140625,402.0625,251.44140625,102.0,339.25390625,9
260,Jordan Hawkins,New Orleans Pelicans,G,46,131,16,58,271.5,4,5,150.0,10,39,210.0,3,13,16,6,8,0,2,2,2,68,62,52,22,170.27777777777777,18.600694444444443,6.444444444444445,10.434027777777779,232.68402777777783,199.8506944444444,204.5,23.65625,10
261,Jordan McLaughlin,Minnesota Timberwolves,PG,50,147,17,31,494.4,4,4,200.0,12,21,369.4,3,18,21,24,10,6,4,2,57,95,71,74,45,159.625,29.7265625,19.337890625,21.884765625,224.556640625,227.6640625,151.556640625,54.025390625,10
262,Jordan Miller,LA Clippers,G,4,5,1,1,100.0,2,2,100.0,0,0,0.0,0,1,1,0,0,0,0,0,3,5,5,4,1,9.679012345679013,0.44444444444444453,0.0,0.0,14.271604938271604,14.271604938271604,9.679012345679013,0.44444444444444453,1
263,Jordan Nwora,Toronto Raptors,SF,92,165,37,77,441.70000000000005,7,8,366.7,11,34,301.6,5,35,40,7,8,8,11,4,-32,139,132,99,47,315.5612244897959,45.54336734693877,4.471938775510204,6.908163265306123,365.48979591836735,399.625,276.94132653061223,54.5,10
264,Jordan Poole,Washington Wizards,SG,187,272,70,154,437.1,17,19,630.0,30,77,386.6,4,25,29,44,29,8,26,5,-108,260,216,231,73,752.1124330755503,30.599048185603806,40.52587745389649,22.21415823914337,548.2831647828673,667.4907792980368,631.0297441998811,73.0,10
265,Jordan Walsh,Boston Celtics,G,2,27,1,4,100.0,0,0,0.0,0,2,0.0,2,4,6,1,5,2,2,1,24,9,8,3,7,2.36734693877551,9.46938775510204,2.2244897959183674,0.0,1.0,2.36734693877551,8.183673469387756,4.510204081632653,2
266,Jose Alvarado,New Orleans Pelicans,PG,67,207,24,61,408.4,5,8,250.0,14,32,483.3,3,16,19,25,17,12,11,3,54,111,86,92,44,52.100936524453694,8.987513007284079,56.456815816857436,4.401664932362123,141.98231009365244,44.47034339229969,145.4360041623309,69.62122788761705,10
267,Josh Giddey,Oklahoma City Thunder,SG,122,235,54,107,491.6,3,3,200.0,11,36,336.9,16,44,60,43,16,7,18,5,52,225,182,165,103,267.625,102.06944444444444,43.364197530864196,2.919753086419753,552.4012345679013,394.4444444444444,344.9891975308642,226.02623456790124,10
268,Josh Green,Dallas Mavericks,SG,67,259,28,55,498.7,4,5,80.0,7,23,270.0,11,24,35,13,16,11,9,2,-34,115,102,80,48,175.42568370986916,41.573127229488705,10.20332936979786,7.416171224732463,227.9346016646849,241.15576694411413,176.20927467300828,37.77170035671819,10
269,Josh Hart,New York Knicks,SG,130,428,50,130,388.3,15,23,416.6,15,54,242.2,25,106,131,60,26,15,17,5,19,321,261,190,191,208.0,206.30864197530863,109.21604938271605,19.902777777777782,866.5493827160494,484.530864197531,450.1049382716049,455.43827160493834,10
270,Josh Minott,Minnesota Timberwolves,F,0,5,0,0,0.0,0,0,0.0,0,0,0.0,0,4,4,0,0,0,0,0,6,4,4,0,4,6.084444444444445,10.671111111111111,0.017777777777777778,0.2177777777777778,0.44444444444444425,0.6399999999999997,6.760000000000001,9.817777777777778,1
271,Josh Okogie,Phoenix Suns,SF,46,141,15,32,423.8,10,11,350.0,6,14,300.0,16,6,22,10,4,8,10,2,6,78,68,56,32,116.44982698961938,13.598615916955017,8.13840830449827,6.422145328719724,170.26989619377161,161.01730103806227,120.75432525951557,26.685121107266436,10
272,Josh Richardson,Miami Heat,SG,98,211,38,76,433.2,6,6,200.0,16,45,301.7,4,26,30,19,16,5,3,2,3,147,128,117,49,296.8888888888889,20.0,10.88888888888889,27.555555555555557,468.0,427.55555555555554,344.0,24.22222222222222,9
273,Joshua Primo,LA Clippers,G,0,5,0,1,0.0,0,0,0.0,0,0,0.0,1,0,1,0,0,0,1,0,1,1,1,0,1,0.0,0.0,0.0,0.0,0.0,0.0,0.0,0.0,1
274,Jrue Holiday,Boston Celtics,PG,114,323,45,81,564.5,4,4,200.0,20,44,531.8,8,25,33,55,13,14,17,11,120,202,147,169,88,82.59807956104252,48.111111111111114,52.668038408779154,6.054869684499314,210.16186556927298,168.2153635116598,165.63100137174212,59.69272976680384,10
275,Jules Bernard,Washington Wizards,G,37,62,14,27,346.2,3,5,200.0,6,11,285.0,6,5,11,9,3,1,3,1,21,57,48,46,20,161.20226843100187,10.43100189035917,12.759924385633271,5.345935727788281,266.32514177693764,204.17013232514176,221.62192816635158,24.926275992438562,5
276,Julian Champagnie,San Antonio Spurs,F,69,223,20,52,322.0,12,13,450.0,17,41,319.1,3,22,25,13,6,4,7,4,19,107,94,82,38,251.71836734693875,28.844897959183676,18.118367346938776,26.322448979591837,562.8448979591835,394.2040816326531,381.2,86.12244897959184,10
277,Julian Phillips,Chicago Bulls,F,39,132,13,31,272.9,7,8,266.7,6,13,283.4,6,12,18,5,12,5,3,1,-11,62,57,44,23,170.91975308641975,27.290123456790123,6.777777777777779,6.401234567901234,314.4444444444444,289.44444444444446,184.5493827160494,45.43827160493827,10
278,Julian Strawther,Denver Nuggets,G,9,27,3,11,37.5,2,2,100.0,1,8,20.0,0,3,3,4,1,1,2,0,-15,16,12,13,7,37.0,7.512396694214877,4.231404958677686,0.8347107438016528,108.4297520661157,76.69421487603304,61.59504132231405,18.884297520661153,2
279,Julius Randle,New York Knicks,PF,66,99,23,48,142.2,14,14,300.0,6,11,195.0,8,17,25,18,7,1,10,0,25,109,91,84,43,98.0,2.666666666666667,14.0,2.0,140.66666666666669,120.66666666666666,126.0,8.666666666666668,3
280,Justin Champagnie,Washington Wizards,SF,45,105,15,36,184.3,8,8,200.0,7,20,133.3,10,14,24,7,7,6,8,4,-46,76,69,52,31,184.40816326530614,63.235827664399096,5.204081632653061,7.555555555555556,512.657596371882,450.4875283446712,221.6938775510204,93.32426303854875,5
281,Justin Holiday,Denver Nuggets,SF,47,157,18,34,463.70000000000005,0,0,0.0,11,24,326.7,0,13,13,19,11,4,2,3,19,79,60,66,32,210.2627824019025,10.362663495838287,43.611177170035674,14.914387633769323,371.9821640903686,252.01189060642093,305.9453032104637,78.2615933412604,10
282,Justin Minaya,Portland Trail Blazers,F,12,94,4,17,149.89999999999998,1,2,50.0,3,14,116.6,6,9,15,4,5,3,3,2,-37,31,27,16,19,20.185255198487713,16.13421550094518,2.3062381852551983,1.9149338374291114,43.31001890359169,50.28544423440454,14.967863894139887,16.682419659735352,8
283,Jusuf Nurkic,Phoenix Suns,C,94,275,42,74,612.1,10,26,342.9,0,2,0.0,46,102,148,41,33,5,32,12,16,283,242,135,189,68.89072543617998,584.7144168962351,35.44444444444444,0.0,806.7943067033976,830.7438016528924,66.31496786042241,598.785123966942,10
284,Karl-Anthony Towns,Minnesota Timberwolves,C,193,306,66,146,451.8,41,47,734.2,20,56,341.5,20,55,75,29,33,8,24,8,98,297,268,222,104,265.0493827160493,98.62345679012346,46.91975308641975,18.771604938271604,548.530864197531,414.4012345679012,362.2777777777778,182.44444444444443,10
285,Kawhi Leonard,LA Clippers,SF,230,331,85,167,514.5,46,52,827.5,14,46,294.1,12,41,53,32,8,15,15,8,44,315,283,262,85,529.6873630387144,56.35427319211103,29.60116873630387,8.560993425858292,739.6223520818114,683.4894083272461,557.054784514244,114.72096420745069,10
286,Keegan Murray,Sacramento Kings,SF,127,355,47,117,382.7,18,21,425.0,15,59,235.5,17,45,62,16,28,11,9,10,31,205,189,143,78,272.125,67.61111111111111,20.625,21.271604938271604,516.7777777777777,460.90277777777777,296.5,119.73611111111111,10
287,Keita Bates-Diop,Brooklyn Nets,SF,35,85,12,20,615.0,6,6,300.0,5,11,350.0,3,10,13,5,1,2,5,4,-13,53,48,40,18,43.736000000000004,16.2,4.6000000000000005,5.175999999999999,77.976,73.05599999999998,41.45600000000001,28.0,10
288,Keldon Johnson,San Antonio Spurs,SF,172,304,62,128,485.1,16,19,483.3,32,74,428.6,17,39,56,22,17,3,12,1,-19,250,228,194,78,278.634765625,55.625,20.556640625,22.931640625,379.7890625,397.041015625,289.9765625,47.587890625,10
289,Kelly Olynyk,Toronto Raptors,PF,131,284,49,93,490.90000000000003,21,29,437.1,12,31,391.6,20,38,58,43,39,15,27,10,-92,232,189,174,101,367.1015625,53.0390625,59.478515625,8.869140625,686.306640625,556.15625,488.025390625,121.744140625,10
290,Kelly Oubre Jr.,Philadelphia 76ers,SG,204,334,74,178,415.1,41,55,634.5,15,55,252.79999999999998,20,41,61,23,28,9,20,10,-54,288,265,227,84,349.7530864197532,63.864197530864196,24.111111111111107,10.012345679012345,624.4444444444443,463.0,476.90123456790127,122.27160493827161,10
291,Kendall Brown,Indiana Pacers,SG,0,7,0,0,0.0,0,0,0.0,0,0,0.0,0,0,0,0,0,0,0,0,4,0,0,0,0,1.6198347107438016,0.03305785123966942,0.4049586776859504,0.0,4.37190082644628,2.115702479338843,3.6446280991735542,0.6694214876033059,1
292,Kenneth Lofton Jr.,Philadelphia 76ers,F,2,5,1,4,25.0,0,0,0.0,0,2,0.0,0,1,1,0,0,0,0,0,-4,3,3,2,1,0.0,0.0,0.0,0.0,0.0,0.0,0.0,0.0,1
293,Kenrich Williams,Oklahoma City Thunder,SF,20,101,8,23,281.7,0,0,0.0,4,15,150.0,9,22,31,12,11,3,3,1,21,63,51,32,43,95.22130394857668,43.69421487603306,14.835629017447198,7.309458218549128,171.61524334251607,147.47199265381084,97.78328741965106,80.11111111111111,10
294,Kentavious Caldwell-Pope,Denver Nuggets,SG,104,319,38,76,492.9,7,7,300.0,21,45,435.0,3,18,21,26,21,18,10,8,54,151,125,130,47,212.44444444444446,16.91111111111111,22.577777777777776,20.5,241.79999999999998,255.71111111111108,200.04444444444442,37.97777777777778,10
295,Kenyon Martin Jr.,Philadelphia 76ers,F,47,157,18,35,506.1,8,12,400.0,3,5,250.0,11,28,39,11,27,4,5,3,-16,97,86,58,50,112.96539792387543,146.1349480968858,10.901384083044983,2.105536332179931,566.5,462.75432525951555,174.34083044982697,199.40657439446366,10
296,Keon Ellis,Sacramento Kings,G,55,219,21,42,437.5,1,2,50.0,12,26,360.0,9,19,28,18,22,20,6,9,84,101,83,73,46,179.27160493827162,27.62688614540467,46.52400548696844,11.679012345679013,186.77777777777777,226.61042524005487,140.7997256515775,72.79012345679013,10
297,Keon Johnson,Brooklyn Nets,G,12,26,3,8,73.3,4,4,100.0,2,4,133.3,2,1,3,2,2,2,2,0,-9,17,15,14,5,18.88888888888889,0.5555555555555556,2.2222222222222223,0.22222222222222227,27.222222222222225,13.888888888888888,34.0,1.0,2
298,Kessler Edwards,Sacramento Kings,SF,21,58,8,19,156.7,1,2,50.0,4,13,111.7,1,10,11,3,7,3,1,1,9,35,32,24,14,93.5,19.59375,2.166666666666667,4.59375,152.09375,135.09375,100.66666666666667,31.59375,6
299,Kevin Durant,Phoenix Suns,PF,268,379,103,201,501.6,40,49,735.6,22,56,376.2,4,66,70,37,15,8,37,12,-9,375,338,305,107,1347.2,63.83673469387756,41.26122448979592,19.689795918367345,1581.8163265306125,1459.6081632653058,1395.204081632653,179.30204081632652,10
300,Kevin Huerter,Sacramento Kings,SG,72,231,29,79,330.1,2,4,100.0,12,45,205.0,6,24,30,25,23,8,11,2,5,127,102,97,55,288.7933884297521,30.44995408631772,4.557392102846649,16.24793388429752,456.13314967860424,441.77777777777777,290.82736455463726,47.32874196510561,10
301,Kevin Knox II,Detroit Pistons,SF,22,89,9,26,148.9,3,3,200.0,1,11,33.3,3,11,14,4,9,2,6,0,21,40,36,26,18,115.33333333333334,19.333333333333336,3.3333333333333335,0.8333333333333335,167.33333333333331,188.0,101.33333333333334,16.0,6
302,Kevin Love,Miami Heat,PF,88,158,30,62,483.6,10,14,208.3,18,45,387.4,10,55,65,19,20,3,10,3,31,172,153,107,84,362.530612244898,61.03061224489795,13.244897959183673,16.97959183673469,574.7448979591837,534.5,405.0,72.05102040816325,10
303,Kevon Looney,Golden State Warriors,F,23,98,10,20,533.3,3,7,75.0,0,0,0.0,6,22,28,10,16,1,6,3,25,61,51,33,38,21.09467455621302,21.801775147928993,4.133136094674556,0.0,23.0,25.05621301775149,13.95562130177515,31.017751479289945,10
304,Keyontae Johnson,Oklahoma City Thunder,F,5,39,2,8,66.7,0,0,0.0,1,2,100.0,2,4,6,2,4,0,2,0,-15,13,11,7,8,20.0,7.0,1.2653061224489797,0.8163265306122451,29.69387755102041,35.0,17.26530612244898,5.6938775510204085,5
305,Keyonte George,Utah Jazz,G,186,310,63,147,383.7,34,38,692.5,26,69,345.1,0,32,32,49,13,4,31,2,-101,267,218,235,81,859.5763330898466,33.64207450693937,64.39371804236669,47.0927684441198,1218.7326515704895,961.0343316289262,1130.3732651570488,84.93718042366692,10
306,Khris Middleton,Milwaukee Bucks,SF,136,236,51,98,439.8,20,23,517.5,14,33,393.3,8,30,38,46,29,8,17,3,9,220,174,182,84,293.5102040816327,41.224489795918366,48.734693877551024,3.5918367346938775,469.59183673469386,312.0,465.0204081632653,76.04081632653062,8
307,Killian Hayes,Detroit Pistons,PG,18,79,7,14,209.6,1,3,33.3,3,6,100.0,0,15,15,20,4,0,5,2,-12,53,33,38,35,27.0,18.75,54.0,2.75,252.75,74.75,153.0,124.75,4
308,Kira Lewis Jr.,Utah Jazz,PG,0,7,0,0,0.0,0,0,0.0,0,0,0.0,0,0,0,0,0,0,0,0,-10,0,0,0,0,1.9599999999999997,0.09,0.48999999999999994,0.0,5.76,2.8899999999999997,4.41,1.0,1
309,Klay Thompson,Golden State Warriors,SG,178,259,63,143,449.7,14,16,516.7,38,87,423.5,5,20,25,24,10,10,9,3,-7,227,203,202,49,553.1146822498174,29.87655222790358,46.680788897005115,21.61869978086194,589.0467494521549,515.5142439737034,640.699780861943,62.50474799123447,10
310,Kobe Brown,LA Clippers,G,2,27,1,5,100.0,0,0,0.0,0,2,0.0,4,5,9,2,4,0,3,0,-23,13,11,4,11,3.140625,11.75,1.5625,0.015625,19.765625,12.140625,3.265625,20.8125,4
311,Kobe Bufkin,Atlanta Hawks,G,27,81,11,31,158.4,1,2,50.0,4,14,115.0,1,10,11,14,6,3,4,1,21,52,38,41,25,72.63265306122449,3.9795918367346945,14.959183673469388,2.836734693877551,134.6326530612245,95.83673469387756,113.83673469387753,16.53061224489796,5
312,Kris Dunn,Utah Jazz,G,47,218,20,51,321.4,0,0,0.0,7,21,275.0,8,14,22,32,24,9,7,2,-58,101,69,79,54,122.72318339100346,17.344290657439448,16.5,6.548442906574395,274.7993079584775,166.6522491349481,209.16435986159172,55.55017301038061,10
313,Kris Murray,Portland Trail Blazers,F,91,287,36,76,499.0,9,14,391.7,10,36,273.3,14,34,48,24,20,6,12,7,-10,163,139,115,72,295.47346938775513,65.55102040816327,34.75918367346939,8.522448979591836,555.1224489795918,428.5020408163266,339.0,183.40408163265306,10
314,Kristaps Porzingis,Boston Celtics,C,208,286,70,147,494.1,42,46,836.1,26,61,457.8,17,55,72,20,23,6,11,14,98,300,280,228,92,153.825,97.6,10.899999999999999,18.425,457.225,414.225,202.825,102.5,10
315,Kyle Anderson,Minnesota Timberwolves,SF,80,271,33,72,422.9,12,16,500.0,2,8,100.0,7,35,42,49,22,7,9,7,54,171,122,129,91,139.51730103806227,39.72491349480969,32.693771626297575,1.6003460207612457,245.13667820069202,246.20069204152247,135.0,75.8719723183391,10
316,Kyle Kuzma,Washington Wizards,SF,245,345,92,177,533.3,43,53,855.3,18,50,283.3,6,65,71,44,19,8,29,9,-81,360,316,289,115,434.212890625,75.806640625,57.494140625,28.5,727.025390625,673.4140625,496.125,125.0,10
317,Kyle Lowry,Philadelphia 76ers,PG,91,304,29,74,365.2,16,19,575.0,17,47,330.4,3,31,34,53,21,11,13,2,-39,178,125,144,87,211.03780718336486,22.54820415879017,98.78071833648394,14.417769376181473,313.46691871455573,257.0718336483932,222.57466918714553,166.18714555765595,10
318,Kyrie Irving,Dallas Mavericks,PG,239,355,93,191,489.2,27,27,700.0,26,74,333.3,10,42,52,53,17,12,21,4,-36,344,291,292,105,381.3413111342352,33.30489073881374,137.3621227887617,23.13423517169615,979.1779396462016,482.6503642039544,829.5587929240376,218.9771071800208,10
319,LaMelo Ball,Charlotte Hornets,PG,32,55,12,37,66.1,5,6,150.0,3,17,34.7,1,5,6,15,10,3,7,0,-49,53,38,47,21,2.0,2.0,0.5,0.5,4.5,8.0,0.5,0.5,2
320,Lamar Stevens,Memphis Grizzlies,PF,111,215,46,97,495.5,13,18,333.3,6,15,425.0,12,32,44,7,18,7,12,7,-20,162,155,118,51,211.0,48.44444444444444,6.111111111111112,2.4444444444444446,334.9777777777778,267.17777777777775,274.44444444444446,58.91111111111111,10
321,Landry Shamet,Washington Wizards,SG,55,184,20,55,273.1,7,7,300.0,8,35,104.1,4,10,14,8,12,4,9,2,-68,77,69,63,22,330.90000000000003,22.5,5.700000000000001,15.624999999999998,463.7,413.80000000000007,373.0,35.99999999999999,10
322,Larry Nance Jr.,New Orleans Pelicans,PF,64,221,26,42,597.0,10,12,366.7,2,7,133.3,17,32,49,21,19,9,9,3,41,134,113,85,70,160.5,49.07777777777777,11.299999999999999,1.777777777777778,285.6111111111111,261.44444444444446,184.60000000000002,60.44444444444445,10
323,Lauri Markkanen,Utah Jazz,PF,200,337,66,161,411.9,41,44,856.7,27,75,347.4,18,53,71,22,13,8,21,4,-68,293,271,222,93,189.77777777777777,129.0,51.70975056689342,22.519274376417233,595.408163265306,394.7777777777777,358.69387755102036,212.42403628117913,10
324,LeBron James,Los Angeles Lakers,SF,281,362,107,183,584.2,42,55,708.4,25,57,421.6,7,66,73,96,13,11,34,5,26,450,354,377,169,393.0777777777778,77.21111111111111,24.944444444444443,26.77777777777777,294.5444444444444,274.5777777777778,440.2,75.0,10
325,Leaky Black,Charlotte Hornets,F,27,151,8,25,232.1,7,10,275.0,4,10,150.0,5,21,26,13,12,2,3,2,-31,66,53,40,39,88.0,30.96,8.41,8.25,118.49000000000001,84.96000000000001,110.40999999999998,50.49,9
326,Leonard Miller,Minnesota Timberwolves,F,0,5,0,1,0.0,0,0,0.0,0,0,0.0,0,0,0,2,0,0,0,0,8,2,0,2,2,0.04000000000000001,0.25,0.3600000000000001,0.0,0.010000000000000018,0.48999999999999994,0.15999999999999992,0.010000000000000018,1
327,Lester Quinones,Golden State Warriors,G,58,162,20,53,357.0,9,13,325.0,9,31,250.0,8,18,26,11,17,2,5,0,-34,95,84,69,37,195.03254437869822,18.86390532544379,14.902366863905323,10.902366863905325,256.6094674556213,288.9023668639053,180.0059171597633,16.5,10
328,Lindy Waters III,Oklahoma City Thunder,F,29,66,10,21,323.3,0,0,0.0,9,19,283.3,1,14,15,4,6,1,3,2,-33,48,44,33,19,99.72530864197532,28.861111111111114,3.9475308641975313,11.75,236.19444444444443,202.71604938271605,119.0,47.01234567901234,7
329,Lonnie Walker IV,Brooklyn Nets,G,77,163,29,77,361.5,3,4,150.0,16,44,222.4,0,18,18,5,18,3,8,4,12,100,95,82,23,556.4710743801653,17.623507805325985,4.706152433425161,35.67860422405877,744.2644628099173,707.5105601469238,584.7695133149679,30.78512396694215,10
330,Luguentz Dort,Oklahoma City Thunder,G,116,294,39,81,500.4,13,13,500.0,25,54,479.4,9,23,32,16,32,10,8,2,46,164,148,132,48,127.63734567901234,35.660493827160494,19.586419753086417,17.61111111111111,181.304012345679,137.4027777777778,171.40277777777777,55.382716049382715,10
331,Luka Doncic,Dallas Mavericks,PG,321,377,113,248,454.5,58,70,836.1,37,109,321.59999999999997,13,87,100,111,20,11,44,2,58,532,421,432,211,552.125,64.7265625,142.4140625,36.166015625,696.5,769.0390625,415.6015625,271.125,10
332,Luka Garza,Minnesota Timberwolves,C,45,61,16,35,240.8,6,8,200.0,7,20,233.3,8,6,14,1,8,2,3,1,-7,60,59,46,15,20.450000000000003,18.05,0.9124999999999999,1.4000000000000001,71.6125,67.0,23.91250000000001,20.1125,5
333,Luka Samanic,Utah Jazz,F,42,107,13,39,288.8,12,14,450.0,4,19,178.3,5,19,24,5,9,1,5,4,-42,71,66,47,29,97.26643598615918,48.73702422145328,4.591695501730103,2.29757785467128,298.76816608996546,259.0,123.05536332179929,67.30795847750865,9
334,Luke Kennard,Memphis Grizzlies,SG,124,269,39,78,499.6,18,20,571.4,28,59,476.40000000000003,2,23,25,40,10,8,18,0,-65,189,149,164,65,420.10069444444446,7.350694444444443,92.40277777777779,24.184027777777775,602.5,437.9027777777777,557.3506944444445,127.10069444444443,10
335,Luke Kornet,Boston Celtics,C,60,176,24,39,498.4,12,12,400.0,0,0,0.0,20,24,44,11,11,3,2,12,75,115,104,71,55,258.84444444444443,108.41111111111111,31.0,0.0,737.8777777777777,582.0111111111111,364.77777777777777,189.34444444444443,10
336,M. Pereira,Memphis Grizzlies,F,2,6,1,2,50.0,0,0,0.0,0,1,0.0,0,0,0,0,1,0,0,0,4,2,2,2,0,0.0,0.0,0.0,0.0,0.0,0.0,0.0,0.0,1
337,Malachi Flynn,Detroit Pistons,PG,47,101,16,47,270.0,7,10,275.0,8,23,281.7,0,12,12,12,5,5,6,0,-43,71,59,59,24,130.42239999999998,7.2544,13.385600000000002,5.8624,244.0384,185.51360000000003,180.82559999999998,28.761600000000005,9
338,Malaki Branham,San Antonio Spurs,G,113,218,41,95,398.2,16,18,441.7,15,41,273.7,6,14,20,22,14,3,17,1,-45,155,133,135,42,680.3149678604225,18.036730945821855,31.557392102846645,34.70615243342516,992.9761248852158,759.0495867768594,896.7777777777777,67.05785123966942,10
339,Malcolm Brogdon,Portland Trail Blazers,PG,102,218,37,83,266.20000000000005,17,19,433.3,11,30,202.89999999999998,7,22,29,40,13,4,17,2,4,171,131,142,69,100.0,28.833333333333336,7.333333333333334,6.833333333333334,113.5,66.83333333333334,151.33333333333331,31.5,6
340,Malik Beasley,Milwaukee Bucks,SG,103,298,37,101,350.6,2,3,150.0,27,79,324.7,3,36,39,17,16,7,7,1,63,159,142,120,56,342.494140625,16.759765625,14.103515625,30.791015625,259.806640625,268.15625,334.90625,30.1015625,10
341,Malik Monk,Sacramento Kings,SG,210,293,78,167,449.3,31,35,880.0,23,69,331.5,7,36,43,55,29,7,22,1,78,308,253,265,98,811.1855955678672,23.89196675900277,40.488919667590025,16.444598337950136,1046.5,948.6731301939059,858.2340720221608,115.15927977839335,10
342,MarJon Beauchamp,Milwaukee Bucks,F,30,42,10,16,350.0,7,8,175.0,3,7,200.0,2,9,11,1,4,1,3,0,-17,42,41,31,12,58.991735537190095,10.140495867768596,0.8677685950413222,1.8099173553719008,103.32231404958677,93.38016528925618,65.92561983471074,14.016528925619834,6
343,Marcus Morris Sr.,Cleveland Cavaliers,SF,18,36,6,10,104.7,1,2,50.0,5,7,130.0,1,5,6,3,5,0,1,0,7,27,24,21,9,53.92,2.32,5.220000000000001,4.68,43.379999999999995,78.48,25.78,0.5800000000000002,2
344,Marcus Morris Sr.,Philadelphia 76ers,SF,40,98,16,38,166.7,4,4,200.0,4,13,103.3,0,14,14,3,5,2,6,1,-21,57,54,43,17,86.64,5.04,2.8400000000000003,7.760000000000002,127.56,107.36,105.96000000000001,8.76,4
345,Marcus Sasser,Detroit Pistons,G,59,202,23,67,345.8,3,3,200.0,10,37,299.6,1,25,26,32,13,8,16,0,-36,117,85,91,58,144.2299687825182,21.001040582726326,37.6420395421436,10.509885535900104,325.7950052029136,237.61394380853275,223.20811654526534,67.84599375650365,10
346,Markelle Fultz,Orlando Magic,PG,66,168,29,70,363.6,8,11,233.3,0,4,0.0,13,19,32,14,10,3,13,3,-7,112,98,80,46,215.11111111111111,44.864197530864196,13.783264746227706,0.013717421124828532,334.5898491083676,297.679012345679,235.5116598079561,75.15775034293553,10
347,Markieff Morris,Dallas Mavericks,PF,5,11,2,3,150.0,0,0,0.0,1,2,50.0,0,2,2,0,0,0,0,0,4,7,7,5,2,0.625,2.5,0.0,0.625,4.625,4.625,0.625,2.5,2
348,Marques Bolden,Charlotte Hornets,C,0,13,0,1,0.0,0,0,0.0,0,0,0.0,0,1,1,0,1,0,1,0,2,1,1,0,1,0.0,0.7551020408163267,0.0,0.0,0.7551020408163267,0.7551020408163267,0.0,0.7551020408163267,2
349,Marvin Bagley III,Washington Wizards,PF,119,262,53,102,492.7,10,14,383.3,3,8,250.0,40,46,86,16,13,7,8,11,-40,221,205,135,102,366.9111111111111,136.0,12.577777777777778,2.2000000000000006,625.0,593.0444444444445,373.0,174.44444444444446,10
350,Mason Jones,Sacramento Kings,G,1,13,0,3,0.0,1,2,50.0,0,2,0.0,1,3,4,4,0,0,0,0,10,9,5,5,8,0.0,0.0,0.0,0.0,0.0,0.0,0.0,0.0,1
351,Mason Plumlee,LA Clippers,C,48,117,17,29,603.3,14,20,391.7,0,0,0.0,11,35,46,13,16,3,10,4,4,107,94,61,59,62.546938775510206,106.7591836734694,12.689795918367347,0.0,242.26530612244898,232.9795918367347,75.07346938775511,116.20816326530611,10
352,Matisse Thybulle,Portland Trail Blazers,SG,75,232,28,57,448.9,6,9,250.0,13,32,368.3,8,23,31,21,15,19,12,8,-28,127,106,96,52,287.728515625,35.1015625,21.40625,10.6640625,608.509765625,458.775390625,412.119140625,81.8515625,10
353,Matt Ryan,New Orleans Pelicans,F,26,54,9,21,200.0,0,0,0.0,8,17,194.4,1,8,9,2,5,0,2,0,-6,37,35,28,11,167.85185185185185,11.0,1.4074074074074074,14.518518518518519,268.1851851851852,257.5185185185185,177.85185185185185,13.074074074074074,6
354,Matthew Hurt,Memphis Grizzlies,F,32,110,12,33,215.9,3,3,200.0,5,19,233.4,9,7,16,4,8,3,2,3,-7,52,48,36,20,136.33217993079583,28.083044982698958,4.505190311418684,4.664359861591695,287.37716262975783,234.74740484429063,178.9204152249135,42.62975778546712,7
355,Max Christie,Los Angeles Lakers,G,42,123,15,32,606.9,5,7,300.0,7,17,320.0,3,12,15,11,2,1,3,2,-29,68,57,53,26,88.23309053069718,10.523413111342352,30.423517169614982,4.213319458896982,243.681581685744,141.0,176.29240374609785,55.56919875130073,10
356,Max Strus,Cleveland Cavaliers,SG,118,312,42,93,422.4,12,15,316.7,22,62,318.5,11,20,31,48,25,6,16,4,-32,197,149,166,79,284.77562326869804,32.988919667590025,26.775623268698062,31.81717451523546,400.2908587257617,331.86426592797784,377.1024930747922,35.86426592797784,10
357,Maxi Kleber,Dallas Mavericks,PF,16,185,4,20,183.3,6,8,300.0,2,16,150.0,1,28,29,15,21,2,1,4,43,60,45,31,44,64.76989619377163,34.949826989619375,15.745674740484429,2.887543252595156,138.75605536332182,95.68512110726643,114.34256055363323,44.193771626297575,10
358,Maxwell Lewis,Los Angeles Lakers,F,0,5,0,1,0.0,0,0,0.0,0,1,0.0,0,0,0,2,0,0,0,0,-3,2,0,2,2,0.0625,0.0,2.25,0.0,1.5625,0.0625,1.5625,2.25,1
359,Micah Potter,Utah Jazz,C,24,55,8,10,250.0,3,3,200.0,5,6,250.0,2,8,10,2,4,0,2,1,6,36,34,26,12,54.734693877551024,1.0204081632653061,1.020408163265306,3.0,46.734693877551024,41.51020408163265,60.0,2.0,4
360,Michael Porter Jr.,Denver Nuggets,SF,206,326,79,140,577.7,14,16,530.0,34,72,488.7,11,56,67,18,17,9,12,7,34,291,273,224,85,418.8852157943066,68.11111111111111,17.65289256198347,18.52157943067034,782.8842975206612,680.2892561983472,484.6317722681359,122.61248852157944,10
361,Mikal Bridges,Brooklyn Nets,SF,177,366,56,143,368.4,35,46,830.1,30,69,445.8,10,34,44,38,14,12,19,2,-37,259,221,215,82,648.125,40.45216049382716,33.77777777777778,20.030864197530864,619.5123456790124,672.3271604938271,593.9027777777778,75.63734567901234,10
362,Mike Conley,Minnesota Timberwolves,PG,121,297,41,93,399.4,23,25,563.3,16,51,266.6,10,25,35,47,19,12,15,1,-18,203,156,168,82,622.9359861591695,34.446366782006926,37.517301038062286,36.81833910034602,548.4325259515571,524.7768166089966,630.2698961937716,88.28546712802768,10
363,Mike Muscala,Oklahoma City Thunder,C,26,127,9,35,234.2,1,2,50.0,7,25,250.0,5,15,20,6,8,2,1,2,24,52,46,32,26,106.40277777777777,20.402777777777782,7.350694444444445,11.15625,231.60069444444446,200.5,125.85069444444446,39.40625,10
364,Miles Bridges,Charlotte Hornets,SF,208,390,85,188,451.1,22,30,546.4,16,62,231.0,11,70,81,40,12,8,19,3,-87,329,289,248,121,497.754565376187,81.33308984660336,16.35792549306063,25.791088385682983,825.1051862673485,834.0051132213293,505.64207450693937,80.9035792549306,10
365,Miles McBride,New York Knicks,PG,113,294,41,89,422.1,8,9,283.3,23,50,396.4,7,11,18,30,24,10,5,2,-4,161,131,143,48,660.4336419753085,9.95679012345679,117.34104938271605,37.43827160493827,932.0123456790122,691.2361111111112,887.4382716049382,141.06944444444443,10
366,Mo Bamba,Philadelphia 76ers,C,50,189,20,37,541.8,4,6,100.0,6,15,300.0,11,36,47,8,24,7,11,10,-33,105,97,58,55,60.653810835629024,49.0,15.057851239669422,4.494031221303949,112.77777777777777,76.56290174471994,89.77777777777777,71.14876033057851,10
367,Monte Morris,Minnesota Timberwolves,PG,54,166,20,48,538.6,5,8,225.0,9,19,383.3,3,12,15,30,3,7,2,1,7,99,69,84,45,45.3,19.4,52.711111111111116,5.177777777777777,202.4111111111111,86.5,127.6111111111111,105.71111111111111,10
368,Moritz Wagner,Orlando Magic,C,96,162,39,61,609.5,14,17,526.7,4,16,216.6,10,32,42,12,12,3,14,2,1,150,138,108,54,219.5371900826446,71.70615243342516,6.0,2.429752066115702,478.69237832874194,483.5408631772268,213.90082644628097,78.49403122130396,10
369,Moses Brown,Portland Trail Blazers,C,13,34,6,10,233.3,1,5,33.3,0,0,0.0,5,7,12,2,4,0,2,1,16,27,25,15,14,31.6530612244898,10.938775510204081,3.183673469387756,0.0,39.734693877551024,38.183673469387756,31.73469387755102,15.59183673469388,4
370,Moses Moody,Golden State Warriors,SG,87,209,34,78,438.6,9,12,233.3,10,36,225.4,10,28,38,6,14,10,8,8,28,131,125,93,44,240.74399999999997,71.024,2.416,18.256,487.00000000000006,489.73599999999993,246.66400000000002,64.78399999999999,10
371,Mouhamadou Gueye,Toronto Raptors,F,5,19,2,9,50.0,1,4,25.0,0,0,0.0,3,2,5,0,2,1,3,3,-15,10,10,5,5,1.0,0.625,0.0,0.0,1.125,1.125,1.0,0.625,2
372,Moussa Diabate,LA Clippers,F,2,7,1,1,100.0,0,2,0.0,0,0,0.0,1,3,4,0,0,1,0,1,1,6,6,2,4,0.0,0.0,0.0,0.0,0.0,0.0,0.0,0.0,1
373,Myles Turner,Indiana Pacers,C,152,267,58,119,475.0,19,29,470.0,17,42,335.2,12,47,59,13,28,3,14,22,24,224,211,165,72,384.025390625,47.556640625,16.212890625,25.6015625,425.634765625,407.0390625,437.4765625,28.9140625,10
374,Naji Marshall,New Orleans Pelicans,SF,71,216,28,54,410.0,4,5,250.0,11,25,418.3,6,42,48,24,7,11,10,3,57,143,119,95,72,287.556640625,36.744140625,13.337890625,13.1640625,317.166015625,305.6015625,261.6640625,87.5390625,10
375,Nassir Little,Phoenix Suns,SF,9,50,3,12,133.3,0,0,0.0,3,8,200.0,0,10,10,3,6,0,1,2,-8,22,19,12,13,15.705215419501137,13.535147392290249,4.244897959183674,1.8548752834467117,51.20408163265307,42.91836734693877,19.678004535147387,22.092970521541954,5
376,Nate Hinton,Houston Rockets,G,12,22,4,7,110.0,2,3,66.7,2,3,66.7,1,5,6,3,4,1,1,2,10,21,18,15,9,48.05555555555556,6.722222222222221,1.3888888888888884,2.5,97.38888888888886,75.55555555555557,65.0,13.0,2
377,Nathan Mensah,Charlotte Hornets,C,4,59,2,5,66.7,0,0,0.0,0,0,0.0,4,6,10,1,13,2,1,4,-17,15,14,5,11,13.75,9.9375,0.859375,0.0,41.359375,44.4375,13.484375,7.984375,7
378,Naz Reid,Minnesota Timberwolves,C,169,280,60,128,467.5,21,28,559.2,28,62,408.4,11,57,68,22,21,6,11,15,22,259,237,191,90,794.3425605536333,69.10726643598616,20.269896193771626,52.78892733564014,894.4463667820069,771.0,872.9792387543251,134.18685121107265,10
379,Neemias Queta,Boston Celtics,C,39,80,19,26,443.4,1,2,100.0,0,0,0.0,12,17,29,4,8,3,4,6,63,72,68,43,33,99.27218934911244,52.0,1.958579881656805,0.0,271.7988165680473,262.04142011834324,109.18343195266272,53.80473372781064,7
380,Nic Claxton,Brooklyn Nets,C,133,305,55,81,699.0,23,36,550.5,0,1,0.0,18,76,94,27,26,6,13,18,-23,254,227,160,121,198.47530864197532,79.625,16.125,0.0,265.36419753086415,249.98919753086415,226.60030864197535,83.0,10
381,Nick Jr. Smith,Charlotte Hornets,G,53,164,17,59,301.1,8,9,187.5,11,32,275.0,2,10,12,17,19,4,5,0,8,82,65,70,29,231.70399999999998,10.896,21.0,15.384000000000002,295.216,236.45600000000002,270.224,52.13600000000001,10
382,Nick Richards,Charlotte Hornets,C,90,296,38,56,653.6,14,20,400.0,0,1,0.0,26,64,90,7,27,5,12,8,-27,187,180,97,97,273.90123456790127,152.1929012345679,10.277777777777777,0.0,385.5817901234568,400.5632716049383,278.54938271604937,142.84104938271605,10
383,Nickeil Alexander-Walker,Minnesota Timberwolves,SG,110,285,39,81,474.1,12,14,433.3,20,44,425.0,9,19,28,25,13,9,9,5,34,163,138,135,53,462.8298027757487,38.549306062819575,22.254930606281956,24.262965668371077,599.3520818115413,565.3849525200876,456.2154857560263,101.38568298027758,10
384,Nicolas Batum,Philadelphia 76ers,PF,50,293,18,53,317.5,6,7,250.0,8,34,211.6,15,41,56,21,19,13,7,8,16,127,106,71,77,125.37174211248285,83.99725651577504,21.34567901234568,5.679012345679013,309.77914951989027,248.91083676268866,146.28120713305898,145.30178326474623,10
385,Nikola Jokic,Denver Nuggets,C,265,376,105,182,577.8,45,51,884.8,10,27,218.7,27,93,120,70,18,13,32,9,78,455,385,335,190,668.9485766758494,128.74380165289256,81.73921028466484,18.036730945821855,973.0165289256198,841.3122130394858,798.5206611570247,212.6152433425161,10
386,Nikola Jovic,Miami Heat,F,76,213,28,62,455.8,6,9,250.0,14,40,346.6,2,41,43,17,18,8,10,4,10,136,119,93,60,83.91689750692521,47.343490304709135,21.199445983379505,10.454293628808863,261.9279778393352,200.40720221606648,123.29916897506925,90.6814404432133,10
387,Nikola Vucevic,Chicago Bulls,C,200,337,87,171,501.0,11,13,400.0,15,40,364.9,27,75,102,26,22,5,20,3,-50,328,302,226,128,517.461224489796,61.804081632653066,20.408163265306122,6.518367346938775,700.9795918367347,654.0,578.9224489795918,67.73061224489796,10
388,Noah Clowney,Brooklyn Nets,F,8,41,3,6,50.0,0,0,0.0,0,2,0.0,3,4,7,5,2,2,1,0,-7,20,15,13,12,47.7603305785124,8.041322314049587,4.43801652892562,0.024793388429752067,97.09917355371901,90.7603305785124,50.29752066115703,16.28099173553719,3
389,Norman Powell,LA Clippers,G,153,282,54,116,463.2,21,27,525.0,24,68,384.1,3,29,32,16,23,10,10,2,0,201,185,169,48,363.20395421436007,32.3309053069719,17.00104058272633,20.40374609781478,435.0,481.80749219562955,306.2341311134235,59.494276795005206,10
390,O.G. Anunoby,New York Knicks,SF,83,194,33,70,262.7,9,14,243.3,8,28,138.3,3,24,27,12,12,16,13,5,107,122,110,95,39,460.8469387755101,55.0,6.0,9.132653061224492,279.704081632653,279.7040816326531,470.84693877551024,51.0,6
391,Obi Toppin,Indiana Pacers,PF,75,178,30,53,523.0,9,11,450.0,6,21,233.3,8,31,39,10,16,5,6,4,35,124,114,85,49,237.39999999999998,47.63673469387756,18.35918367346939,4.922448979591837,425.6326530612245,409.8367346938776,238.5591836734694,80.6326530612245,10
392,Ochai Agbaji,Toronto Raptors,G,66,255,28,79,325.1,4,8,200.0,6,28,155.89999999999998,15,20,35,9,22,7,9,4,-95,110,101,75,44,183.80020811654526,65.43912591050989,6.908428720083245,4.520291363163372,373.03642039542143,383.5327783558793,178.12591050988553,67.525494276795,10
393,Olivier Sarr,Oklahoma City Thunder,C,11,22,4,7,125.0,3,5,116.7,0,1,0.0,4,4,8,0,3,0,1,1,-14,19,19,11,8,34.92,6.920000000000002,0.0,0.0,59.68000000000001,59.68000000000001,34.92,6.920000000000002,3
394,OlivierMaxence Prosper,Dallas Mavericks,F,10,36,3,6,150.0,4,7,57.1,0,2,0.0,2,6,8,0,1,1,1,1,-14,18,18,10,8,25.76,12.0,0.0,0.0,72.16,72.16,25.76,12.0,4
395,Omer Yurtseven,Utah Jazz,C,33,65,15,21,269.0,3,5,150.0,0,1,0.0,10,12,22,3,8,1,3,6,-5,58,55,36,25,131.46814404432132,23.581717451523545,8.177285318559557,0.013850415512465372,220.57340720221606,181.64819944598338,161.06925207756234,41.08310249307479,5
396,Onuralp Bitim,Chicago Bulls,SF,55,167,23,51,449.7,1,2,50.0,8,27,206.7,6,16,22,10,14,2,4,2,-22,87,77,65,32,220.54253308128546,54.71455576559546,4.680529300567108,8.151228733459359,437.7788279773157,414.35727788279775,229.56332703213613,73.79584120982986,10
397,Onyeka Okongwu,Atlanta Hawks,PF,149,297,62,89,718.1,16,22,492.9,9,19,466.6,33,43,76,11,27,6,5,15,5,236,225,160,87,232.51111111111112,157.9111111111111,9.444444444444445,5.0,611.2444444444445,621.4,233.6,156.11111111111111,10
398,Orlando Robinson,Miami Heat,C,13,54,4,10,108.3,4,5,175.0,1,2,100.0,7,9,16,4,4,1,3,0,6,33,29,17,20,43.8125,15.03472222222222,3.25,0.8055555555555556,65.88888888888889,44.138888888888886,63.3125,20.534722222222225,5
399,Oscar Tshiebwe,Indiana Pacers,C,3,5,1,3,33.3,1,2,50.0,0,0,0.0,2,0,2,0,1,0,0,1,8,5,5,3,2,0.25,0.0,0.0,0.0,0.25,0.25,0.25,0.0,1
400,Oshae Brissett,Boston Celtics,SF,41,155,12,33,327.2,14,24,438.3,3,12,183.3,14,23,37,15,12,4,4,1,30,93,78,56,52,107.53061224489797,65.0,21.36989795918367,2.1734693877551017,362.125,244.53061224489798,208.625,102.86989795918367,10
401,Ousmane Dieng,Oklahoma City Thunder,F,28,90,10,25,324.4,4,4,200.0,4,14,220.0,1,7,8,14,3,3,6,3,16,50,36,42,22,111.92,6.0,18.48,4.080000000000001,218.32,153.92,172.32000000000002,28.48,8
402,P.J. Tucker,LA Clippers,PF,16,127,6,16,133.3,0,0,0.0,4,10,183.4,7,17,24,3,8,3,3,4,-15,43,40,19,27,61.69777777777778,35.791111111111114,3.8977777777777782,4.631111111111111,154.5244444444444,120.92,78.11111111111111,56.88,7
403,P.J. Washington,Dallas Mavericks,PF,103,323,37,99,387.5,15,20,400.0,14,58,237.6,13,49,62,12,15,9,6,9,7,177,165,115,74,236.62892622352084,53.618699780861945,13.377647918188458,14.505478451424397,347.04674945215487,291.6296566837107,272.48137326515706,86.5609934258583,10
404,Paolo Banchero,Orlando Magic,PF,227,346,82,154,587.8,48,61,715.5,15,38,476.3,8,53,61,58,19,7,36,6,73,346,288,285,119,268.1009365244537,67.28720083246618,58.13943808532778,10.396462018730489,512.420395421436,481.9500520291363,315.0853277835588,108.91259105098857,10
405,Pascal Siakam,Indiana Pacers,PF,197,312,80,151,530.6,31,43,621.8,6,18,208.3,22,63,85,31,21,10,12,5,-6,313,282,228,116,260.99999999999994,110.50204081632654,25.03265306122449,5.061224489795918,442.32244897959174,390.0163265306123,280.48979591836735,168.35102040816327,10
406,Pat Connaughton,Milwaukee Bucks,SG,73,243,23,52,446.2,14,16,625.0,13,36,409.6,7,21,28,14,11,4,5,3,-26,115,101,87,42,209.2361111111111,28.40277777777778,16.526234567901234,13.364197530864198,326.58179012345676,309.0,220.6049382716049,51.14197530864198,10
407,Patrick Baldwin Jr.,Washington Wizards,F,43,147,15,53,272.6,5,8,210.0,8,33,171.9,6,33,39,12,13,6,5,3,-38,94,82,55,51,126.26530612244898,59.08418367346938,19.89030612244898,6.155612244897959,315.9183673469388,212.29846938775512,198.1862244897959,110.6734693877551,10
408,Patrick Beverley,Milwaukee Bucks,PG,64,229,21,54,337.1,11,13,533.4,11,29,332.9,5,30,35,18,23,9,7,6,-43,117,99,82,53,182.40816326530611,90.09387755102043,38.8734693877551,8.918367346938776,459.81632653061223,405.0,238.13061224489795,128.06122448979593,10
409,Patrick Williams,Chicago Bulls,PF,6,24,2,9,22.2,2,2,100.0,0,5,0.0,0,6,6,2,5,0,2,2,-11,14,12,8,8,0.0,0.0,0.0,0.0,0.0,0.0,0.0,0.0,1
410,Patty Mills,Atlanta Hawks,PG,2,27,1,6,25.0,0,0,0.0,0,4,0.0,0,4,4,1,0,2,0,0,17,7,6,3,5,20.1875,2.671875,5.671875,0.8802083333333333,49.0,24.921875,43.25520833333333,9.354166666666664,3
411,Patty Mills,Miami Heat,PG,36,116,13,45,175.0,4,4,200.0,6,31,132.5,3,8,11,13,8,6,5,0,20,60,47,49,24,176.5486111111111,6.262152777777778,15.234375,7.5538194444444455,204.0,203.734375,176.76215277777783,21.548611111111114,7
412,Paul George,LA Clippers,F,238,361,83,161,525.5,36,43,769.6,36,82,447.7,2,50,52,37,22,15,20,9,44,327,290,275,89,180.83265306122453,11.893877551020408,70.3469387755102,21.779591836734692,321.7510204081633,218.52244897959187,289.40000000000003,76.90204081632653,10
413,Paul Reed,Philadelphia 76ers,SF,101,248,40,85,478.9,14,20,550.0,7,17,350.0,32,42,74,18,25,12,11,17,10,193,175,119,92,305.8137326515705,58.43535427319211,10.420745069393718,6.815924032140249,562.9780861943025,545.4981738495252,322.0343316289262,70.1154127100073,10
414,Payton Pritchard,Boston Celtics,PG,111,252,43,88,431.2,4,4,200.0,21,47,415.3,9,30,39,42,11,5,12,0,83,192,150,153,81,549.1469387755102,58.33061224489795,157.60816326530613,29.065306122448977,1315.6897959183675,721.8367346938775,1048.265306122449,310.6734693877551,10
415,Peyton Watson,Denver Nuggets,F,62,188,27,64,404.0,5,10,150.0,3,21,225.0,3,28,31,9,16,6,5,10,11,102,93,71,40,143.9325259515571,21.0121107266436,16.949826989619375,2.6262975778546713,270.88754325259515,238.93079584775086,167.53979238754326,46.311418685121104,10
416,Precious Achiuwa,New York Knicks,PF,95,273,37,70,540.0,17,26,520.8,4,13,183.3,29,48,77,17,22,9,17,18,10,189,172,112,94,278.84567901234567,72.84567901234568,18.45679012345679,4.549382716049383,409.4444444444444,379.3827160493827,286.1049382716049,114.10493827160495,10
417,Quentin Grimes,Detroit Pistons,SG,82,213,26,80,296.2,19,24,525.0,11,50,200.0,2,27,29,19,13,7,9,4,-12,130,111,101,48,312.44628099173553,35.19834710743802,14.900826446280991,10.900826446280991,442.06611570247935,483.0495867768595,277.6942148760331,43.86776859504132,10
418,R. Rupert,Portland Trail Blazers,G,36,135,12,29,398.1,6,6,300.0,6,15,325.0,8,15,23,13,15,3,7,0,-15,72,59,49,36,163.77839335180056,34.19667590027701,15.742382271468141,9.20775623268698,351.1468144044322,315.2437673130194,187.77008310249306,61.850415512465375,10
419,RJ Barrett,Toronto Raptors,SG,208,328,85,152,559.5,20,43,406.1,18,37,425.0,9,42,51,46,22,5,28,4,-39,305,259,254,97,255.64444444444445,58.24444444444445,50.577777777777776,15.777777777777777,454.77777777777777,307.8,398.8,112.64444444444445,10
420,Reggie Bullock,Houston Rockets,SF,28,111,10,22,441.6,0,0,0.0,8,19,399.9,1,18,19,3,4,5,3,0,22,50,47,31,22,35.421487603305785,30.28925619834711,2.1404958677685952,3.8677685950413228,60.33057851239669,62.70247933884298,31.975206611570247,33.50413223140496,10
421,Reggie Jackson,Denver Nuggets,PG,54,154,23,68,301.0,0,0,0.0,8,27,310.0,1,12,13,21,13,2,8,1,23,88,67,75,34,108.15224913494811,6.5,31.97577854671281,5.799307958477509,142.2854671280277,98.41695501730105,137.25605536332182,53.240484429065745,10
422,Richaun Holmes,Washington Wizards,F,74,189,29,49,542.5,15,17,500.0,1,2,100.0,18,34,52,5,25,6,6,5,-48,131,126,79,57,229.77777777777777,84.94444444444444,4.9,0.9444444444444444,577.4000000000001,541.3,263.74444444444447,91.97777777777779,10
423,Ricky IV Council,Philadelphia 76ers,G,62,114,21,48,420.2,17,23,530.0,3,14,125.0,2,15,17,6,5,0,3,1,-8,85,79,68,23,258.625,32.724999999999994,6.425000000000001,4.200000000000001,480.125,415.79999999999995,317.59999999999997,44.5,10
424,Robin Lopez,Milwaukee Bucks,C,6,23,3,9,37.5,0,0,0.0,0,2,0.0,1,0,1,1,3,1,0,2,-16,8,7,7,2,21.92,0.52,0.6800000000000002,0.0,24.48,29.0,18.28,0.32000000000000006,2
425,Royce O'Neale,Phoenix Suns,PF,84,275,31,79,399.6,2,2,100.0,20,54,396.9,8,44,52,32,18,4,7,4,30,168,136,116,84,404.89446366782005,44.608996539792386,38.99134948096886,21.046712802768166,585.6885813148789,588.7837370242214,382.89965397923874,102.5,10
426,Rudy Gobert,Minnesota Timberwolves,C,130,361,53,82,648.8,24,35,555.0,0,1,0.0,44,102,146,14,37,7,16,26,30,290,276,144,160,287.37603305785126,111.5206611570248,12.41322314049587,0.0,438.5165289256198,479.09504132231405,236.8305785123967,133.900826446281,10
427,Rui Hachimura,Los Angeles Lakers,PF,162,310,71,123,573.5,5,8,250.0,15,37,381.7,6,26,32,13,18,5,7,2,-3,207,194,175,45,412.7755102040817,31.551020408163268,8.151020408163266,12.66530612244898,338.6,356.23673469387757,391.23673469387757,43.60408163265306,10
428,Russell Westbrook,LA Clippers,PG,93,216,37,98,389.9,15,21,523.3,4,26,95.0,8,19,27,29,17,13,15,1,-10,149,120,122,56,193.55363321799308,25.844290657439448,33.636678200692046,4.7543252595155705,366.9792387543252,307.43252595155707,227.9515570934256,84.62975778546712,10
429,Ryan Arcidiacono,New York Knicks,G,0,5,0,1,0.0,0,0,0.0,0,1,0.0,0,0,0,0,1,1,0,0,3,0,0,0,0,0.0,0.0625,0.0,0.0,0.0625,0.0625,0.0,0.0625,1
430,Saben Lee,Phoenix Suns,G,35,98,9,28,194.29999999999998,15,20,416.7,2,9,83.3,3,15,18,17,6,4,2,0,11,70,53,52,35,190.68,24.479999999999997,5.720000000000001,1.5200000000000005,336.32,336.0,189.68,31.519999999999996,8
431,Saddiq Bey,Atlanta Hawks,SF,146,337,48,125,372.4,31,35,800.0,19,59,298.4,29,32,61,14,7,4,10,4,-23,221,207,160,75,398.90000000000003,67.125,9.625,14.9,439.4000000000001,478.32500000000005,362.225,74.5,10
432,Sam Hauser,Boston Celtics,SF,103,210,36,72,446.1,0,0,0.0,31,63,432.70000000000005,2,36,38,8,13,6,2,7,90,149,141,111,46,835.0,33.091557669441144,5.638525564803805,85.98216409036863,953.8299643281807,936.1605231866824,847.9488703923901,43.450653983353156,10
433,Sam Merrill,Cleveland Cavaliers,SG,91,241,28,82,330.8,8,8,400.0,27,78,334.09999999999997,3,21,24,24,16,3,4,3,7,139,115,115,48,334.5,48.77681660899655,67.56401384083046,40.76989619377162,547.7889273356401,428.8062283737024,455.3581314878893,114.46539792387544,10
434,Samardo Samuels,Houston Rockets,F,0,6,0,1,0.0,0,0,0.0,0,0,0.0,1,1,2,0,0,0,0,0,-5,2,2,0,2,1.44,1.9599999999999997,0.0,0.0,0.03999999999999998,0.03999999999999998,1.44,1.9599999999999997,1
435,Sandro Mamukelashvili,San Antonio Spurs,PF,20,47,10,16,296.7,0,1,0.0,0,2,0.0,8,3,11,5,5,2,0,0,21,36,31,25,16,61.83673469387756,13.5,6.918367346938775,0.0,142.1938775510204,98.76530612244899,89.12244897959182,36.56122448979592,6
436,Santi Aldama,Memphis Grizzlies,PF,144,333,53,116,461.0,15,23,516.7,23,62,319.3,14,50,64,29,14,9,16,13,-112,237,208,173,93,372.8442906574395,34.77681660899654,37.0,38.11245674740484,613.0467128027681,489.3996539792388,508.0795847750865,60.18858131487889,10
437,Sasha Vezenkov,Sacramento Kings,F,9,22,2,7,28.6,3,3,100.0,2,4,50.0,0,1,1,1,4,1,0,0,24,11,10,10,2,4.5,0.5,0.5,2.0,4.5,2.0,8.0,0.0,2
438,Scoot Henderson,Portland Trail Blazers,G,126,289,42,122,357.6,33,38,808.3,9,39,226.6,9,26,35,56,36,9,30,1,-103,217,161,182,91,156.40428061831153,74.50297265160523,64.88228299643282,4.942925089179548,466.50535077288947,268.9001189060642,291.6242568370987,201.7705112960761,10
439,Scottie Barnes,Toronto Raptors,SF,179,333,70,155,460.1,33,39,674.9,6,36,159.89999999999998,28,63,91,75,18,13,31,14,21,345,270,254,166,391.6640625,102.8515625,85.6640625,4.8515625,827.2890625,587.40625,576.65625,243.40625,10
440,Scotty Pippen Jr.,Memphis Grizzlies,G,90,203,31,65,366.4,15,22,340.4,13,25,455.0,8,22,30,45,23,10,17,5,-9,165,120,135,75,177.12,17.52,34.0,6.72,257.68,247.28000000000003,188.32,50.72000000000001,8
441,Seth Curry,Charlotte Hornets,SG,81,181,29,67,372.5,14,15,566.7,9,31,256.6,4,15,19,17,7,5,7,3,-33,117,100,98,36,233.0,12.900826446280993,16.140495867768593,4.900826446280991,334.3388429752066,276.08264462809916,269.8677685950413,50.429752066115704,10
442,Shai Gilgeous-Alexander,Oklahoma City Thunder,PG,295,344,107,205,519.4,67,81,827.2,14,44,364.3,8,52,60,53,28,18,21,11,65,408,355,348,113,373.2716049382716,66.27777777777779,33.24845679012345,18.5,541.625,418.62345679012344,506.4027777777778,89.39660493827162,10
443,Shake Milton,New York Knicks,SG,40,105,17,39,321.1,2,3,66.7,4,11,150.0,9,13,22,11,6,3,5,2,-16,73,62,51,33,109.48000000000002,70.72,17.27,7.920000000000001,423.83000000000004,324.52,167.02999999999997,129.75,7
444,Simone Fontecchio,Detroit Pistons,F,158,307,55,116,455.5,19,21,616.7,29,65,413.2,8,41,49,16,20,10,13,5,5,223,207,174,65,507.2111111111111,37.07777777777778,14.444444444444443,30.244444444444447,586.7777777777777,545.0,539.6111111111111,60.9,10
445,Skylar Mays,Los Angeles Lakers,SG,8,34,4,10,170.0,0,0,0.0,0,3,0.0,0,1,1,3,2,3,2,1,-3,12,9,11,4,12.55111111111111,0.7511111111111113,2.9377777777777783,0.0,8.417777777777777,13.16,9.337777777777777,2.16,4
446,Spencer Dinwiddie,Los Angeles Lakers,PG,45,225,14,36,385.0,8,11,316.7,9,22,391.7,1,13,14,24,14,2,8,3,29,83,59,69,38,113.44444444444444,4.405876951331497,28.991735537190085,4.904499540863177,180.77777777777777,120.25436179981635,172.92102846648302,34.44444444444444,10
447,Stanley Umude,Detroit Pistons,G,49,150,16,39,260.4,8,9,366.7,9,25,243.3,5,16,21,3,15,4,4,2,-32,73,70,52,24,176.92797783933517,43.87534626038781,2.0581717451523547,11.166204986149586,280.4072022160665,273.606648199446,181.46260387811634,48.199445983379505,8
448,Stephen Curry,Golden State Warriors,PG,214,292,74,190,387.8,26,29,642.5,40,120,329.0,8,40,48,39,9,4,24,2,18,301,262,253,87,1032.076124567474,91.64186851211073,40.55017301038063,63.27508650519031,1755.0121107266439,1523.8425605536331,1262.9169550173015,132.52076124567472,10
449,Svi Mykhailiuk,Boston Celtics,SG,40,99,14,36,335.4,0,0,0.0,12,31,288.3,2,12,14,10,1,4,2,0,64,64,54,50,24,38.63,22.07,7.83,5.43,166.23000000000002,114.11999999999999,72.92,47.72,7
450,T.J. McConnell,Indiana Pacers,PG,135,200,61,105,565.0,7,8,250.0,6,10,400.0,5,24,29,41,11,17,18,2,35,205,164,176,70,312.041015625,30.947265625,40.728515625,4.572265625,499.134765625,387.625,424.5,70.7265625,10
451,T.J. Warren,Minnesota Timberwolves,SF,29,98,13,34,301.2,1,2,50.0,2,11,83.3,5,11,16,7,10,3,4,1,31,52,45,36,23,34.09567901234568,13.93827160493827,6.777777777777778,1.4567901234567902,32.19444444444444,46.19444444444445,14.836419753086423,25.97530864197531,7
452,Taj Gibson,Detroit Pistons,F,3,11,1,2,50.0,0,0,0.0,1,2,50.0,0,2,2,0,1,1,0,0,-3,5,5,3,2,2.5600000000000005,0.03999999999999998,0.16000000000000003,0.36,1.9599999999999997,3.2399999999999993,1.44,0.04000000000000007,1
453,Taj Gibson,New York Knicks,F,2,68,0,9,0.0,2,2,100.0,0,2,0.0,4,6,10,4,8,1,3,0,2,16,12,6,14,8.2,10.200000000000001,1.6,0.8000000000000002,15.600000000000001,12.400000000000002,6.6000000000000005,16.599999999999998,5
454,Talen Horton-Tucker,Utah Jazz,SG,64,154,19,65,304.2,16,18,566.7,10,30,384.9,3,17,20,23,12,6,3,5,-48,107,84,87,43,47.0359168241966,52.92627599243857,32.02835538752363,2.0756143667296785,213.59735349716448,140.42722117202268,110.87901701323253,94.28166351606806,10
455,Taurean Prince,Los Angeles Lakers,PF,63,186,24,53,497.70000000000005,2,2,100.0,13,33,342.0,3,27,30,11,12,4,6,6,17,104,93,74,41,147.46530612244896,34.032653061224494,12.17551020408163,16.68979591836735,298.14693877551025,275.2448979591837,167.95918367346943,48.61632653061224,10
456,Taylor Hendricks,Utah Jazz,F,93,255,34,72,506.2,11,13,425.0,14,41,358.6,17,55,72,8,31,5,3,12,-49,173,165,101,80,96.9171597633136,110.28402366863905,1.6479289940828403,6.428994082840236,213.24556213017755,195.22485207100593,112.5,114.3698224852071,10
457,Taze Moore,Portland Trail Blazers,G,2,5,1,1,100.0,0,0,0.0,0,0,0.0,0,0,0,1,0,0,1,0,7,3,2,3,1,1.44,0.0,0.6400000000000001,0.0,4.0,1.44,4.0,0.6400000000000001,1
458,Terance Mann,LA Clippers,SG,95,251,35,66,554.4,14,14,700.0,11,26,378.5,7,22,29,6,20,7,4,3,-21,130,124,101,35,146.58948137326516,16.916727538349164,7.871439006574143,8.903579254930607,162.13586559532504,145.03871439006573,153.34623813002193,35.128560993425864,10
459,Terquavion Smith,Philadelphia 76ers,G,40,59,14,34,241.1,2,3,100.0,10,26,216.6,0,2,2,10,3,7,4,0,9,52,42,50,12,186.96296296296296,1.4074074074074074,17.185185185185183,17.185185185185183,177.40740740740742,184.66666666666663,179.62962962962965,18.666666666666668,6
460,Terry Rozier,Miami Heat,SG,181,344,71,158,456.1,19,23,547.7,20,51,338.7,6,42,48,51,18,10,15,2,-16,280,229,232,99,195.744140625,38.462890625,109.1640625,35.40625,389.2265625,260.125,349.400390625,123.072265625,10
461,Terry Taylor,Chicago Bulls,F,11,46,4,8,275.0,1,2,50.0,2,3,150.0,2,10,12,3,1,1,0,0,-17,26,23,14,15,10.977839335180054,29.16897506925208,3.182825484764543,1.6232686980609419,88.07202216066483,68.49030470914128,17.43490304709141,45.476454293628805,4
462,Thaddeus Young,Phoenix Suns,F,6,29,3,6,100.0,0,2,0.0,0,0,0.0,7,3,10,0,4,1,1,0,3,16,16,6,10,6.5,23.397959183673464,4.081632653061225,0.0,11.306122448979597,8.040816326530612,19.1530612244898,18.091836734693878,2
463,Thaddeus Young,Phoenix Suns,PF,53,152,26,34,569.9,1,5,50.0,0,2,0.0,15,20,35,18,15,3,4,2,-39,106,88,71,53,205.75,40.89285714285714,36.857142857142854,0.0,599.0,355.2857142857143,395.17857142857133,132.03571428571428,7
464,Thanasis Antetokounmpo,Milwaukee Bucks,SF,10,48,5,11,266.7,0,2,0.0,0,1,0.0,2,1,3,4,8,1,3,1,-18,17,13,14,7,12.833333333333332,1.666666666666667,2.0000000000000004,0.0,20.83333333333334,17.5,15.5,4.333333333333334,6
465,Theo Maledon,Phoenix Suns,PG,5,10,1,2,50.0,3,3,100.0,0,0,0.0,0,1,1,0,3,0,3,0,-11,6,6,5,1,14.0625,0.5625,0.0,0.0,20.25,20.25,14.0625,0.5625,1
466,Thomas Bryant,Miami Heat,C,48,108,18,35,330.2,11,13,525.0,1,9,100.0,8,25,33,5,11,1,0,6,-2,86,81,53,38,162.4025,86.16,4.239999999999999,0.9600000000000002,376.5625,369.8025,171.7225,87.84,9
467,Tim Hardaway Jr.,Dallas Mavericks,SF,84,182,28,78,316.1,11,16,450.0,17,50,298.9,2,20,22,16,6,5,5,0,12,122,106,100,38,489.7560262965668,82.4835646457268,12.568298027757487,27.76552227903579,922.8327246165084,854.9934258582908,547.2885317750182,105.35865595325053,10
468,Tobias Harris,Philadelphia 76ers,PF,155,338,63,146,400.2,15,20,633.3,14,46,249.4,13,58,71,21,13,12,9,7,-39,247,226,176,92,755.2438016528926,123.67355371900827,29.0,24.698347107438014,1298.4214876033059,1114.1487603305786,898.1528925619835,194.03719008264463,10
469,Torrey Craig,Chicago Bulls,SF,58,205,20,47,355.2,3,6,150.0,15,37,327.1,8,23,31,15,16,4,7,5,-44,104,89,73,46,150.65625,42.90277777777778,20.5,14.5,403.35069444444446,339.85069444444446,197.15625,80.40277777777777,10
470,Tosan Evbuomwan,Detroit Pistons,F,39,138,15,30,451.4,4,6,125.0,5,12,283.3,8,14,22,6,9,2,2,1,-55,67,61,45,28,118.34222222222222,112.54222222222224,10.480000000000002,3.9688888888888885,284.6355555555555,247.88888888888889,106.63555555555556,171.47555555555556,8
471,Toumani Camara,Portland Trail Blazers,F,75,275,27,56,475.0,12,15,400.0,9,21,328.3,19,30,49,19,22,8,8,6,-10,143,124,94,68,242.02410518626732,77.34623813002192,17.10518626734843,9.28926223520818,525.1738495252009,491.72242512783055,274.2585829072315,95.66837107377648,10
472,Trae Young,Atlanta Hawks,PG,235,370,76,173,432.4,45,55,813.4,38,93,399.0,2,18,20,109,22,11,45,2,-38,364,255,344,129,758.2361111111111,12.069444444444445,83.0,45.06944444444444,786.5,622.5,926.4027777777778,90.90277777777777,10
473,Trayce JacksonDavis,Golden State Warriors,F,116,223,52,64,825.5,12,23,486.7,0,0,0.0,23,41,64,18,21,3,6,17,11,198,180,134,82,156.06944444444446,76.40277777777777,25.859567901234566,0.0,418.1188271604939,360.4444444444444,193.3641975308642,122.64197530864199,10
474,Tre Jones,San Antonio Spurs,PG,103,305,36,68,498.4,19,21,658.3,12,26,247.1,6,36,42,77,10,11,12,1,62,222,145,180,119,592.3877551020408,22.261224489795918,63.1795918367347,27.599999999999998,659.4367346938776,594.2326530612245,610.7020408163265,132.33061224489796,10
475,Tre Mann,Charlotte Hornets,PG,118,315,46,99,465.8,14,23,457.1,12,36,288.3,6,41,47,42,17,19,12,0,-51,207,165,160,89,241.01736111111114,34.11111111111111,37.77777777777778,8.267361111111109,499.1006944444444,396.6006944444445,332.40625,83.0,10
476,Trendon Watford,Brooklyn Nets,PF,66,128,21,45,511.4,20,22,535.7,4,10,200.0,8,17,25,2,18,2,9,4,-57,93,91,68,27,259.0694444444444,56.15625,1.90625,4.767361111111111,397.23611111111103,379.18402777777777,286.1840277777777,49.0,10
477,Trent Forrest,Atlanta Hawks,G,23,121,10,20,358.3,3,4,150.0,0,0,0.0,2,11,13,27,7,0,3,1,-10,63,36,50,40,57.256,16.2,43.576,0.0,148.6,82.976,107.6,75.056,10
478,Trevelin Queen,Orlando Magic,SG,0,13,0,3,0.0,0,0,0.0,0,2,0.0,0,1,1,1,1,0,0,0,-17,2,1,1,2,0.0,0.5555555555555556,0.5555555555555556,0.0,0.22222222222222227,0.5555555555555556,0.5555555555555556,0.22222222222222227,2
479,Trey Jemison,Memphis Grizzlies,C,80,228,36,57,561.0,8,10,400.0,0,0,0.0,24,27,51,11,32,3,15,9,4,142,131,91,62,455.7777777777777,22.017361111111107,6.934027777777779,0.0,525.625,580.6840277777777,402.26736111111114,27.402777777777782,10
480,Trey Lyles,Sacramento Kings,PF,53,186,18,46,392.9,12,16,625.0,5,22,236.7,11,28,39,8,19,0,7,3,1,100,92,61,47,103.99173553719008,15.06198347107438,7.640495867768594,7.148760330578514,183.88429752066114,131.55785123966942,140.88016528925618,38.14049586776859,10
481,Trey Murphy III,New Orleans Pelicans,SG,192,307,65,128,490.2,20,26,783.4,42,96,399.3,10,45,55,33,11,7,5,2,91,280,247,225,88,969.7439446366782,44.71453287197232,35.16608996539792,88.71453287197231,1160.569204152249,1240.416955017301,900.1972318339101,69.57958477508652,10
482,Tristan Thompson,Cleveland Cavaliers,C,7,38,3,6,116.7,1,4,50.0,0,0,0.0,6,7,13,4,6,2,2,1,-6,24,20,11,17,13.32,0.6800000000000002,0.6799999999999999,0.0,19.08,19.520000000000003,13.520000000000001,0.7199999999999999,3
483,Troy Brown Jr.,Detroit Pistons,SF,34,118,13,35,316.2,2,2,100.0,6,20,206.6,3,18,21,9,6,1,3,0,-30,64,55,43,30,74.40625,23.7265625,9.3515625,4.90625,204.65625,155.7890625,117.8515625,38.5,10
484,TyTy Washington Jr.,Milwaukee Bucks,G,0,8,0,2,0.0,0,0,0.0,0,1,0.0,0,0,0,1,0,0,0,0,-4,1,0,1,1,0.0,0.0,0.44444444444444453,0.0,0.44444444444444453,0.0,0.44444444444444453,0.44444444444444453,1
485,Tyler Herro,Miami Heat,PG,183,325,71,166,433.4,10,13,333.4,31,80,406.0,3,46,49,50,11,0,13,1,35,282,232,233,99,148.11111111111111,40.94444444444444,28.069444444444443,12.944444444444445,309.7361111111111,207.61111111111111,206.125,113.125,10
486,Tyrese Haliburton,Indiana Pacers,PG,157,327,60,141,408.9,25,27,625.0,12,68,180.79999999999998,5,43,48,94,14,10,26,7,-7,299,205,251,142,374.13007284079083,31.679500520291366,125.75234131113423,9.8792924037461,810.1633714880332,419.3100936524454,792.6857440166493,129.72944849115504,10
487,Tyrese Maxey,Philadelphia 76ers,PG,250,367,88,203,428.2,45,48,825.0,29,78,349.7,4,34,38,54,20,11,18,3,-20,342,288,304,92,634.0856123662306,56.323424494649224,38.63020214030916,23.0,978.7705112960762,929.6432818073722,646.7966706302022,131.36979785969086,10
488,Tyus Jones,Washington Wizards,PG,91,313,36,84,402.0,4,4,300.0,15,43,360.8,3,22,25,97,4,9,13,2,-70,213,116,188,122,345.04336734693874,43.53316326530612,160.5,20.959183673469386,776.265306122449,542.0510204081633,542.9719387755102,240.3188775510204,10
489,Udoka Azubuike,Phoenix Suns,C,2,11,1,3,33.3,0,2,0.0,0,0,0.0,2,4,6,0,1,0,0,0,-3,8,8,2,6,1.7777777777777781,13.444444444444443,0.0,0.0,25.0,25.0,1.7777777777777781,13.444444444444443,1
490,Vasilije Micic,Charlotte Hornets,G,160,310,60,115,530.5,26,29,844.5,14,38,330.0,6,18,24,53,13,11,31,2,-60,237,184,213,77,425.6734693877552,43.26530612244899,76.19999999999999,23.216326530612246,589.8163265306122,469.95918367346934,509.0163265306123,155.9795918367347,10
491,Victor Wembanyama,San Antonio Spurs,C,210,318,74,162,440.9,42,55,717.8,20,58,344.5,24,94,118,44,27,11,38,47,35,372,328,254,162,630.5,36.788927335640146,36.416955017301035,19.461937716262977,1085.6055363321798,855.6418685121107,821.3287197231834,112.340830449827,10
492,Vince Williams Jr.,Memphis Grizzlies,G,127,336,42,92,459.70000000000005,30,38,723.3,13,34,328.8,8,54,62,61,30,12,34,9,-54,250,189,188,123,231.93628808864267,72.8808864265928,35.61495844875347,18.00831024930748,492.2326869806094,474.07479224376726,226.76454293628805,131.82548476454295,10
493,Vit Krejci,Atlanta Hawks,G,31,154,11,27,235.8,4,5,150.0,5,16,158.3,2,6,8,16,14,5,3,4,-4,55,39,47,24,56.84,3.535,11.615,3.1599999999999997,50.36,65.63499999999999,38.875,17.839999999999996,6
494,Walker Kessler,Utah Jazz,C,61,241,26,43,665.0,9,12,400.0,0,2,0.0,31,55,86,11,17,4,10,14,-96,158,147,72,97,126.56920415224913,106.5121107266436,7.0674740484429055,0.0,348.92041522491354,341.4757785467128,125.4878892733564,122.10553633217994,10
495,Wendell Carter Jr.,Orlando Magic,C,114,263,42,82,517.7,19,26,506.7,11,33,306.7,27,53,80,22,20,6,16,7,77,216,194,136,102,155.625,103.2265625,5.712890625,7.125,345.822265625,323.6640625,180.994140625,105.728515625,10
496,Wendell Moore Jr.,Minnesota Timberwolves,G,2,5,1,1,100.0,0,0,0.0,0,0,0.0,0,2,2,0,1,0,0,0,8,4,4,2,2,2.863905325443787,3.130177514792899,0.00591715976331361,0.0,11.455621301775148,11.98224852071006,2.609467455621302,2.863905325443787,1
497,Wenyen Gabriel,Memphis Grizzlies,F,17,81,8,22,168.3,0,5,0.0,1,6,50.0,7,18,25,3,10,2,8,2,-16,45,42,20,28,48.16897506925207,18.182825484764543,3.767313019390582,0.8448753462603878,99.94182825484765,99.47645429362879,44.961218836565095,25.62326869806094,5
498,Wesley Matthews,Atlanta Hawks,SG,39,94,13,25,477.6,2,3,100.0,11,18,515.0,0,11,11,5,5,3,0,4,-19,55,50,44,16,106.75510204081633,22.306122448979593,8.306122448979592,6.183673469387755,182.75510204081633,177.22448979591834,118.89795918367348,24.0,8
499,Xavier Moon,LA Clippers,G,2,6,1,3,33.3,0,0,0.0,0,1,0.0,0,0,0,0,0,1,1,0,-9,2,2,2,0,0.28994082840236673,0.14792899408284024,0.14792899408284024,0.0,1.7100591715976325,0.8520710059171595,0.8520710059171595,0.591715976331361,1
500,Xavier Tillman,Boston Celtics,F,45,191,18,37,447.5,6,10,200.0,3,14,183.3,13,26,39,12,13,9,2,6,16,96,84,57,51,87.04158790170132,32.678638941398866,8.69187145557656,2.1153119092627595,192.73724007561435,162.4045368620038,114.18714555765597,44.557655954631386,10
501,Yuta Watanabe,Memphis Grizzlies,SF,22,97,10,24,250.0,0,2,0.0,2,12,64.3,0,11,11,5,6,5,4,0,-36,38,33,27,16,115.08000000000001,11.27,3.75,1.4800000000000004,136.28,131.43,116.23000000000002,18.72,7
502,Zach Collins,San Antonio Spurs,PF,102,181,39,75,507.9,17,23,541.7,7,13,516.7,17,31,48,21,26,5,20,9,-31,171,150,123,69,241.70000000000002,77.87777777777778,25.3,4.5,517.7444444444444,404.7111111111111,333.0,124.91111111111111,10
503,Zeke Nnaji,Denver Nuggets,PF,18,100,6,17,350.0,6,8,300.0,0,2,0.0,7,10,17,4,10,2,2,10,-19,39,35,22,21,51.199999999999996,15.864,7.183999999999999,0.0,127.80000000000001,93.30399999999999,72.944,35.8,10
504,Ziaire Williams,Memphis Grizzlies,F,103,270,39,94,389.0,13,16,421.4,12,46,213.7,6,38,44,20,15,12,15,0,-39,167,147,123,64,552.1,32.4,24.0,17.599999999999998,788.1,632.1,714.1,50.4,10
505,Zion Williamson,New Orleans Pelicans,PF,239,316,93,155,593.8,52,68,765.3,1,3,50.0,20,50,70,47,20,9,25,11,74,356,309,286,117,577.4765625,76.625,48.525390625,0.947265625,611.322265625,808.5390625,419.291015625,86.119140625,10
